year,group,sys,topic,n,n_u,n_t,avg,avg_t,p_i
2010,University of Ottawa,DFalah2010,51,121,59,62,1.47560975609756,2.69565217391304,0.0656504339589112
2010,University of Ottawa,DFalah2010,52,521,25,496,7.44285714285714,11.0222222222222,0.62232745994294
2010,University of Ottawa,DFalah2010,53,1000,151,849,4.149377593361,9.43333333333333,0.262509531027535
2010,University of Ottawa,DFalah2010,54,1000,136,864,4.67289719626168,11.0769230769231,0.284708773538499
2010,University of Ottawa,DFalah2010,55,1000,23,977,13.5135135135135,19.156862745098,0.812780061042087
2010,University of Ottawa,DFalah2010,56,51,36,15,1.18604651162791,2.14285714285714,0.0854305253856307
2010,University of Ottawa,DFalah2010,57,250,100,150,1.65562913907285,2.94117647058824,0.19761562424149
2010,University of Ottawa,DFalah2010,58,392,36,356,4.55813953488372,7.12,0.487952869451982
2010,University of Ottawa,DFalah2010,59,151,80,71,1.51,3.55,0.0433179142297412
2010,University of Ottawa,DFalah2010,60,1000,24,976,10.5263157894737,13.7464788732394,0.483178045135442
2010,University of Ottawa,DFalah2010,61,1000,14,986,17.2413793103448,22.4090909090909,0.760631255861804
2010,University of Ottawa,DFalah2010,62,4,4,0,1,,0
2010,University of Ottawa,DFalah2010,63,1000,37,963,11.9047619047619,20.4893617021277,0.172558910447782
2010,University of Ottawa,DFalah2010,64,701,20,681,11.1269841269841,15.8372093023256,0.565150069065297
2010,University of Ottawa,DFalah2010,65,961,195,766,2.78550724637681,5.10666666666667,0.159382544041653
2010,University of Ottawa,DFalah2010,66,1000,513,487,1.59235668789809,4.23478260869565,0.0463581255968534
2010,University of Ottawa,DFalah2010,67,9,9,0,1,,0
2010,University of Ottawa,DFalah2010,68,1000,32,968,10.8695652173913,16.1333333333333,0.322415915679612
2010,University of Ottawa,DFalah2010,69,141,58,83,1.7625,3.77272727272727,0.0707040280746965
2010,University of Ottawa,DFalah2010,70,28,12,16,1.47368421052632,2.28571428571429,0.44276747712567
2010,University of Ottawa,DFalah2010,71,551,110,441,2.86979166666667,5.37804878048781,0.247592286546374
2010,University of Ottawa,DFalah2010,72,1000,27,973,15.3846153846154,25.6052631578947,0.649822037210804
2010,University of Ottawa,DFalah2010,73,931,103,828,4.77435897435897,9,0.661875841424668
2010,University of Ottawa,DFalah2010,74,1000,18,982,14.4927536231884,19.2549019607843,0.470769771901328
2010,University of Ottawa,DFalah2010,75,189,20,169,3.85714285714286,5.82758620689655,0.525768416921555
2010,University of Ottawa,DFalah2010,76,100,38,62,1.69491525423729,2.95238095238095,0.230148747502775
2010,University of Ottawa,DFalah2010,77,1000,26,974,12.3456790123457,17.7090909090909,0.527327954434488
2010,University of Ottawa,DFalah2010,78,1000,21,979,16.1290322580645,23.8780487804878,0.446003941264288
2010,University of Ottawa,DFalah2010,79,1000,28,972,12.987012987013,19.8367346938776,0.652632942127772
2010,University of Ottawa,DFalah2010,80,220,87,133,1.73228346456693,3.325,0.14587952140031
2010,University of Ottawa,DFalah2010,81,1000,35,965,10.989010989011,17.2321428571429,0.648966365472759
2010,University of Ottawa,DFalah2010,82,1000,18,982,17.5438596491228,25.1794871794872,0.806919923668116
2010,University of Ottawa,DFalah2010,83,1000,33,967,12.3456790123457,20.1458333333333,0.724456770818286
2010,University of Ottawa,DFalah2010,84,60,26,34,1.66666666666667,3.4,0.19429547326239
2010,University of Ottawa,DFalah2010,85,121,59,62,1.53164556962025,3.1,0.299840913554567
2010,University of Ottawa,DFalah2010,86,10,10,0,1,,0
2010,University of Ottawa,DFalah2010,87,70,45,25,1.25,2.27272727272727,0.265449752123419
2010,University of Ottawa,DFalah2010,88,40,24,16,1.29032258064516,2.28571428571429,0.19556573378733
2010,University of Ottawa,DFalah2010,89,871,32,839,10.6219512195122,16.78,0.448374014484372
2010,University of Ottawa,DFalah2010,90,281,24,257,5.2037037037037,8.56666666666667,0.522449180076305
2010,University of Ottawa,DFalah2010,91,411,132,279,2.08629441624365,4.29230769230769,0.0378420865352342
2010,University of Ottawa,DFalah2010,92,1000,22,978,13.6986301369863,19.1764705882353,0.639898887310405
2010,University of Ottawa,DFalah2010,93,691,24,667,9.46575342465753,13.6122448979592,0.522406882301967
2010,University of Ottawa,DFalah2010,94,1000,30,970,12.3456790123457,19.0196078431373,0.625341899095602
2010,University of Ottawa,DFalah2010,95,1000,454,546,1.74216027874564,4.55,0.175975108044822
2010,University of Ottawa,DFalah2010,96,1000,26,974,14.0845070422535,21.6444444444444,0.618223149165488
2010,University of Ottawa,DFalah2010,97,1000,129,871,4.3859649122807,8.7979797979798,0.266697283437445
2010,University of Ottawa,DFalah2010,98,1000,20,980,14.9253731343284,20.8510638297872,0.737068216793754
2010,University of Ottawa,DFalah2010,99,1000,26,974,12.3456790123457,17.7090909090909,0.525623258787963
2010,University of Ottawa,DFalah2010,100,150,124,26,1.09489051094891,2,0.00760884145299835
2010,"ICT, Chinese Academy of Sciences",ICTNETAD10R1,51,1000,920,80,1.04602510460251,2.22222222222222,0.213708051816937
2010,"ICT, Chinese Academy of Sciences",ICTNETAD10R1,52,1000,711,289,1.27064803049555,3.80263157894737,0.00314189998986904
2010,"ICT, Chinese Academy of Sciences",ICTNETAD10R1,53,1000,911,89,1.0515247108307,2.225,7.04716872097754e-12
2010,"ICT, Chinese Academy of Sciences",ICTNETAD10R1,54,1000,858,142,1.09649122807018,2.62962962962963,0.00363285713111912
2010,"ICT, Chinese Academy of Sciences",ICTNETAD10R1,55,1000,940,60,1.0351966873706,2.30769230769231,0.187014303180425
2010,"ICT, Chinese Academy of Sciences",ICTNETAD10R1,56,1000,873,127,1.08459869848156,2.59183673469388,0.0579487791325806
2010,"ICT, Chinese Academy of Sciences",ICTNETAD10R1,57,1000,963,37,1.02145045965271,2.3125,0.00522477048854111
2010,"ICT, Chinese Academy of Sciences",ICTNETAD10R1,58,1000,888,112,1.06382978723404,2.15384615384615,0.114606284979289
2010,"ICT, Chinese Academy of Sciences",ICTNETAD10R1,59,1000,899,101,1.06044538706257,2.29545454545455,0.00423495269281329
2010,"ICT, Chinese Academy of Sciences",ICTNETAD10R1,60,1000,739,261,1.26742712294043,5.22,0.00751386194244073
2010,"ICT, Chinese Academy of Sciences",ICTNETAD10R1,61,1000,545,455,1.5748031496063,5.05555555555556,0.0641602467314824
2010,"ICT, Chinese Academy of Sciences",ICTNETAD10R1,62,1000,902,98,1.06609808102345,2.72222222222222,0.0352221333847856
2010,"ICT, Chinese Academy of Sciences",ICTNETAD10R1,63,1000,880,120,1.06837606837607,2.14285714285714,0.00346747448764464
2010,"ICT, Chinese Academy of Sciences",ICTNETAD10R1,64,1000,907,93,1.0515247108307,2.11363636363636,0.0164176593659394
2010,"ICT, Chinese Academy of Sciences",ICTNETAD10R1,65,1000,913,87,1.05042016806723,2.23076923076923,0.124700510230402
2010,"ICT, Chinese Academy of Sciences",ICTNETAD10R1,66,1000,942,58,1.04493207941484,3.86666666666667,1.16436328544495e-09
2010,"ICT, Chinese Academy of Sciences",ICTNETAD10R1,67,1000,911,89,1.05820105820106,2.61764705882353,0.0377148272077672
2010,"ICT, Chinese Academy of Sciences",ICTNETAD10R1,68,1000,856,144,1.085776330076,2.21538461538462,0.0201248752688649
2010,"ICT, Chinese Academy of Sciences",ICTNETAD10R1,69,1000,929,71,1.03950103950104,2.15151515151515,0.0136456792030803
2010,"ICT, Chinese Academy of Sciences",ICTNETAD10R1,70,1000,947,53,1.03412616339193,2.65,0.0537252060315667
2010,"ICT, Chinese Academy of Sciences",ICTNETAD10R1,71,1000,944,56,1.03092783505155,2.15384615384615,0.11786920318589
2010,"ICT, Chinese Academy of Sciences",ICTNETAD10R1,72,1000,760,240,1.17096018735363,2.5531914893617,0.492029210827845
2010,"ICT, Chinese Academy of Sciences",ICTNETAD10R1,73,1000,987,13,1.00806451612903,2.6,0.129636328683898
2010,"ICT, Chinese Academy of Sciences",ICTNETAD10R1,74,1000,772,228,1.20048019207683,3.73770491803279,0.0491697187575511
2010,"ICT, Chinese Academy of Sciences",ICTNETAD10R1,75,1000,841,159,1.0989010989011,2.30434782608696,0.0557525294419349
2010,"ICT, Chinese Academy of Sciences",ICTNETAD10R1,76,1000,931,69,1.03734439834025,2.09090909090909,0.0203591156069347
2010,"ICT, Chinese Academy of Sciences",ICTNETAD10R1,77,1000,899,101,1.05820105820106,2.19565217391304,0.00137615772223861
2010,"ICT, Chinese Academy of Sciences",ICTNETAD10R1,78,1000,986,14,1.00704934541793,2,0.00144774293118761
2010,"ICT, Chinese Academy of Sciences",ICTNETAD10R1,79,1000,886,114,1.07181136120043,2.42553191489362,0.277882390607257
2010,"ICT, Chinese Academy of Sciences",ICTNETAD10R1,80,1000,987,13,1.00704934541793,2.16666666666667,0.0536616608729264
2010,"ICT, Chinese Academy of Sciences",ICTNETAD10R1,81,1000,883,117,1.07066381156317,2.29411764705882,0.0620361945756829
2010,"ICT, Chinese Academy of Sciences",ICTNETAD10R1,82,1000,920,80,1.04384133611691,2.10526315789474,0.00149281417417838
2010,"ICT, Chinese Academy of Sciences",ICTNETAD10R1,83,1000,220,780,2.32558139534884,3.71428571428571,0.262969583744986
2010,"ICT, Chinese Academy of Sciences",ICTNETAD10R1,84,1000,885,115,1.06723585912487,2.21153846153846,0.426350146797207
2010,"ICT, Chinese Academy of Sciences",ICTNETAD10R1,85,1000,928,72,1.04058272632674,2.18181818181818,0.00246882249189525
2010,"ICT, Chinese Academy of Sciences",ICTNETAD10R1,86,1000,911,89,1.04931794333683,2.11904761904762,0.213237047908556
2010,"ICT, Chinese Academy of Sciences",ICTNETAD10R1,87,1000,954,46,1.02880658436214,2.55555555555556,0.0818756101159098
2010,"ICT, Chinese Academy of Sciences",ICTNETAD10R1,88,1000,961,39,1.02145045965271,2.16666666666667,0.000231890124110362
2010,"ICT, Chinese Academy of Sciences",ICTNETAD10R1,89,1000,933,67,1.03734439834025,2.16129032258065,0.0883425407796933
2010,"ICT, Chinese Academy of Sciences",ICTNETAD10R1,90,1000,836,164,1.10619469026549,2.41176470588235,0.463919629305145
2010,"ICT, Chinese Academy of Sciences",ICTNETAD10R1,91,1000,926,74,1.04493207941484,2.38709677419355,0.32851
2010,"ICT, Chinese Academy of Sciences",ICTNETAD10R1,92,1000,921,79,1.04602510460251,2.25714285714286,3.77968223639551e-05
2010,"ICT, Chinese Academy of Sciences",ICTNETAD10R1,93,1000,925,75,1.04493207941484,2.34375,0.214688562971274
2010,"ICT, Chinese Academy of Sciences",ICTNETAD10R1,94,1000,643,357,1.45772594752187,8.30232558139535,0.0767265788587627
2010,"ICT, Chinese Academy of Sciences",ICTNETAD10R1,95,1000,177,823,5.0761421319797,41.15,2.05928889236937e-06
2010,"ICT, Chinese Academy of Sciences",ICTNETAD10R1,96,1000,810,190,1.12994350282486,2.53333333333333,0.0100798215102777
2010,"ICT, Chinese Academy of Sciences",ICTNETAD10R1,97,1000,891,109,1.06837606837607,2.42222222222222,0.20143408680975
2010,"ICT, Chinese Academy of Sciences",ICTNETAD10R1,98,1000,838,162,1.10497237569061,2.41791044776119,0.117352006420244
2010,"ICT, Chinese Academy of Sciences",ICTNETAD10R1,99,1000,929,71,1.05932203389831,4.73333333333333,0.515030420148218
2010,"ICT, Chinese Academy of Sciences",ICTNETAD10R1,100,1000,843,157,1.11607142857143,2.9622641509434,0.0126561085946221
2010,"ICT, Chinese Academy of Sciences",ICTNETAD10R2,51,1000,130,870,3.73134328358209,6.30434782608696,0.360957466391872
2010,"ICT, Chinese Academy of Sciences",ICTNETAD10R2,52,1000,594,406,1.45560407569141,4.36559139784946,0.226188967874671
2010,"ICT, Chinese Academy of Sciences",ICTNETAD10R2,53,1000,90,910,4.54545454545455,7,0.626390282651097
2010,"ICT, Chinese Academy of Sciences",ICTNETAD10R2,54,1000,168,832,2.9585798816568,4.89411764705882,0.433234404924575
2010,"ICT, Chinese Academy of Sciences",ICTNETAD10R2,55,1000,863,137,1.09170305676856,2.58490566037736,0.231279405458928
2010,"ICT, Chinese Academy of Sciences",ICTNETAD10R2,56,880,683,197,1.20383036935705,4.10416666666667,0.0437739296004195
2010,"ICT, Chinese Academy of Sciences",ICTNETAD10R2,57,1000,83,917,5.15463917525773,8.26126126126126,0.438546521181917
2010,"ICT, Chinese Academy of Sciences",ICTNETAD10R2,58,1000,17,983,16.6666666666667,22.8604651162791,0.999999994049888
2010,"ICT, Chinese Academy of Sciences",ICTNETAD10R2,59,1000,405,595,1.73913043478261,3.5,0.19171862910812
2010,"ICT, Chinese Academy of Sciences",ICTNETAD10R2,60,1000,827,173,1.10497237569061,2.21794871794872,0.00916768251537102
2010,"ICT, Chinese Academy of Sciences",ICTNETAD10R2,61,1000,884,116,1.06382978723404,2.07142857142857,0.0649031854786024
2010,"ICT, Chinese Academy of Sciences",ICTNETAD10R2,62,1000,168,832,3.23624595469256,5.90070921985816,0.386747053722688
2010,"ICT, Chinese Academy of Sciences",ICTNETAD10R2,63,1000,926,74,1.04058272632674,2.11428571428571,0.00379256476421956
2010,"ICT, Chinese Academy of Sciences",ICTNETAD10R2,64,1000,49,951,7.57575757575758,11.4578313253012,0.996028669953697
2010,"ICT, Chinese Academy of Sciences",ICTNETAD10R2,65,1000,34,966,8.47457627118644,11.5,0.856705845977842
2010,"ICT, Chinese Academy of Sciences",ICTNETAD10R2,66,1000,295,705,2.27272727272727,4.86206896551724,0.582448935260172
2010,"ICT, Chinese Academy of Sciences",ICTNETAD10R2,67,350,296,54,1.08359133126935,2,0.277611805144102
2010,"ICT, Chinese Academy of Sciences",ICTNETAD10R2,68,1000,906,94,1.0515247108307,2.08888888888889,1.33042916294038e-05
2010,"ICT, Chinese Academy of Sciences",ICTNETAD10R2,69,1000,139,861,3.98406374501992,7.6875,0.612918244431343
2010,"ICT, Chinese Academy of Sciences",ICTNETAD10R2,70,1000,238,762,2.93255131964809,7.39805825242719,0.268367803170183
2010,"ICT, Chinese Academy of Sciences",ICTNETAD10R2,71,1000,106,894,4.95049504950495,9.3125,0.319454638076028
2010,"ICT, Chinese Academy of Sciences",ICTNETAD10R2,72,1000,1,999,38.4615384615385,39.96,1
2010,"ICT, Chinese Academy of Sciences",ICTNETAD10R2,73,1000,37,963,8.92857142857143,12.84,0.947194022589809
2010,"ICT, Chinese Academy of Sciences",ICTNETAD10R2,74,1000,634,366,1.46627565982405,7.625,0.0450345254993938
2010,"ICT, Chinese Academy of Sciences",ICTNETAD10R2,75,1000,49,951,7.8125,12.0379746835443,0.99999950508183
2010,"ICT, Chinese Academy of Sciences",ICTNETAD10R2,76,1000,221,779,2.7027027027027,5.22818791946309,0.35873328855041
2010,"ICT, Chinese Academy of Sciences",ICTNETAD10R2,77,1000,899,101,1.05708245243129,2.14893617021277,0.328147548652011
2010,"ICT, Chinese Academy of Sciences",ICTNETAD10R2,78,1000,41,959,9.70873786407767,15.4677419354839,0.98433697847286
2010,"ICT, Chinese Academy of Sciences",ICTNETAD10R2,79,1000,887,113,1.06496272630458,2.17307692307692,0.180036239166564
2010,"ICT, Chinese Academy of Sciences",ICTNETAD10R2,80,1000,159,841,3.90625,8.67010309278351,0.462404513875993
2010,"ICT, Chinese Academy of Sciences",ICTNETAD10R2,81,1000,902,98,1.05820105820106,2.27906976744186,0.0413181232743563
2010,"ICT, Chinese Academy of Sciences",ICTNETAD10R2,82,1000,21,979,17.2413793103448,26.4594594594595,0.99817519963686
2010,"ICT, Chinese Academy of Sciences",ICTNETAD10R2,83,1000,725,275,1.30208333333333,6.3953488372093,0.109053820651352
2010,"ICT, Chinese Academy of Sciences",ICTNETAD10R2,84,1000,139,861,3.34448160535117,5.38125,0.68484123190642
2010,"ICT, Chinese Academy of Sciences",ICTNETAD10R2,85,1000,183,817,3.03951367781155,5.5958904109589,0.476393046230391
2010,"ICT, Chinese Academy of Sciences",ICTNETAD10R2,86,1000,76,924,5.20833333333333,7.96551724137931,0.447078630911885
2010,"ICT, Chinese Academy of Sciences",ICTNETAD10R2,87,1000,179,821,3.46020761245675,7.46363636363636,0.206299856527952
2010,"ICT, Chinese Academy of Sciences",ICTNETAD10R2,88,1000,161,839,2.89017341040462,4.53513513513514,0.124807759020014
2010,"ICT, Chinese Academy of Sciences",ICTNETAD10R2,89,1000,896,104,1.07296137339056,2.88888888888889,0.0948313968972629
2010,"ICT, Chinese Academy of Sciences",ICTNETAD10R2,90,1000,672,328,1.29032258064516,3.18446601941748,0.113732356069184
2010,"ICT, Chinese Academy of Sciences",ICTNETAD10R2,91,1000,68,932,9.25925925925926,23.3,0.5841094851876
2010,"ICT, Chinese Academy of Sciences",ICTNETAD10R2,92,1000,13,987,20,26.6756756756757,0.999778146876554
2010,"ICT, Chinese Academy of Sciences",ICTNETAD10R2,93,1000,44,956,8.47457627118644,12.9189189189189,0.985413956444109
2010,"ICT, Chinese Academy of Sciences",ICTNETAD10R2,94,1000,885,115,1.06382978723404,2.09090909090909,0.0630275614116515
2010,"ICT, Chinese Academy of Sciences",ICTNETAD10R2,95,1000,782,218,1.18483412322275,3.51612903225806,0.593398030168497
2010,"ICT, Chinese Academy of Sciences",ICTNETAD10R2,96,1000,895,105,1.05932203389831,2.14285714285714,0.136841134780784
2010,"ICT, Chinese Academy of Sciences",ICTNETAD10R2,97,1000,1,999,100,111,1
2010,"ICT, Chinese Academy of Sciences",ICTNETAD10R2,98,1000,897,103,1.06382978723404,2.3953488372093,1.04768188491529e-06
2010,"ICT, Chinese Academy of Sciences",ICTNETAD10R2,99,1000,883,117,1.09409190371991,3.7741935483871,0.00137761076715199
2010,"ICT, Chinese Academy of Sciences",ICTNETAD10R2,100,1000,162,838,3.003003003003,4.90058479532164,0.504230929249344
2010,"ICT, Chinese Academy of Sciences",ICTNETAD10R3,51,1000,130,870,3.73134328358209,6.30434782608696,0.360957466391872
2010,"ICT, Chinese Academy of Sciences",ICTNETAD10R3,52,1000,594,406,1.45560407569141,4.36559139784946,0.226188967874671
2010,"ICT, Chinese Academy of Sciences",ICTNETAD10R3,53,1000,90,910,4.54545454545455,7,0.626390282651097
2010,"ICT, Chinese Academy of Sciences",ICTNETAD10R3,54,1000,168,832,2.9585798816568,4.89411764705882,0.433234404924575
2010,"ICT, Chinese Academy of Sciences",ICTNETAD10R3,55,1000,863,137,1.09170305676856,2.58490566037736,0.231279405458928
2010,"ICT, Chinese Academy of Sciences",ICTNETAD10R3,56,880,683,197,1.20383036935705,4.10416666666667,0.0437739296004195
2010,"ICT, Chinese Academy of Sciences",ICTNETAD10R3,57,1000,83,917,5.15463917525773,8.26126126126126,0.438546521181917
2010,"ICT, Chinese Academy of Sciences",ICTNETAD10R3,58,1000,17,983,16.6666666666667,22.8604651162791,0.999999994049888
2010,"ICT, Chinese Academy of Sciences",ICTNETAD10R3,59,1000,405,595,1.73913043478261,3.5,0.19171862910812
2010,"ICT, Chinese Academy of Sciences",ICTNETAD10R3,60,1000,827,173,1.10497237569061,2.21794871794872,0.00916768251537102
2010,"ICT, Chinese Academy of Sciences",ICTNETAD10R3,61,1000,884,116,1.06382978723404,2.07142857142857,0.0649031854786024
2010,"ICT, Chinese Academy of Sciences",ICTNETAD10R3,62,1000,168,832,3.23624595469256,5.90070921985816,0.386747053722688
2010,"ICT, Chinese Academy of Sciences",ICTNETAD10R3,63,1000,926,74,1.04058272632674,2.11428571428571,0.00379256476421956
2010,"ICT, Chinese Academy of Sciences",ICTNETAD10R3,64,1000,49,951,7.57575757575758,11.4578313253012,0.996028669953697
2010,"ICT, Chinese Academy of Sciences",ICTNETAD10R3,65,1000,34,966,8.47457627118644,11.5,0.856705845977842
2010,"ICT, Chinese Academy of Sciences",ICTNETAD10R3,66,1000,295,705,2.27272727272727,4.86206896551724,0.582448935260172
2010,"ICT, Chinese Academy of Sciences",ICTNETAD10R3,67,350,296,54,1.08359133126935,2,0.277611805144102
2010,"ICT, Chinese Academy of Sciences",ICTNETAD10R3,68,1000,906,94,1.0515247108307,2.08888888888889,1.33042916294038e-05
2010,"ICT, Chinese Academy of Sciences",ICTNETAD10R3,69,1000,139,861,3.98406374501992,7.6875,0.612918244431343
2010,"ICT, Chinese Academy of Sciences",ICTNETAD10R3,70,1000,238,762,2.93255131964809,7.39805825242719,0.268367803170183
2010,"ICT, Chinese Academy of Sciences",ICTNETAD10R3,71,1000,106,894,4.95049504950495,9.3125,0.319454638076028
2010,"ICT, Chinese Academy of Sciences",ICTNETAD10R3,72,1000,1,999,38.4615384615385,39.96,1
2010,"ICT, Chinese Academy of Sciences",ICTNETAD10R3,73,1000,37,963,8.92857142857143,12.84,0.947194022589809
2010,"ICT, Chinese Academy of Sciences",ICTNETAD10R3,74,1000,634,366,1.46627565982405,7.625,0.0450345254993938
2010,"ICT, Chinese Academy of Sciences",ICTNETAD10R3,75,1000,49,951,7.8125,12.0379746835443,0.99999950508183
2010,"ICT, Chinese Academy of Sciences",ICTNETAD10R3,76,1000,221,779,2.7027027027027,5.22818791946309,0.35873328855041
2010,"ICT, Chinese Academy of Sciences",ICTNETAD10R3,77,1000,899,101,1.05708245243129,2.14893617021277,0.328147548652011
2010,"ICT, Chinese Academy of Sciences",ICTNETAD10R3,78,1000,41,959,9.70873786407767,15.4677419354839,0.98433697847286
2010,"ICT, Chinese Academy of Sciences",ICTNETAD10R3,79,1000,887,113,1.06496272630458,2.17307692307692,0.180036239166564
2010,"ICT, Chinese Academy of Sciences",ICTNETAD10R3,80,1000,159,841,3.90625,8.67010309278351,0.462404513875993
2010,"ICT, Chinese Academy of Sciences",ICTNETAD10R3,81,1000,902,98,1.05820105820106,2.27906976744186,0.0413181232743563
2010,"ICT, Chinese Academy of Sciences",ICTNETAD10R3,82,1000,21,979,17.2413793103448,26.4594594594595,0.99817519963686
2010,"ICT, Chinese Academy of Sciences",ICTNETAD10R3,83,1000,725,275,1.30208333333333,6.3953488372093,0.109053820651352
2010,"ICT, Chinese Academy of Sciences",ICTNETAD10R3,84,1000,139,861,3.34448160535117,5.38125,0.68484123190642
2010,"ICT, Chinese Academy of Sciences",ICTNETAD10R3,85,1000,183,817,3.03951367781155,5.5958904109589,0.476393046230391
2010,"ICT, Chinese Academy of Sciences",ICTNETAD10R3,86,1000,76,924,5.20833333333333,7.96551724137931,0.447078630911885
2010,"ICT, Chinese Academy of Sciences",ICTNETAD10R3,87,1000,179,821,3.46020761245675,7.46363636363636,0.206299856527952
2010,"ICT, Chinese Academy of Sciences",ICTNETAD10R3,88,1000,161,839,2.89017341040462,4.53513513513514,0.124807759020014
2010,"ICT, Chinese Academy of Sciences",ICTNETAD10R3,89,1000,896,104,1.07296137339056,2.88888888888889,0.0948313968972629
2010,"ICT, Chinese Academy of Sciences",ICTNETAD10R3,90,1000,672,328,1.29032258064516,3.18446601941748,0.113732356069184
2010,"ICT, Chinese Academy of Sciences",ICTNETAD10R3,91,1000,68,932,9.25925925925926,23.3,0.5841094851876
2010,"ICT, Chinese Academy of Sciences",ICTNETAD10R3,92,1000,13,987,20,26.6756756756757,0.999778146876554
2010,"ICT, Chinese Academy of Sciences",ICTNETAD10R3,93,1000,44,956,8.47457627118644,12.9189189189189,0.985413956444109
2010,"ICT, Chinese Academy of Sciences",ICTNETAD10R3,94,1000,885,115,1.06382978723404,2.09090909090909,0.0630275614116515
2010,"ICT, Chinese Academy of Sciences",ICTNETAD10R3,95,1000,782,218,1.18483412322275,3.51612903225806,0.593398030168497
2010,"ICT, Chinese Academy of Sciences",ICTNETAD10R3,96,1000,895,105,1.05932203389831,2.14285714285714,0.136841134780784
2010,"ICT, Chinese Academy of Sciences",ICTNETAD10R3,97,1000,1,999,100,111,1
2010,"ICT, Chinese Academy of Sciences",ICTNETAD10R3,98,1000,897,103,1.06382978723404,2.3953488372093,1.04768188491529e-06
2010,"ICT, Chinese Academy of Sciences",ICTNETAD10R3,99,1000,883,117,1.09409190371991,3.7741935483871,0.00137761076715199
2010,"ICT, Chinese Academy of Sciences",ICTNETAD10R3,100,1000,162,838,3.003003003003,4.90058479532164,0.504230929249344
2010,University of Maryland,IvoryBM25a,51,1000,967,33,1.01729399796541,2.0625,0.0736098929122787
2010,University of Maryland,IvoryBM25a,52,1000,938,62,1.03734439834025,2.38461538461538,0.000688941991868293
2010,University of Maryland,IvoryBM25a,53,1000,976,24,1.01317122593718,2.18181818181818,0.0930647212631222
2010,University of Maryland,IvoryBM25a,54,1000,930,70,1.04275286757039,2.41379310344828,0.00160458405215058
2010,University of Maryland,IvoryBM25a,55,1000,802,198,1.14025085518814,2.64,0.0913964316716415
2010,University of Maryland,IvoryBM25a,56,1000,916,84,1.05596620908131,2.70967741935484,0.0194563214673535
2010,University of Maryland,IvoryBM25a,57,1000,969,31,1.01936799184506,2.58333333333333,7.97754120315375e-05
2010,University of Maryland,IvoryBM25a,58,1000,901,99,1.06496272630458,2.60526315789474,0.0777739251439574
2010,University of Maryland,IvoryBM25a,59,1000,975,25,1.01317122593718,2.08333333333333,9.20915756392254e-08
2010,University of Maryland,IvoryBM25a,60,1000,976,24,1.01317122593718,2.18181818181818,0.0072495016296009
2010,University of Maryland,IvoryBM25a,61,1000,908,92,1.05485232067511,2.3,1.64844402209013e-05
2010,University of Maryland,IvoryBM25a,62,1000,976,24,1.01419878296146,2.4,0.00108845705108441
2010,University of Maryland,IvoryBM25a,63,1000,963,37,1.02040816326531,2.17647058823529,0.000968858152483535
2010,University of Maryland,IvoryBM25a,64,1000,915,85,1.0515247108307,2.36111111111111,2.68217601814634e-06
2010,University of Maryland,IvoryBM25a,65,1000,928,72,1.04166666666667,2.25,0.0523610065790835
2010,University of Maryland,IvoryBM25a,66,1000,977,23,1.01419878296146,2.55555555555556,0.0695676183186927
2010,University of Maryland,IvoryBM25a,67,1000,943,57,1.03412616339193,2.375,0.0909070561200775
2010,University of Maryland,IvoryBM25a,68,1000,923,77,1.04712041884817,2.40625,2.26345017402925e-11
2010,University of Maryland,IvoryBM25a,69,1000,953,47,1.03092783505155,2.76470588235294,0.000544491993500768
2010,University of Maryland,IvoryBM25a,70,1000,923,77,1.04275286757039,2.13888888888889,0.203187391492065
2010,University of Maryland,IvoryBM25a,71,1000,959,41,1.02459016393443,2.41176470588235,0.00346712068996614
2010,University of Maryland,IvoryBM25a,72,1000,956,44,1.02249488752556,2,2.82906531491211e-05
2010,University of Maryland,IvoryBM25a,73,1000,922,78,1.04931794333683,2.51612903225806,0.0963418706482202
2010,University of Maryland,IvoryBM25a,74,1000,879,121,1.08813928182807,3.025,0.0466798045988875
2010,University of Maryland,IvoryBM25a,75,1000,906,94,1.05374077976818,2.18604651162791,0.0648861495324233
2010,University of Maryland,IvoryBM25a,76,1000,968,32,1.01626016260163,2,0.0143359697287854
2010,University of Maryland,IvoryBM25a,77,1000,943,57,1.03305785123967,2.28,0.160314313711877
2010,University of Maryland,IvoryBM25a,78,1000,982,18,1.00908173562059,2,1.87682326266709e-12
2010,University of Maryland,IvoryBM25a,79,1000,473,527,1.73010380622837,5.01904761904762,0.000874202790466504
2010,University of Maryland,IvoryBM25a,80,1000,1000,0,1,,0
2010,University of Maryland,IvoryBM25a,81,1000,869,131,1.09529025191676,2.97727272727273,0.101617011941387
2010,University of Maryland,IvoryBM25a,82,1000,943,57,1.0351966873706,2.47826086956522,0.00053585418178797
2010,University of Maryland,IvoryBM25a,83,1000,844,156,1.09649122807018,2.29411764705882,0.00258064154407042
2010,University of Maryland,IvoryBM25a,84,1000,903,97,1.05820105820106,2.30952380952381,0.32479148972888
2010,University of Maryland,IvoryBM25a,85,1000,978,22,1.01112234580384,2,0.0736611400151597
2010,University of Maryland,IvoryBM25a,86,1000,935,65,1.03734439834025,2.24137931034483,0.0281961898101494
2010,University of Maryland,IvoryBM25a,87,1000,985,15,1.00806451612903,2.14285714285714,0.00994417311351664
2010,University of Maryland,IvoryBM25a,88,1000,954,46,1.02669404517454,2.3,2.07732772369463e-05
2010,University of Maryland,IvoryBM25a,89,1000,953,47,1.02564102564103,2.13636363636364,0.00120894045203053
2010,University of Maryland,IvoryBM25a,90,1000,942,58,1.03412616339193,2.32,0.166817553458644
2010,University of Maryland,IvoryBM25a,91,1000,903,97,1.06837606837607,2.93939393939394,1.70922976085245e-08
2010,University of Maryland,IvoryBM25a,92,1000,932,68,1.03950103950104,2.26666666666667,0.20443162475691
2010,University of Maryland,IvoryBM25a,93,1000,954,46,1.02774922918808,2.42105263157895,0.0954090665134862
2010,University of Maryland,IvoryBM25a,94,1000,909,91,1.05708245243129,2.45945945945946,0.204236978370897
2010,University of Maryland,IvoryBM25a,95,1000,931,69,1.05374077976818,3.83333333333333,1.47242679086485e-08
2010,University of Maryland,IvoryBM25a,96,1000,949,51,1.02669404517454,2.04,0.0662662111176305
2010,University of Maryland,IvoryBM25a,97,1000,961,39,1.02040816326531,2.05263157894737,0.0316866484259683
2010,University of Maryland,IvoryBM25a,98,1000,958,42,1.02669404517454,2.625,1.02395210738363e-07
2010,University of Maryland,IvoryBM25a,99,1000,703,297,1.25156445556946,3.09375,0.21956955976662
2010,University of Maryland,IvoryBM25a,100,1000,928,72,1.04931794333683,2.88,0.13976647375578
2010,University of Southern California / ISI,IvoryL2Rb,51,1000,959,41,1.02354145342886,2.27777777777778,6.04953017445793e-12
2010,University of Southern California / ISI,IvoryL2Rb,52,1000,972,28,1.01522842639594,2.15384615384615,1.15718262100833e-18
2010,University of Southern California / ISI,IvoryL2Rb,53,1000,988,12,1.00806451612903,3,0.00549503894813954
2010,University of Southern California / ISI,IvoryL2Rb,54,1000,924,76,1.04384133611691,2.23529411764706,0.000457461961657759
2010,University of Southern California / ISI,IvoryL2Rb,55,1000,925,75,1.04712041884817,2.5,0.0909590847894906
2010,University of Southern California / ISI,IvoryL2Rb,56,1000,919,81,1.04493207941484,2.13157894736842,0.043467061286331
2010,University of Southern California / ISI,IvoryL2Rb,57,1000,997,3,1.00200400801603,3,0.00172428775454784
2010,University of Southern California / ISI,IvoryL2Rb,58,1000,955,45,1.02774922918808,2.5,0.0925665040813204
2010,University of Southern California / ISI,IvoryL2Rb,59,1000,973,27,1.0183299389002,3,6.61129771041564e-09
2010,University of Southern California / ISI,IvoryL2Rb,60,1000,978,22,1.01112234580384,2,0.0189382290051918
2010,University of Southern California / ISI,IvoryL2Rb,61,1000,940,60,1.0351966873706,2.30769230769231,0.0237426158202233
2010,University of Southern California / ISI,IvoryL2Rb,62,1000,966,34,1.02459016393443,3.4,0.0374381266310876
2010,University of Southern California / ISI,IvoryL2Rb,63,1000,963,37,1.02040816326531,2.17647058823529,1.76087896125407e-06
2010,University of Southern California / ISI,IvoryL2Rb,64,1000,931,69,1.03842159916926,2.15625,0.000305091399908606
2010,University of Southern California / ISI,IvoryL2Rb,65,1000,933,67,1.04166666666667,2.48148148148148,0.0851708178480136
2010,University of Southern California / ISI,IvoryL2Rb,66,1000,970,30,1.0183299389002,2.5,0.00323730325842678
2010,University of Southern California / ISI,IvoryL2Rb,67,1000,939,61,1.03626943005181,2.34615384615385,0.104307840017573
2010,University of Southern California / ISI,IvoryL2Rb,68,1000,996,4,1.00200400801603,2,1.97316659691315e-26
2010,University of Southern California / ISI,IvoryL2Rb,69,1000,987,13,1.00704934541793,2.16666666666667,2.37704453564918e-07
2010,University of Southern California / ISI,IvoryL2Rb,70,1000,987,13,1.00704934541793,2.16666666666667,0.000146983423946994
2010,University of Southern California / ISI,IvoryL2Rb,71,1000,938,62,1.04058272632674,2.69565217391304,2.16794741487617e-13
2010,University of Southern California / ISI,IvoryL2Rb,72,1000,956,44,1.02774922918808,2.58823529411765,3.56827664019535e-08
2010,University of Southern California / ISI,IvoryL2Rb,73,1000,950,50,1.02774922918808,2.17391304347826,0.0283709202459605
2010,University of Southern California / ISI,IvoryL2Rb,74,1000,976,24,1.01419878296146,2.4,0.0559308409859883
2010,University of Southern California / ISI,IvoryL2Rb,75,1000,900,100,1.05485232067511,2.08333333333333,0.0325883555346169
2010,University of Southern California / ISI,IvoryL2Rb,76,1000,996,4,1.00200400801603,2,1.83120029206301e-24
2010,University of Southern California / ISI,IvoryL2Rb,77,1000,982,18,1.00908173562059,2,6.32680309410348e-05
2010,University of Southern California / ISI,IvoryL2Rb,78,1000,966,34,1.01729399796541,2,1.47879222783972e-08
2010,University of Southern California / ISI,IvoryL2Rb,79,1000,932,68,1.03842159916926,2.19354838709677,1.81703220093963e-05
2010,University of Southern California / ISI,IvoryL2Rb,80,1000,998,2,1.001001001001,2,2.34084429190187e-08
2010,University of Southern California / ISI,IvoryL2Rb,81,1000,867,133,1.0989010989011,3.09302325581395,2.7092311695678e-05
2010,University of Southern California / ISI,IvoryL2Rb,82,1000,929,71,1.04166666666667,2.29032258064516,0.0252852646932763
2010,University of Southern California / ISI,IvoryL2Rb,83,1000,980,20,1.01010101010101,2,4.6739125589373e-11
2010,University of Southern California / ISI,IvoryL2Rb,84,1000,951,49,1.02669404517454,2.1304347826087,0.0129951432406268
2010,University of Southern California / ISI,IvoryL2Rb,85,1000,977,23,1.01214574898785,2.09090909090909,4.22473848945607e-07
2010,University of Southern California / ISI,IvoryL2Rb,86,1000,993,7,1.00401606425703,2.33333333333333,3.85344815301074e-29
2010,University of Southern California / ISI,IvoryL2Rb,87,1000,954,46,1.02669404517454,2.3,0.00898286775104569
2010,University of Southern California / ISI,IvoryL2Rb,88,1000,964,36,1.02459016393443,3,1.48940558962295e-10
2010,University of Southern California / ISI,IvoryL2Rb,89,1000,991,9,1.00502512562814,2.25,0.000219295300636397
2010,University of Southern California / ISI,IvoryL2Rb,90,1000,970,30,1.02145045965271,3.33333333333333,0.150846041295981
2010,University of Southern California / ISI,IvoryL2Rb,91,1000,980,20,1.01010101010101,2,0.00037936892051641
2010,University of Southern California / ISI,IvoryL2Rb,92,1000,968,32,1.0183299389002,2.28571428571429,7.96628793425824e-12
2010,University of Southern California / ISI,IvoryL2Rb,93,1000,988,12,1.00603621730382,2,0.0285179807064302
2010,University of Southern California / ISI,IvoryL2Rb,94,1000,915,85,1.0482180293501,2.17948717948718,0.00397577186119218
2010,University of Southern California / ISI,IvoryL2Rb,95,1000,952,48,1.03626943005181,3.69230769230769,0.0641540916327955
2010,University of Southern California / ISI,IvoryL2Rb,96,1000,941,59,1.0351966873706,2.36,0.00108997712132511
2010,University of Southern California / ISI,IvoryL2Rb,97,1000,992,8,1.00401606425703,2,1.69420070309364e-29
2010,University of Southern California / ISI,IvoryL2Rb,98,1000,979,21,1.01419878296146,3,3.36556185312207e-10
2010,University of Southern California / ISI,IvoryL2Rb,99,1000,957,43,1.02354145342886,2.15,2.56326928759966e-08
2010,University of Southern California / ISI,IvoryL2Rb,100,1000,998,2,1.001001001001,2,3.19781169445606e-22
2010,University of Southern California / ISI,IvoryLCEb,51,1000,934,66,1.03626943005181,2.12903225806452,0.055544350058457
2010,University of Southern California / ISI,IvoryLCEb,52,1000,919,81,1.04493207941484,2.13157894736842,0.166852117784101
2010,University of Southern California / ISI,IvoryLCEb,53,1000,961,39,1.02249488752556,2.29411764705882,0.0548038388260517
2010,University of Southern California / ISI,IvoryLCEb,54,1000,779,221,1.15340253748558,2.51136363636364,0.0110561208502364
2010,University of Southern California / ISI,IvoryLCEb,55,1000,811,189,1.12485939257593,2.42307692307692,0.330217872868551
2010,University of Southern California / ISI,IvoryLCEb,56,1000,827,173,1.11358574610245,2.43661971830986,0.1077162244217
2010,University of Southern California / ISI,IvoryLCEb,57,1000,955,45,1.02459016393443,2.14285714285714,0.00106037358727924
2010,University of Southern California / ISI,IvoryLCEb,58,1000,910,90,1.05374077976818,2.30769230769231,0.432452978458339
2010,University of Southern California / ISI,IvoryLCEb,59,1000,928,72,1.04275286757039,2.32258064516129,2.02858053004892e-05
2010,University of Southern California / ISI,IvoryLCEb,60,1000,914,86,1.04712041884817,2.09756097560976,0.0532141262350551
2010,University of Southern California / ISI,IvoryLCEb,61,1000,824,176,1.11482720178372,2.41095890410959,0.000256433535525143
2010,University of Southern California / ISI,IvoryLCEb,62,1000,915,85,1.05820105820106,2.83333333333333,0.0373319351839579
2010,University of Southern California / ISI,IvoryLCEb,63,1000,913,87,1.05042016806723,2.23076923076923,0.000457595331204607
2010,University of Southern California / ISI,IvoryLCEb,64,1000,889,111,1.06723585912487,2.3125,0.00629668115653751
2010,University of Southern California / ISI,IvoryLCEb,65,1000,850,150,1.09769484083425,2.45901639344262,0.593098353424295
2010,University of Southern California / ISI,IvoryLCEb,66,1000,942,58,1.0351966873706,2.41666666666667,0.00797053996597859
2010,University of Southern California / ISI,IvoryLCEb,67,1000,871,129,1.085776330076,2.58,0.482796708549452
2010,University of Southern California / ISI,IvoryLCEb,68,1000,968,32,1.01729399796541,2.13333333333333,0.00284142827821047
2010,University of Southern California / ISI,IvoryLCEb,69,1000,902,98,1.07758620689655,3.76923076923077,7.25941808511083e-10
2010,University of Southern California / ISI,IvoryLCEb,70,1000,917,83,1.0482180293501,2.24324324324324,0.177763508731404
2010,University of Southern California / ISI,IvoryLCEb,71,1000,879,121,1.08695652173913,2.95121951219512,1.00767253571855e-08
2010,University of Southern California / ISI,IvoryLCEb,72,1000,836,164,1.11482720178372,2.68852459016393,0.0596240138854605
2010,University of Southern California / ISI,IvoryLCEb,73,1000,860,140,1.08813928182807,2.3728813559322,0.212034782471387
2010,University of Southern California / ISI,IvoryLCEb,74,1000,945,55,1.03199174406605,2.29166666666667,0.3110087219856
2010,University of Southern California / ISI,IvoryLCEb,75,1000,844,156,1.09051254089422,2.13698630136986,0.129778543313779
2010,University of Southern California / ISI,IvoryLCEb,76,1000,958,42,1.02669404517454,2.625,0.00166205492249609
2010,University of Southern California / ISI,IvoryLCEb,77,1000,925,75,1.04166666666667,2.14285714285714,0.0753153047566492
2010,University of Southern California / ISI,IvoryLCEb,78,1000,980,20,1.01112234580384,2.22222222222222,1.67729562237151e-16
2010,University of Southern California / ISI,IvoryLCEb,79,1000,866,134,1.08459869848156,2.39285714285714,0.0158376242858962
2010,University of Southern California / ISI,IvoryLCEb,80,1000,980,20,1.01010101010101,2,2.83002163277386e-10
2010,University of Southern California / ISI,IvoryLCEb,81,1000,802,198,1.15340253748558,3.04615384615385,0.000457075898530101
2010,University of Southern California / ISI,IvoryLCEb,82,1000,819,181,1.12359550561798,2.54929577464789,0.279326502788118
2010,University of Southern California / ISI,IvoryLCEb,83,1000,890,110,1.06269925611052,2.15686274509804,0.00428808990493691
2010,University of Southern California / ISI,IvoryLCEb,84,1000,883,117,1.07066381156317,2.29411764705882,0.174760304003908
2010,University of Southern California / ISI,IvoryLCEb,85,1000,929,71,1.03842159916926,2.08823529411765,0.0607508110789077
2010,University of Southern California / ISI,IvoryLCEb,86,1000,945,55,1.03199174406605,2.29166666666667,0.124659061170266
2010,University of Southern California / ISI,IvoryLCEb,87,1000,835,165,1.11358574610245,2.61904761904762,0.00374359331992008
2010,University of Southern California / ISI,IvoryLCEb,88,1000,931,69,1.04384133611691,2.55555555555556,0.000642608258177384
2010,University of Southern California / ISI,IvoryLCEb,89,1000,950,50,1.02669404517454,2.08333333333333,0.00078294039611572
2010,University of Southern California / ISI,IvoryLCEb,90,1000,941,59,1.03842159916926,2.68181818181818,0.110139310231886
2010,University of Southern California / ISI,IvoryLCEb,91,1000,964,36,1.02145045965271,2.4,2.24627551175396e-05
2010,University of Southern California / ISI,IvoryLCEb,92,1000,947,53,1.02880658436214,2.12,1.93999376357867e-07
2010,University of Southern California / ISI,IvoryLCEb,93,1000,947,53,1.02986611740474,2.20833333333333,0.0755742831877128
2010,University of Southern California / ISI,IvoryLCEb,94,1000,839,161,1.1001100110011,2.3,0.271038692207604
2010,University of Southern California / ISI,IvoryLCEb,95,1000,937,63,1.04931794333683,3.9375,0.0663153885191627
2010,University of Southern California / ISI,IvoryLCEb,96,1000,885,115,1.0752688172043,2.55555555555556,0.0154763605914893
2010,University of Southern California / ISI,IvoryLCEb,97,1000,962,38,1.02040816326531,2.11111111111111,9.92325309666617e-10
2010,University of Southern California / ISI,IvoryLCEb,98,1000,946,54,1.03412616339193,2.57142857142857,0.00584676206996555
2010,University of Southern California / ISI,IvoryLCEb,99,1000,793,207,1.1454753722795,2.5875,0.0560892138049204
2010,University of Southern California / ISI,IvoryLCEb,100,1000,988,12,1.00603621730382,2,4.47563124372196e-07
2010,University of Maryland,IvorySDa,51,1000,964,36,1.01936799184506,2.11764705882353,0.0187106682124431
2010,University of Maryland,IvorySDa,52,1000,938,62,1.03734439834025,2.38461538461538,0.00124145341504275
2010,University of Maryland,IvorySDa,53,1000,974,26,1.01419878296146,2.16666666666667,0.093743780419506
2010,University of Maryland,IvorySDa,54,1000,913,87,1.05596620908131,2.55882352941176,0.00063388567311751
2010,University of Maryland,IvorySDa,55,1000,771,229,1.17647058823529,2.89873417721519,0.0938557373805508
2010,University of Maryland,IvorySDa,56,1000,911,89,1.05932203389831,2.6969696969697,0.0141836757952868
2010,University of Maryland,IvorySDa,57,1000,929,71,1.05485232067511,3.73684210526316,0.00013303521759786
2010,University of Maryland,IvorySDa,58,1000,901,99,1.06496272630458,2.60526315789474,0.117444910191837
2010,University of Maryland,IvorySDa,59,1000,983,17,1.00908173562059,2.125,4.46612675601954e-14
2010,University of Maryland,IvorySDa,60,1000,976,24,1.01317122593718,2.18181818181818,0.0151556443705199
2010,University of Maryland,IvorySDa,61,1000,964,36,1.0183299389002,2,7.14523986542315e-05
2010,University of Maryland,IvorySDa,62,1000,956,44,1.02774922918808,2.58823529411765,1.10259064223607e-09
2010,University of Maryland,IvorySDa,63,1000,963,37,1.02040816326531,2.17647058823529,0.00614846941491527
2010,University of Maryland,IvorySDa,64,1000,915,85,1.0515247108307,2.36111111111111,2.20612805247347e-05
2010,University of Maryland,IvorySDa,65,1000,931,69,1.03950103950104,2.2258064516129,0.0666544286421243
2010,University of Maryland,IvorySDa,66,1000,975,25,1.01419878296146,2.27272727272727,0.016839796361348
2010,University of Maryland,IvorySDa,67,1000,945,55,1.03305785123967,2.39130434782609,0.0162370318212236
2010,University of Maryland,IvorySDa,68,1000,927,73,1.04493207941484,2.43333333333333,1.91646232282518e-11
2010,University of Maryland,IvorySDa,69,1000,952,48,1.03305785123967,3,0.0323515209134979
2010,University of Maryland,IvorySDa,70,1000,930,70,1.03842159916926,2.12121212121212,0.207438140994186
2010,University of Maryland,IvorySDa,71,1000,943,57,1.03305785123967,2.28,4.14860970034916e-07
2010,University of Maryland,IvorySDa,72,1000,931,69,1.04058272632674,2.3,3.50626616187872e-05
2010,University of Maryland,IvorySDa,73,1000,935,65,1.04166666666667,2.6,0.102603742520722
2010,University of Maryland,IvorySDa,74,1000,874,126,1.09170305676856,3,0.0585617412997148
2010,University of Maryland,IvorySDa,75,1000,892,108,1.06157112526539,2.16,0.0726914800058697
2010,University of Maryland,IvorySDa,76,1000,952,48,1.02564102564103,2.08695652173913,0.0676372971656442
2010,University of Maryland,IvorySDa,77,1000,945,55,1.03199174406605,2.29166666666667,0.160988781003457
2010,University of Maryland,IvorySDa,78,1000,978,22,1.01112234580384,2,7.40713297669617e-10
2010,University of Maryland,IvorySDa,79,1000,496,504,1.66666666666667,4.84615384615385,0.00132343607268021
2010,University of Maryland,IvorySDa,80,1000,966,34,1.02880658436214,5.66666666666667,6.89421630171447e-20
2010,University of Maryland,IvorySDa,81,1000,864,136,1.0989010989011,2.95652173913043,0.0736476790820031
2010,University of Maryland,IvorySDa,82,1000,940,60,1.03734439834025,2.5,0.00165736098157055
2010,University of Maryland,IvorySDa,83,1000,856,144,1.08695652173913,2.25,0.00152471811619176
2010,University of Maryland,IvorySDa,84,1000,903,97,1.05932203389831,2.36585365853659,0.424997208155582
2010,University of Maryland,IvorySDa,85,1000,969,31,1.01626016260163,2.06666666666667,0.0663270122998121
2010,University of Maryland,IvorySDa,86,1000,957,43,1.02249488752556,2.04761904761905,0.0341480180435317
2010,University of Maryland,IvorySDa,87,1000,972,28,1.01626016260163,2.33333333333333,9.8309252419013e-09
2010,University of Maryland,IvorySDa,88,1000,954,46,1.02669404517454,2.3,0.000979219067679999
2010,University of Maryland,IvorySDa,89,1000,957,43,1.02354145342886,2.15,0.00204735677183438
2010,University of Maryland,IvorySDa,90,1000,942,58,1.03412616339193,2.32,0.144554608022996
2010,University of Maryland,IvorySDa,91,1000,864,136,1.09649122807018,2.83333333333333,0.00065046352922647
2010,University of Maryland,IvorySDa,92,1000,936,64,1.03734439834025,2.28571428571429,0.219495660746585
2010,University of Maryland,IvorySDa,93,1000,952,48,1.02880658436214,2.4,0.074161429826735
2010,University of Maryland,IvorySDa,94,1000,911,89,1.05596620908131,2.47222222222222,0.281286195291153
2010,University of Maryland,IvorySDa,95,1000,910,90,1.05485232067511,2.36842105263158,0.0206762741356327
2010,University of Maryland,IvorySDa,96,1000,951,49,1.02564102564103,2.04166666666667,0.0536793660571862
2010,University of Maryland,IvorySDa,97,1000,965,35,1.0183299389002,2.05882352941176,0.0391193160923537
2010,University of Maryland,IvorySDa,98,1000,958,42,1.02669404517454,2.625,1.90930272839138e-09
2010,University of Maryland,IvorySDa,99,1000,730,270,1.21506682867558,2.90322580645161,0.283363304244212
2010,University of Maryland,IvorySDa,100,1000,926,74,1.05042016806723,2.84615384615385,0.0868559161036863
2010,University of Maryland,IvoryWSDa,51,1000,962,38,1.02040816326531,2.11111111111111,0.0136401754935311
2010,University of Maryland,IvoryWSDa,52,1000,936,64,1.03842159916926,2.37037037037037,0.00174075294644376
2010,University of Maryland,IvoryWSDa,53,1000,972,28,1.01522842639594,2.15384615384615,0.0438533119249084
2010,University of Maryland,IvoryWSDa,54,1000,940,60,1.03734439834025,2.5,0.00840760225410861
2010,University of Maryland,IvoryWSDa,55,1000,759,241,1.18483412322275,2.83529411764706,0.105041633114797
2010,University of Maryland,IvoryWSDa,56,1000,909,91,1.06044538706257,2.67647058823529,0.00932108439297507
2010,University of Maryland,IvoryWSDa,57,1000,916,84,1.05374077976818,2.54545454545455,0.000276614264311344
2010,University of Maryland,IvoryWSDa,58,1000,918,82,1.05042016806723,2.41176470588235,0.121636720718176
2010,University of Maryland,IvoryWSDa,59,1000,977,23,1.01214574898785,2.09090909090909,1.56227615148263e-16
2010,University of Maryland,IvoryWSDa,60,1000,976,24,1.01317122593718,2.18181818181818,0.0434659977761422
2010,University of Maryland,IvoryWSDa,61,1000,960,40,1.02145045965271,2.10526315789474,0.000207222124040343
2010,University of Maryland,IvoryWSDa,62,1000,956,44,1.02774922918808,2.58823529411765,2.24682189203257e-12
2010,University of Maryland,IvoryWSDa,63,1000,961,39,1.02145045965271,2.16666666666667,0.0128550258353514
2010,University of Maryland,IvoryWSDa,64,1000,915,85,1.0515247108307,2.36111111111111,9.64317108715484e-05
2010,University of Maryland,IvoryWSDa,65,1000,932,68,1.03950103950104,2.26666666666667,0.405156680157374
2010,University of Maryland,IvoryWSDa,66,1000,944,56,1.03412616339193,2.43478260869565,0.0285641032561728
2010,University of Maryland,IvoryWSDa,67,1000,947,53,1.03199174406605,2.40909090909091,0.00815441193132968
2010,University of Maryland,IvoryWSDa,68,1000,930,70,1.04275286757039,2.41379310344828,3.19163179039399e-12
2010,University of Maryland,IvoryWSDa,69,1000,946,54,1.03734439834025,3,0.0443773909471226
2010,University of Maryland,IvoryWSDa,70,1000,936,64,1.0351966873706,2.13333333333333,0.222728359146121
2010,University of Maryland,IvoryWSDa,71,1000,949,51,1.02986611740474,2.31818181818182,0.00388879402565067
2010,University of Maryland,IvoryWSDa,72,1000,889,111,1.07411385606874,2.64285714285714,3.0214834555183e-05
2010,University of Maryland,IvoryWSDa,73,1000,987,13,1.00704934541793,2.16666666666667,0.00205889048819929
2010,University of Maryland,IvoryWSDa,74,1000,872,128,1.09289617486339,2.97674418604651,0.0822569055442155
2010,University of Maryland,IvoryWSDa,75,1000,890,110,1.06269925611052,2.15686274509804,0.0814080126810456
2010,University of Maryland,IvoryWSDa,76,1000,946,54,1.02880658436214,2.07692307692308,0.0928733407120462
2010,University of Maryland,IvoryWSDa,77,1000,945,55,1.03199174406605,2.29166666666667,0.160175786638276
2010,University of Maryland,IvoryWSDa,78,1000,978,22,1.01112234580384,2,4.04189607165957e-08
2010,University of Maryland,IvoryWSDa,79,1000,524,476,1.6,4.71287128712871,0.000492022906899362
2010,University of Maryland,IvoryWSDa,80,1000,966,34,1.02880658436214,5.66666666666667,1.94354306486076e-21
2010,University of Maryland,IvoryWSDa,81,1000,863,137,1.0989010989011,2.91489361702128,0.048329630582195
2010,University of Maryland,IvoryWSDa,82,1000,936,64,1.03950103950104,2.46153846153846,0.0039885537401399
2010,University of Maryland,IvoryWSDa,83,1000,860,140,1.08459869848156,2.25806451612903,0.000855430893355349
2010,University of Maryland,IvoryWSDa,84,1000,909,91,1.05596620908131,2.39473684210526,0.62590720718536
2010,University of Maryland,IvoryWSDa,85,1000,965,35,1.0183299389002,2.05882352941176,0.060967246851264
2010,University of Maryland,IvoryWSDa,86,1000,951,49,1.02564102564103,2.04166666666667,0.0584176073910534
2010,University of Maryland,IvoryWSDa,87,1000,929,71,1.04166666666667,2.29032258064516,2.17696621025099e-06
2010,University of Maryland,IvoryWSDa,88,1000,954,46,1.02669404517454,2.3,0.000379368841466742
2010,University of Maryland,IvoryWSDa,89,1000,953,47,1.02564102564103,2.13636363636364,0.0052849470151754
2010,University of Maryland,IvoryWSDa,90,1000,942,58,1.03412616339193,2.32,0.124230112019071
2010,University of Maryland,IvoryWSDa,91,1000,865,135,1.09649122807018,2.87234042553192,4.11212168164023e-05
2010,University of Maryland,IvoryWSDa,92,1000,942,58,1.03412616339193,2.32,0.255740317774844
2010,University of Maryland,IvoryWSDa,93,1000,952,48,1.02880658436214,2.4,0.0737835296294105
2010,University of Maryland,IvoryWSDa,94,1000,906,94,1.05932203389831,2.47368421052632,0.277853895074163
2010,University of Maryland,IvoryWSDa,95,1000,945,55,1.03092783505155,2.2,0.00244076113765903
2010,University of Maryland,IvoryWSDa,96,1000,936,64,1.03626943005181,2.20689655172414,0.0391681552913735
2010,University of Maryland,IvoryWSDa,97,1000,947,53,1.02880658436214,2.12,0.171000004458276
2010,University of Maryland,IvoryWSDa,98,1000,957,43,1.02669404517454,2.52941176470588,3.13217058432209e-10
2010,University of Maryland,IvoryWSDa,99,1000,774,226,1.16822429906542,2.75609756097561,0.305168183063677
2010,University of Maryland,IvoryWSDa,100,1000,926,74,1.05042016806723,2.84615384615385,2.54581877417442e-06
2010,University of Southern California / ISI,IvoryWSDb,51,1000,934,66,1.03626943005181,2.12903225806452,0.0410789889175154
2010,University of Southern California / ISI,IvoryWSDb,52,1000,919,81,1.04493207941484,2.13157894736842,0.125409138808162
2010,University of Southern California / ISI,IvoryWSDb,53,1000,960,40,1.02354145342886,2.35294117647059,0.0310065920123921
2010,University of Southern California / ISI,IvoryWSDb,54,1000,748,252,1.18063754427391,2.54545454545455,0.00528502238359344
2010,University of Southern California / ISI,IvoryWSDb,55,1000,807,193,1.12866817155756,2.44303797468354,0.333402937448522
2010,University of Southern California / ISI,IvoryWSDb,56,1000,820,180,1.11856823266219,2.43243243243243,0.0963076282208388
2010,University of Southern California / ISI,IvoryWSDb,57,1000,955,45,1.02459016393443,2.14285714285714,0.000799893190938826
2010,University of Southern California / ISI,IvoryWSDb,58,1000,914,86,1.0515247108307,2.32432432432432,0.430216285127361
2010,University of Southern California / ISI,IvoryWSDb,59,1000,928,72,1.04275286757039,2.32258064516129,6.36230317206392e-06
2010,University of Southern California / ISI,IvoryWSDb,60,1000,918,82,1.04493207941484,2.1025641025641,0.0024899824515887
2010,University of Southern California / ISI,IvoryWSDb,61,1000,867,133,1.08225108225108,2.33333333333333,0.0828654617095314
2010,University of Southern California / ISI,IvoryWSDb,62,1000,917,83,1.05708245243129,2.86206896551724,0.054958310996806
2010,University of Southern California / ISI,IvoryWSDb,63,1000,920,80,1.04493207941484,2.16216216216216,0.12476498576104
2010,University of Southern California / ISI,IvoryWSDb,64,1000,891,109,1.06609808102345,2.31914893617021,0.0403358297999419
2010,University of Southern California / ISI,IvoryWSDb,65,1000,869,131,1.08342361863489,2.42592592592593,0.59133209432293
2010,University of Southern California / ISI,IvoryWSDb,66,1000,942,58,1.0351966873706,2.41666666666667,0.00148918900037357
2010,University of Southern California / ISI,IvoryWSDb,67,1000,869,131,1.08695652173913,2.56862745098039,0.478630766503832
2010,University of Southern California / ISI,IvoryWSDb,68,1000,968,32,1.01729399796541,2.13333333333333,0.00925656650262015
2010,University of Southern California / ISI,IvoryWSDb,69,1000,900,100,1.07874865156419,3.7037037037037,3.82551491260486e-09
2010,University of Southern California / ISI,IvoryWSDb,70,1000,930,70,1.03950103950104,2.1875,0.193714617794227
2010,University of Southern California / ISI,IvoryWSDb,71,1000,890,110,1.07758620689655,2.89473684210526,7.12411020635082e-11
2010,University of Southern California / ISI,IvoryWSDb,72,1000,853,147,1.10132158590308,2.67272727272727,2.45710159249755e-05
2010,University of Southern California / ISI,IvoryWSDb,73,1000,862,138,1.08695652173913,2.37931034482759,0.140698821908245
2010,University of Southern California / ISI,IvoryWSDb,74,1000,945,55,1.03199174406605,2.29166666666667,0.236489834407322
2010,University of Southern California / ISI,IvoryWSDb,75,1000,844,156,1.09170305676856,2.16666666666667,0.105190570117941
2010,University of Southern California / ISI,IvoryWSDb,76,1000,956,44,1.02774922918808,2.58823529411765,0.00528505997941281
2010,University of Southern California / ISI,IvoryWSDb,77,1000,927,73,1.04058272632674,2.14705882352941,0.116051378575321
2010,University of Southern California / ISI,IvoryWSDb,78,1000,942,58,1.03305785123967,2.23076923076923,0.0057536227609436
2010,University of Southern California / ISI,IvoryWSDb,79,1000,871,129,1.08108108108108,2.38888888888889,0.000953738515595136
2010,University of Southern California / ISI,IvoryWSDb,80,1000,980,20,1.01010101010101,2,6.55654255427616e-11
2010,University of Southern California / ISI,IvoryWSDb,81,1000,821,179,1.13765642775882,3.08620689655172,0.000453783566258213
2010,University of Southern California / ISI,IvoryWSDb,82,1000,832,168,1.11482720178372,2.58461538461539,0.278899771967481
2010,University of Southern California / ISI,IvoryWSDb,83,1000,886,114,1.06496272630458,2.15094339622642,0.00134416964718834
2010,University of Southern California / ISI,IvoryWSDb,84,1000,881,119,1.07066381156317,2.24528301886792,0.166678159782776
2010,University of Southern California / ISI,IvoryWSDb,85,1000,931,69,1.03734439834025,2.09090909090909,0.0556966686576153
2010,University of Southern California / ISI,IvoryWSDb,86,1000,936,64,1.03734439834025,2.28571428571429,0.124812671880189
2010,University of Southern California / ISI,IvoryWSDb,87,1000,825,175,1.12359550561798,2.69230769230769,0.016453627343803
2010,University of Southern California / ISI,IvoryWSDb,88,1000,928,72,1.04602510460251,2.57142857142857,0.000320709619163924
2010,University of Southern California / ISI,IvoryWSDb,89,1000,946,54,1.02986611740474,2.16,0.000744632183811981
2010,University of Southern California / ISI,IvoryWSDb,90,1000,937,63,1.04058272632674,2.625,0.119410283548836
2010,University of Southern California / ISI,IvoryWSDb,91,1000,964,36,1.02145045965271,2.4,5.69545369769574e-05
2010,University of Southern California / ISI,IvoryWSDb,92,1000,899,101,1.05820105820106,2.19565217391304,0.133750810360716
2010,University of Southern California / ISI,IvoryWSDb,93,1000,949,51,1.02880658436214,2.21739130434783,0.100340892525865
2010,University of Southern California / ISI,IvoryWSDb,94,1000,840,160,1.1001100110011,2.31884057971015,0.306740413699331
2010,University of Southern California / ISI,IvoryWSDb,95,1000,937,63,1.05042016806723,4.2,0.0508363113896202
2010,University of Southern California / ISI,IvoryWSDb,96,1000,879,121,1.07411385606874,2.32692307692308,0.0307717087636773
2010,University of Southern California / ISI,IvoryWSDb,97,1000,942,58,1.03412616339193,2.32,1.2372366200951e-11
2010,University of Southern California / ISI,IvoryWSDb,98,1000,946,54,1.03412616339193,2.57142857142857,0.00880635204045369
2010,University of Southern California / ISI,IvoryWSDb,99,1000,854,146,1.09769484083425,2.56140350877193,0.148935431969158
2010,University of Southern California / ISI,IvoryWSDb,100,1000,988,12,1.00603621730382,2,5.52321711411479e-07
2010,University College London (Media Futures Group),MF1,51,1000,470,530,1.55038759689923,3.02857142857143,0.0800048819975461
2010,University College London (Media Futures Group),MF1,52,1000,186,814,2.77777777777778,4.67816091954023,0.265234895992715
2010,University College London (Media Futures Group),MF1,53,1000,330,670,2.24215246636771,5.77586206896552,0.0423638147645855
2010,University College London (Media Futures Group),MF1,54,1000,872,128,1.07296137339056,2.13333333333333,0.215927518044723
2010,University College London (Media Futures Group),MF1,55,1000,228,772,2.4330900243309,4.21857923497268,0.421622049504739
2010,University College London (Media Futures Group),MF1,56,1000,501,499,1.51057401812689,3.09937888198758,0.173896094508717
2010,University College London (Media Futures Group),MF1,57,1000,594,406,1.41043723554302,3.5304347826087,0.0596607387898791
2010,University College London (Media Futures Group),MF1,58,1000,243,757,2.34741784037559,4.13661202185792,0.0515663479620686
2010,University College London (Media Futures Group),MF1,59,1000,582,418,1.35685210312076,2.69677419354839,0.217327637198278
2010,University College London (Media Futures Group),MF1,60,1000,180,820,2.61096605744125,4.03940886699507,0.0655611069719937
2010,University College London (Media Futures Group),MF1,61,1000,205,795,2.6525198938992,4.62209302325581,0.260974798465165
2010,University College London (Media Futures Group),MF1,62,1000,697,303,1.24069478908189,2.77981651376147,0.344474223623062
2010,University College London (Media Futures Group),MF1,63,1000,201,799,2.63157894736842,4.46368715083799,0.0419893732586995
2010,University College London (Media Futures Group),MF1,64,1000,177,823,2.90697674418605,4.92814371257485,0.0234292927254587
2010,University College London (Media Futures Group),MF1,65,1000,636,364,1.30548302872063,2.8,0.144007161807209
2010,University College London (Media Futures Group),MF1,66,1000,228,772,2.40963855421687,4.1283422459893,0.454710314945646
2010,University College London (Media Futures Group),MF1,67,1000,311,689,2.1551724137931,4.50326797385621,0.484349531146552
2010,University College London (Media Futures Group),MF1,68,1000,185,815,2.71739130434783,4.45355191256831,0.0247429431748945
2010,University College London (Media Futures Group),MF1,69,1000,547,453,1.41643059490085,2.84905660377359,0.187435640092795
2010,University College London (Media Futures Group),MF1,70,1000,294,706,2.04498977505112,3.62051282051282,0.0431424113932445
2010,University College London (Media Futures Group),MF1,71,1000,542,458,1.5748031496063,4.9247311827957,0.113225595962231
2010,University College London (Media Futures Group),MF1,72,1000,311,689,1.96463654223969,3.47979797979798,0.308778755063072
2010,University College London (Media Futures Group),MF1,73,1000,458,542,1.63132137030995,3.49677419354839,0.504805752858411
2010,University College London (Media Futures Group),MF1,74,1000,126,874,3.690036900369,6.02758620689655,0.258079235059621
2010,University College London (Media Futures Group),MF1,75,1000,207,793,2.37529691211401,3.70560747663551,0.155180067624012
2010,University College London (Media Futures Group),MF1,76,1000,607,393,1.34228187919463,2.84782608695652,0.0246554485240762
2010,University College London (Media Futures Group),MF1,77,1000,143,857,3.16455696202532,4.95375722543353,0.364209865439728
2010,University College London (Media Futures Group),MF1,78,1000,314,686,1.91204588910134,3.2822966507177,0.236514024154711
2010,University College London (Media Futures Group),MF1,79,1000,168,832,3.15457413249211,5.58389261744966,0.110060342795482
2010,University College London (Media Futures Group),MF1,80,1000,738,262,1.19617224880383,2.6734693877551,0.0577127562917574
2010,University College London (Media Futures Group),MF1,81,1000,224,776,2.42130750605327,4.10582010582011,0.212689833840419
2010,University College London (Media Futures Group),MF1,82,1000,209,791,2.56410256410256,4.37016574585635,0.233497336033674
2010,University College London (Media Futures Group),MF1,83,1000,20,980,21.2765957446809,36.2962962962963,0.503437009861622
2010,University College London (Media Futures Group),MF1,84,1000,463,537,1.61290322580645,3.4203821656051,0.127389935596633
2010,University College London (Media Futures Group),MF1,85,1000,437,563,1.68350168350168,3.5859872611465,0.452618741774524
2010,University College London (Media Futures Group),MF1,86,1000,332,668,1.94552529182879,3.67032967032967,0.212352504430593
2010,University College London (Media Futures Group),MF1,87,1000,136,864,4,7.57894736842105,0.32166274879671
2010,University College London (Media Futures Group),MF1,88,1000,395,605,1.77304964539007,3.57988165680473,0.022884824559997
2010,University College London (Media Futures Group),MF1,89,1000,189,811,2.55102040816327,3.99507389162562,0.0258348406567532
2010,University College London (Media Futures Group),MF1,90,1000,116,884,4,6.59701492537313,0.0816221940014817
2010,University College London (Media Futures Group),MF1,91,1000,794,206,1.14025085518814,2.48192771084337,0.000193521274094549
2010,University College London (Media Futures Group),MF1,92,1000,227,773,2.40384615384615,4.08994708994709,0.0780356910520617
2010,University College London (Media Futures Group),MF1,93,1000,140,860,3.41296928327645,5.62091503267974,0.194228266790778
2010,University College London (Media Futures Group),MF1,94,1000,236,764,2.29357798165138,3.82,0.0129771784002083
2010,University College London (Media Futures Group),MF1,95,1000,185,815,2.5974025974026,4.075,0.345531492113741
2010,University College London (Media Futures Group),MF1,96,1000,226,774,2.42718446601942,4.16129032258065,0.10037782635523
2010,University College London (Media Futures Group),MF1,97,1000,650,350,1.26742712294043,2.51798561151079,0.190112177845272
2010,University College London (Media Futures Group),MF1,98,1000,244,756,2.26244343891403,3.81818181818182,0.126985265330459
2010,University College London (Media Futures Group),MF1,99,1000,316,684,1.953125,3.48979591836735,0.0831689122673828
2010,University College London (Media Futures Group),MF1,100,1000,585,415,1.39082058414465,3.09701492537313,0.355930845986317
2010,University College London (Media Futures Group),MF2,51,1000,448,552,1.61030595813205,3.19075144508671,0.0836396800087865
2010,University College London (Media Futures Group),MF2,52,1000,170,830,3.003003003003,5.0920245398773,0.453730297445564
2010,University College London (Media Futures Group),MF2,53,1000,129,871,6.17283950617284,26.3939393939394,0.0455784696203227
2010,University College London (Media Futures Group),MF2,54,1000,784,216,1.14678899082569,2.45454545454545,0.144726790640031
2010,University College London (Media Futures Group),MF2,55,1000,166,834,2.89855072463768,4.65921787709497,0.571939371155377
2010,University College London (Media Futures Group),MF2,56,1000,493,507,1.62866449511401,4.1900826446281,0.242788974157488
2010,University College London (Media Futures Group),MF2,57,1000,567,433,1.43266475644699,3.30534351145038,0.0989872059163115
2010,University College London (Media Futures Group),MF2,58,1000,186,814,2.78551532033426,4.70520231213873,0.161976556210113
2010,University College London (Media Futures Group),MF2,59,1000,479,521,1.57232704402516,3.31847133757962,0.258136901265497
2010,University College London (Media Futures Group),MF2,60,1000,149,851,3.03951367781155,4.72777777777778,0.336740333928489
2010,University College London (Media Futures Group),MF2,61,1000,170,830,2.9940119760479,5.0609756097561,0.262997324661421
2010,University College London (Media Futures Group),MF2,62,1000,585,415,1.41242937853107,3.3739837398374,0.252878769653273
2010,University College London (Media Futures Group),MF2,63,1000,171,829,3.003003003003,5.11728395061728,0.0211046696898685
2010,University College London (Media Futures Group),MF2,64,1000,148,852,3.34448160535117,5.64238410596027,0.0367543756748964
2010,University College London (Media Futures Group),MF2,65,1000,557,443,1.4265335235378,3.07638888888889,0.185370328698457
2010,University College London (Media Futures Group),MF2,66,1000,228,772,2.40963855421687,4.1283422459893,0.454710314945646
2010,University College London (Media Futures Group),MF2,67,1000,369,631,1.91204588910134,4.0974025974026,0.0139690334975057
2010,University College London (Media Futures Group),MF2,68,1000,155,845,3.13479623824451,5.15243902439024,0.0821363703697818
2010,University College London (Media Futures Group),MF2,69,1000,471,529,1.59235668789809,3.36942675159236,0.0598284074432914
2010,University College London (Media Futures Group),MF2,70,1000,221,779,2.5706940874036,4.63690476190476,0.0608230933847244
2010,University College London (Media Futures Group),MF2,71,1000,379,621,1.97628458498024,4.88976377952756,0.0772248909546882
2010,University College London (Media Futures Group),MF2,72,1000,232,768,2.40963855421687,4.19672131147541,0.261560326172815
2010,University College London (Media Futures Group),MF2,73,1000,470,530,1.6,3.41935483870968,0.419101493218527
2010,University College London (Media Futures Group),MF2,74,1000,120,880,3.73134328358209,5.94594594594595,0.56367358410179
2010,University College London (Media Futures Group),MF2,75,1000,175,825,2.63157894736842,4.02439024390244,0.172788005382939
2010,University College London (Media Futures Group),MF2,76,1000,487,513,1.54559505409583,3.20625,0.262290067542645
2010,University College London (Media Futures Group),MF2,77,1000,129,871,3.38983050847458,5.24698795180723,0.441817469390779
2010,University College London (Media Futures Group),MF2,78,1000,262,738,2.16450216450216,3.69,0.267416679443024
2010,University College London (Media Futures Group),MF2,79,1000,136,864,3.53356890459364,5.87755102040816,0.11657161158122
2010,University College London (Media Futures Group),MF2,80,1000,676,324,1.25628140703518,2.7,0.0530845875446147
2010,University College London (Media Futures Group),MF2,81,1000,167,833,3.18471337579618,5.66666666666667,0.297531022285451
2010,University College London (Media Futures Group),MF2,82,1000,155,845,3.11526479750779,5.09036144578313,0.269772210309833
2010,University College London (Media Futures Group),MF2,83,1000,24,976,20,37.5384615384615,0.394790511551101
2010,University College London (Media Futures Group),MF2,84,1000,390,610,1.78890876565295,3.6094674556213,0.160225792147472
2010,University College London (Media Futures Group),MF2,85,1000,413,587,1.76056338028169,3.78709677419355,0.293753249702014
2010,University College London (Media Futures Group),MF2,86,1000,235,765,2.52525252525253,4.75155279503106,0.312264771542726
2010,University College London (Media Futures Group),MF2,87,1000,316,684,2.39808153477218,6.77227722772277,0.018945983029731
2010,University College London (Media Futures Group),MF2,88,1000,353,647,1.94174757281553,3.99382716049383,0.0959857458656266
2010,University College London (Media Futures Group),MF2,89,1000,174,826,2.73224043715847,4.30208333333333,0.344632678788297
2010,University College London (Media Futures Group),MF2,90,1000,108,892,4.42477876106195,7.55932203389831,0.0727207863657203
2010,University College London (Media Futures Group),MF2,91,1000,625,375,1.35685210312076,3.34821428571429,0.156431751353763
2010,University College London (Media Futures Group),MF2,92,1000,170,830,2.84090909090909,4.56043956043956,0.0492122060657435
2010,University College London (Media Futures Group),MF2,93,1000,105,895,4.11522633744856,6.48550724637681,0.237701119800836
2010,University College London (Media Futures Group),MF2,94,1000,186,814,2.710027100271,4.44808743169399,0.154047128081307
2010,University College London (Media Futures Group),MF2,95,1000,185,815,2.5974025974026,4.075,0.345531492113741
2010,University College London (Media Futures Group),MF2,96,1000,170,830,2.94985250737463,4.9112426035503,0.0765702234787865
2010,University College London (Media Futures Group),MF2,97,1000,549,451,1.42045454545455,2.90967741935484,0.448509503595457
2010,University College London (Media Futures Group),MF2,98,1000,176,824,2.9585798816568,5.08641975308642,0.227827408575788
2010,University College London (Media Futures Group),MF2,99,1000,316,684,1.953125,3.48979591836735,0.0831689122673828
2010,University College London (Media Futures Group),MF2,100,1000,573,427,1.40252454417952,3.05,0.238715317157661
2010,"Cluster of Excellence """"Multimodal Computing and Interaction"""" (MMCI)",MMCITLCLl20M,51,1000,792,208,1.12233445566779,2.1010101010101,0.264851837504853
2010,"Cluster of Excellence """"Multimodal Computing and Interaction"""" (MMCI)",MMCITLCLl20M,52,1000,84,916,3.08641975308642,3.81666666666667,0.528106203401016
2010,"Cluster of Excellence """"Multimodal Computing and Interaction"""" (MMCI)",MMCITLCLl20M,53,1000,928,72,1.04493207941484,2.48275862068966,3.28114134296014e-11
2010,"Cluster of Excellence """"Multimodal Computing and Interaction"""" (MMCI)",MMCITLCLl20M,54,1000,678,322,1.24378109452736,2.55555555555556,0.4201496381557
2010,"Cluster of Excellence """"Multimodal Computing and Interaction"""" (MMCI)",MMCITLCLl20M,55,1000,11,989,11.9047619047619,13.5479452054795,0.57930528824898
2010,"Cluster of Excellence """"Multimodal Computing and Interaction"""" (MMCI)",MMCITLCLl20M,56,1000,829,171,1.10987791342952,2.375,0.00188482061908829
2010,"Cluster of Excellence """"Multimodal Computing and Interaction"""" (MMCI)",MMCITLCLl20M,57,1000,830,170,1.14285714285714,3.77777777777778,0.00652478725948172
2010,"Cluster of Excellence """"Multimodal Computing and Interaction"""" (MMCI)",MMCITLCLl20M,58,1000,10,990,9.61538461538461,10.531914893617,0.610271906533734
2010,"Cluster of Excellence """"Multimodal Computing and Interaction"""" (MMCI)",MMCITLCLl20M,59,1000,908,92,1.05042016806723,2.09090909090909,0.0191481574846196
2010,"Cluster of Excellence """"Multimodal Computing and Interaction"""" (MMCI)",MMCITLCLl20M,60,1000,25,975,7.46268656716418,8.94495412844037,0.537090242283548
2010,"Cluster of Excellence """"Multimodal Computing and Interaction"""" (MMCI)",MMCITLCLl20M,61,1000,35,965,5.81395348837209,7.04379562043796,0.446652030506374
2010,"Cluster of Excellence """"Multimodal Computing and Interaction"""" (MMCI)",MMCITLCLl20M,62,1000,787,213,1.15740740740741,2.76623376623377,0.239778327032787
2010,"Cluster of Excellence """"Multimodal Computing and Interaction"""" (MMCI)",MMCITLCLl20M,63,1000,30,970,9.25925925925926,12.4358974358974,0.612647380359731
2010,"Cluster of Excellence """"Multimodal Computing and Interaction"""" (MMCI)",MMCITLCLl20M,64,1000,56,944,3.86100386100386,4.65024630541872,0.734107783539729
2010,"Cluster of Excellence """"Multimodal Computing and Interaction"""" (MMCI)",MMCITLCLl20M,65,1000,25,975,10.5263157894737,13.9285714285714,0.435256769337545
2010,"Cluster of Excellence """"Multimodal Computing and Interaction"""" (MMCI)",MMCITLCLl20M,66,1000,933,67,1.04712041884817,3.04545454545455,0.000335864616663004
2010,"Cluster of Excellence """"Multimodal Computing and Interaction"""" (MMCI)",MMCITLCLl20M,67,1000,879,121,1.07642626480086,2.42,0.00634070183775651
2010,"Cluster of Excellence """"Multimodal Computing and Interaction"""" (MMCI)",MMCITLCLl20M,68,1000,24,976,5.37634408602151,6.02469135802469,0.998162981803738
2010,"Cluster of Excellence """"Multimodal Computing and Interaction"""" (MMCI)",MMCITLCLl20M,69,1000,762,238,1.14678899082569,2.16363636363636,0.111453369357512
2010,"Cluster of Excellence """"Multimodal Computing and Interaction"""" (MMCI)",MMCITLCLl20M,70,1000,15,985,13.1578947368421,16.1475409836066,0.707252867869152
2010,"Cluster of Excellence """"Multimodal Computing and Interaction"""" (MMCI)",MMCITLCLl20M,71,1000,800,200,1.15207373271889,2.94117647058824,0.000341967521187487
2010,"Cluster of Excellence """"Multimodal Computing and Interaction"""" (MMCI)",MMCITLCLl20M,72,1000,3,997,15.1515151515152,15.8253968253968,0.999892744955493
2010,"Cluster of Excellence """"Multimodal Computing and Interaction"""" (MMCI)",MMCITLCLl20M,73,1000,900,100,1.05932203389831,2.27272727272727,0.0698691720084825
2010,"Cluster of Excellence """"Multimodal Computing and Interaction"""" (MMCI)",MMCITLCLl20M,74,1000,48,952,4.20168067226891,5.01052631578947,0.317396175950916
2010,"Cluster of Excellence """"Multimodal Computing and Interaction"""" (MMCI)",MMCITLCLl20M,75,1000,22,978,6.17283950617284,6.98571428571429,0.853450368098588
2010,"Cluster of Excellence """"Multimodal Computing and Interaction"""" (MMCI)",MMCITLCLl20M,76,1000,861,139,1.08225108225108,2.20634920634921,0.2765236221913
2010,"Cluster of Excellence """"Multimodal Computing and Interaction"""" (MMCI)",MMCITLCLl20M,77,1000,47,953,5,6.22875816993464,0.601418865891168
2010,"Cluster of Excellence """"Multimodal Computing and Interaction"""" (MMCI)",MMCITLCLl20M,78,1000,5,995,15.1515151515152,16.3114754098361,0.6974815401
2010,"Cluster of Excellence """"Multimodal Computing and Interaction"""" (MMCI)",MMCITLCLl20M,79,1000,17,983,12.3456790123457,15.359375,0.466981674302623
2010,"Cluster of Excellence """"Multimodal Computing and Interaction"""" (MMCI)",MMCITLCLl20M,80,1000,917,83,1.05374077976818,2.59375,5.02321155644684e-06
2010,"Cluster of Excellence """"Multimodal Computing and Interaction"""" (MMCI)",MMCITLCLl20M,81,1000,17,983,7.93650793650794,9.01834862385321,0.583908002033732
2010,"Cluster of Excellence """"Multimodal Computing and Interaction"""" (MMCI)",MMCITLCLl20M,82,1000,18,982,6.32911392405063,7.01428571428571,0.486795564875669
2010,"Cluster of Excellence """"Multimodal Computing and Interaction"""" (MMCI)",MMCITLCLl20M,83,1000,8,992,40,58.3529411764706,0.562243462315673
2010,"Cluster of Excellence """"Multimodal Computing and Interaction"""" (MMCI)",MMCITLCLl20M,84,1000,695,305,1.22399020807834,2.5,0.17337767635671
2010,"Cluster of Excellence """"Multimodal Computing and Interaction"""" (MMCI)",MMCITLCLl20M,85,1000,935,65,1.03626943005181,2.16666666666667,0.000531332748336563
2010,"Cluster of Excellence """"Multimodal Computing and Interaction"""" (MMCI)",MMCITLCLl20M,86,1000,806,194,1.13895216400911,2.69444444444444,0.0284741212144541
2010,"Cluster of Excellence """"Multimodal Computing and Interaction"""" (MMCI)",MMCITLCLl20M,87,1000,810,190,1.12107623318386,2.31707317073171,0.254889983411257
2010,"Cluster of Excellence """"Multimodal Computing and Interaction"""" (MMCI)",MMCITLCLl20M,88,1000,890,110,1.06269925611052,2.15686274509804,0.0425011646265889
2010,"Cluster of Excellence """"Multimodal Computing and Interaction"""" (MMCI)",MMCITLCLl20M,89,1000,22,978,4.83091787439614,5.28648648648649,0.630258097306383
2010,"Cluster of Excellence """"Multimodal Computing and Interaction"""" (MMCI)",MMCITLCLl20M,90,1000,151,849,2.53807106598985,3.49382716049383,0.638742263158194
2010,"Cluster of Excellence """"Multimodal Computing and Interaction"""" (MMCI)",MMCITLCLl20M,91,1000,612,388,1.37551581843191,3.37391304347826,0.101048304844066
2010,"Cluster of Excellence """"Multimodal Computing and Interaction"""" (MMCI)",MMCITLCLl20M,92,1000,9,991,10.2040816326531,11.1348314606742,0.590238319679309
2010,"Cluster of Excellence """"Multimodal Computing and Interaction"""" (MMCI)",MMCITLCLl20M,93,1000,80,920,3.25732899022801,4.05286343612335,0.893028418999586
2010,"Cluster of Excellence """"Multimodal Computing and Interaction"""" (MMCI)",MMCITLCLl20M,94,1000,28,972,5.95238095238095,6.94285714285714,0.627905847072563
2010,"Cluster of Excellence """"Multimodal Computing and Interaction"""" (MMCI)",MMCITLCLl20M,95,1000,903,97,1.06951871657754,3.03125,0.282454150043431
2010,"Cluster of Excellence """"Multimodal Computing and Interaction"""" (MMCI)",MMCITLCLl20M,96,1000,17,983,9.61538461538461,11.2988505747126,0.564699026735299
2010,"Cluster of Excellence """"Multimodal Computing and Interaction"""" (MMCI)",MMCITLCLl20M,97,1000,625,375,1.38888888888889,3.94736842105263,0.23063533237922
2010,"Cluster of Excellence """"Multimodal Computing and Interaction"""" (MMCI)",MMCITLCLl20M,98,1000,21,979,7.35294117647059,8.51304347826087,0.500046198377967
2010,"Cluster of Excellence """"Multimodal Computing and Interaction"""" (MMCI)",MMCITLCLl20M,99,1000,21,979,10.8695652173913,13.7887323943662,0.494154094936993
2010,"Cluster of Excellence """"Multimodal Computing and Interaction"""" (MMCI)",MMCITLCLl20M,100,1000,848,152,1.09649122807018,2.375,0.162208887110749
2010,"Cluster of Excellence """"Multimodal Computing and Interaction"""" (MMCI)",MMCITLl20M,51,1000,760,240,1.14942528735632,2.18181818181818,0.185478892059765
2010,"Cluster of Excellence """"Multimodal Computing and Interaction"""" (MMCI)",MMCITLl20M,52,1000,84,916,3.08641975308642,3.81666666666667,0.528106203401016
2010,"Cluster of Excellence """"Multimodal Computing and Interaction"""" (MMCI)",MMCITLl20M,53,1000,840,160,1.11358574610245,2.75862068965517,0.00103495390936863
2010,"Cluster of Excellence """"Multimodal Computing and Interaction"""" (MMCI)",MMCITLl20M,54,1000,571,429,1.40449438202247,3.04255319148936,0.626560481964435
2010,"Cluster of Excellence """"Multimodal Computing and Interaction"""" (MMCI)",MMCITLl20M,55,1000,11,989,11.9047619047619,13.5479452054795,0.57930528824898
2010,"Cluster of Excellence """"Multimodal Computing and Interaction"""" (MMCI)",MMCITLl20M,56,1000,813,187,1.11731843575419,2.28048780487805,0.00015920775169959
2010,"Cluster of Excellence """"Multimodal Computing and Interaction"""" (MMCI)",MMCITLl20M,57,1000,731,269,1.22249388753056,3.09195402298851,0.573708916935244
2010,"Cluster of Excellence """"Multimodal Computing and Interaction"""" (MMCI)",MMCITLl20M,58,1000,10,990,9.61538461538461,10.531914893617,0.610271906533734
2010,"Cluster of Excellence """"Multimodal Computing and Interaction"""" (MMCI)",MMCITLl20M,59,1000,453,547,2.02839756592292,13.675,0.0330681313062646
2010,"Cluster of Excellence """"Multimodal Computing and Interaction"""" (MMCI)",MMCITLl20M,60,1000,25,975,7.46268656716418,8.94495412844037,0.537090242283548
2010,"Cluster of Excellence """"Multimodal Computing and Interaction"""" (MMCI)",MMCITLl20M,61,1000,35,965,5.81395348837209,7.04379562043796,0.446652030506374
2010,"Cluster of Excellence """"Multimodal Computing and Interaction"""" (MMCI)",MMCITLl20M,62,1000,786,214,1.15740740740741,2.74358974358974,0.196679975046113
2010,"Cluster of Excellence """"Multimodal Computing and Interaction"""" (MMCI)",MMCITLl20M,63,1000,30,970,9.25925925925926,12.4358974358974,0.612647380359731
2010,"Cluster of Excellence """"Multimodal Computing and Interaction"""" (MMCI)",MMCITLl20M,64,1000,56,944,3.86100386100386,4.65024630541872,0.734107783539729
2010,"Cluster of Excellence """"Multimodal Computing and Interaction"""" (MMCI)",MMCITLl20M,65,1000,12,988,16.6666666666667,20.5833333333333,0.504645111139465
2010,"Cluster of Excellence """"Multimodal Computing and Interaction"""" (MMCI)",MMCITLl20M,66,1000,917,83,1.0482180293501,2.24324324324324,0.000230539926877816
2010,"Cluster of Excellence """"Multimodal Computing and Interaction"""" (MMCI)",MMCITLl20M,67,1000,869,131,1.08342361863489,2.42592592592593,0.151219111264568
2010,"Cluster of Excellence """"Multimodal Computing and Interaction"""" (MMCI)",MMCITLl20M,68,1000,24,976,5.37634408602151,6.02469135802469,0.998162981803738
2010,"Cluster of Excellence """"Multimodal Computing and Interaction"""" (MMCI)",MMCITLl20M,69,1000,708,292,1.20772946859903,2.43333333333333,0.166867891613878
2010,"Cluster of Excellence """"Multimodal Computing and Interaction"""" (MMCI)",MMCITLl20M,70,1000,15,985,13.1578947368421,16.1475409836066,0.707252867869152
2010,"Cluster of Excellence """"Multimodal Computing and Interaction"""" (MMCI)",MMCITLl20M,71,1000,851,149,1.1037527593819,2.70909090909091,5.09841086388214e-05
2010,"Cluster of Excellence """"Multimodal Computing and Interaction"""" (MMCI)",MMCITLl20M,72,1000,3,997,15.1515151515152,15.8253968253968,0.999892744955493
2010,"Cluster of Excellence """"Multimodal Computing and Interaction"""" (MMCI)",MMCITLl20M,73,1000,835,165,1.1037527593819,2.32394366197183,0.0687127413046737
2010,"Cluster of Excellence """"Multimodal Computing and Interaction"""" (MMCI)",MMCITLl20M,74,1000,48,952,4.20168067226891,5.01052631578947,0.317396175950916
2010,"Cluster of Excellence """"Multimodal Computing and Interaction"""" (MMCI)",MMCITLl20M,75,1000,22,978,6.17283950617284,6.98571428571429,0.853450368098588
2010,"Cluster of Excellence """"Multimodal Computing and Interaction"""" (MMCI)",MMCITLl20M,76,1000,853,147,1.08932461873638,2.26153846153846,0.210340588909687
2010,"Cluster of Excellence """"Multimodal Computing and Interaction"""" (MMCI)",MMCITLl20M,77,1000,47,953,5,6.22875816993464,0.601418865891168
2010,"Cluster of Excellence """"Multimodal Computing and Interaction"""" (MMCI)",MMCITLl20M,78,1000,5,995,15.1515151515152,16.3114754098361,0.6974815401
2010,"Cluster of Excellence """"Multimodal Computing and Interaction"""" (MMCI)",MMCITLl20M,79,1000,17,983,12.3456790123457,15.359375,0.466981674302623
2010,"Cluster of Excellence """"Multimodal Computing and Interaction"""" (MMCI)",MMCITLl20M,80,1000,950,50,1.02669404517454,2.08333333333333,3.11215051999336e-06
2010,"Cluster of Excellence """"Multimodal Computing and Interaction"""" (MMCI)",MMCITLl20M,81,1000,17,983,7.93650793650794,9.01834862385321,0.583908002033732
2010,"Cluster of Excellence """"Multimodal Computing and Interaction"""" (MMCI)",MMCITLl20M,82,1000,18,982,6.32911392405063,7.01428571428571,0.486795564875669
2010,"Cluster of Excellence """"Multimodal Computing and Interaction"""" (MMCI)",MMCITLl20M,83,1000,8,992,40,58.3529411764706,0.562243462315673
2010,"Cluster of Excellence """"Multimodal Computing and Interaction"""" (MMCI)",MMCITLl20M,84,1000,692,308,1.22549019607843,2.48387096774194,0.159184630328076
2010,"Cluster of Excellence """"Multimodal Computing and Interaction"""" (MMCI)",MMCITLl20M,85,1000,887,113,1.07066381156317,2.40425531914894,0.0987279446612967
2010,"Cluster of Excellence """"Multimodal Computing and Interaction"""" (MMCI)",MMCITLl20M,86,1000,823,177,1.12866817155756,2.80952380952381,0.258450117409002
2010,"Cluster of Excellence """"Multimodal Computing and Interaction"""" (MMCI)",MMCITLl20M,87,1000,815,185,1.12485939257593,2.5,0.384724226817453
2010,"Cluster of Excellence """"Multimodal Computing and Interaction"""" (MMCI)",MMCITLl20M,88,1000,876,124,1.07296137339056,2.21428571428571,0.0178081452640014
2010,"Cluster of Excellence """"Multimodal Computing and Interaction"""" (MMCI)",MMCITLl20M,89,1000,22,978,4.83091787439614,5.28648648648649,0.630258097306383
2010,"Cluster of Excellence """"Multimodal Computing and Interaction"""" (MMCI)",MMCITLl20M,90,1000,151,849,2.53807106598985,3.49382716049383,0.638742263158194
2010,"Cluster of Excellence """"Multimodal Computing and Interaction"""" (MMCI)",MMCITLl20M,91,1000,822,178,1.10864745011086,2.225,0.0979654298645034
2010,"Cluster of Excellence """"Multimodal Computing and Interaction"""" (MMCI)",MMCITLl20M,92,1000,9,991,10.2040816326531,11.1348314606742,0.590238319679309
2010,"Cluster of Excellence """"Multimodal Computing and Interaction"""" (MMCI)",MMCITLl20M,93,1000,80,920,3.25732899022801,4.05286343612335,0.893028418999586
2010,"Cluster of Excellence """"Multimodal Computing and Interaction"""" (MMCI)",MMCITLl20M,94,1000,28,972,5.95238095238095,6.94285714285714,0.627905847072563
2010,"Cluster of Excellence """"Multimodal Computing and Interaction"""" (MMCI)",MMCITLl20M,95,1000,803,197,1.15874855156431,3.28333333333333,0.810042134983785
2010,"Cluster of Excellence """"Multimodal Computing and Interaction"""" (MMCI)",MMCITLl20M,96,1000,17,983,9.61538461538461,11.2988505747126,0.564699026735299
2010,"Cluster of Excellence """"Multimodal Computing and Interaction"""" (MMCI)",MMCITLl20M,97,1000,341,659,1.92678227360308,3.70224719101124,0.269028364495699
2010,"Cluster of Excellence """"Multimodal Computing and Interaction"""" (MMCI)",MMCITLl20M,98,1000,21,979,7.35294117647059,8.51304347826087,0.500046198377967
2010,"Cluster of Excellence """"Multimodal Computing and Interaction"""" (MMCI)",MMCITLl20M,99,1000,21,979,10.8695652173913,13.7887323943662,0.494154094936993
2010,"Cluster of Excellence """"Multimodal Computing and Interaction"""" (MMCI)",MMCITLl20M,100,1000,851,149,1.09769484083425,2.48333333333333,0.165237768958413
2010,"Cluster of Excellence """"Multimodal Computing and Interaction"""" (MMCI)",MMCIl410m1,51,1000,561,439,1.48588410104012,3.91964285714286,0.160590566946359
2010,"Cluster of Excellence """"Multimodal Computing and Interaction"""" (MMCI)",MMCIl410m1,52,410,71,339,2.30337078651685,3.16822429906542,0.528106203401016
2010,"Cluster of Excellence """"Multimodal Computing and Interaction"""" (MMCI)",MMCIl410m1,53,1000,801,199,1.13122171945701,2.39759036144578,0.093979981218979
2010,"Cluster of Excellence """"Multimodal Computing and Interaction"""" (MMCI)",MMCIl410m1,54,1000,420,580,1.69491525423729,3.41176470588235,0.531454113859558
2010,"Cluster of Excellence """"Multimodal Computing and Interaction"""" (MMCI)",MMCIl410m1,55,410,12,398,6.72131147540984,8.12244897959184,0.57930528824898
2010,"Cluster of Excellence """"Multimodal Computing and Interaction"""" (MMCI)",MMCIl410m1,56,1000,788,212,1.15074798619102,2.61728395061728,0.0358987371507579
2010,"Cluster of Excellence """"Multimodal Computing and Interaction"""" (MMCI)",MMCIl410m1,57,1000,333,667,2.55754475703325,11.5,0.00652487481966743
2010,"Cluster of Excellence """"Multimodal Computing and Interaction"""" (MMCI)",MMCIl410m1,58,410,10,400,5.61643835616438,6.34920634920635,0.610271906533734
2010,"Cluster of Excellence """"Multimodal Computing and Interaction"""" (MMCI)",MMCIl410m1,59,1000,378,622,2.14592274678112,7.06818181818182,0.019424832397714
2010,"Cluster of Excellence """"Multimodal Computing and Interaction"""" (MMCI)",MMCIl410m1,60,410,25,385,4.36170212765957,5.57971014492754,0.537090242283548
2010,"Cluster of Excellence """"Multimodal Computing and Interaction"""" (MMCI)",MMCIl410m1,61,410,36,374,3.59649122807018,4.7948717948718,0.446652030506374
2010,"Cluster of Excellence """"Multimodal Computing and Interaction"""" (MMCI)",MMCIl410m1,62,1000,505,495,1.53374233128834,3.36734693877551,0.244987862233838
2010,"Cluster of Excellence """"Multimodal Computing and Interaction"""" (MMCI)",MMCIl410m1,63,410,30,380,4.76744186046512,6.78571428571429,0.612647380359731
2010,"Cluster of Excellence """"Multimodal Computing and Interaction"""" (MMCI)",MMCIl410m1,64,410,52,358,2.75167785234899,3.69072164948454,0.734107783539729
2010,"Cluster of Excellence """"Multimodal Computing and Interaction"""" (MMCI)",MMCIl410m1,65,1000,37,963,7.93650793650794,10.8202247191011,0.499360671740034
2010,"Cluster of Excellence """"Multimodal Computing and Interaction"""" (MMCI)",MMCIl410m1,66,1000,805,195,1.14810562571757,2.95454545454545,0.0818744118071782
2010,"Cluster of Excellence """"Multimodal Computing and Interaction"""" (MMCI)",MMCIl410m1,67,1000,488,512,1.81488203266788,8.12698412698413,8.75893602460394e-09
2010,"Cluster of Excellence """"Multimodal Computing and Interaction"""" (MMCI)",MMCIl410m1,68,410,24,386,4.27083333333333,5.36111111111111,0.998162981803738
2010,"Cluster of Excellence """"Multimodal Computing and Interaction"""" (MMCI)",MMCIl410m1,69,1000,350,650,2.13675213675214,5.50847457627119,0.108215920037821
2010,"Cluster of Excellence """"Multimodal Computing and Interaction"""" (MMCI)",MMCIl410m1,70,410,15,395,6.61290322580645,8.40425531914894,0.707252867869152
2010,"Cluster of Excellence """"Multimodal Computing and Interaction"""" (MMCI)",MMCIl410m1,71,1000,342,658,2.45098039215686,9.96969696969697,0.000381232853735427
2010,"Cluster of Excellence """"Multimodal Computing and Interaction"""" (MMCI)",MMCIl410m1,72,410,4,406,9.53488372093023,10.4102564102564,0.999892744955493
2010,"Cluster of Excellence """"Multimodal Computing and Interaction"""" (MMCI)",MMCIl410m1,73,1000,418,582,1.82481751824818,4.47692307692308,0.0642365829822087
2010,"Cluster of Excellence """"Multimodal Computing and Interaction"""" (MMCI)",MMCIl410m1,74,410,32,378,3.53448275862069,4.5,0.317396175950916
2010,"Cluster of Excellence """"Multimodal Computing and Interaction"""" (MMCI)",MMCIl410m1,75,410,22,388,4.18367346938776,5.10526315789474,0.853450368098588
2010,"Cluster of Excellence """"Multimodal Computing and Interaction"""" (MMCI)",MMCIl410m1,76,1000,399,601,1.94174757281553,5.18103448275862,0.276712913793375
2010,"Cluster of Excellence """"Multimodal Computing and Interaction"""" (MMCI)",MMCIl410m1,77,410,45,365,3.25396825396825,4.50617283950617,0.601418865891168
2010,"Cluster of Excellence """"Multimodal Computing and Interaction"""" (MMCI)",MMCIl410m1,78,410,5,405,11.3888888888889,13.0645161290323,0.6974815401
2010,"Cluster of Excellence """"Multimodal Computing and Interaction"""" (MMCI)",MMCIl410m1,79,410,17,393,10.5128205128205,17.8636363636364,0.466981674302623
2010,"Cluster of Excellence """"Multimodal Computing and Interaction"""" (MMCI)",MMCIl410m1,80,1000,376,624,2.1505376344086,7.01123595505618,2.99297854480466e-06
2010,"Cluster of Excellence """"Multimodal Computing and Interaction"""" (MMCI)",MMCIl410m1,81,410,16,394,4.40860215053763,5.11688311688312,0.583908002033732
2010,"Cluster of Excellence """"Multimodal Computing and Interaction"""" (MMCI)",MMCIl410m1,82,410,19,391,4.14141414141414,4.8875,0.486795564875669
2010,"Cluster of Excellence """"Multimodal Computing and Interaction"""" (MMCI)",MMCIl410m1,83,410,8,402,16.4,23.6470588235294,0.562243462315673
2010,"Cluster of Excellence """"Multimodal Computing and Interaction"""" (MMCI)",MMCIl410m1,84,1000,301,699,2.1551724137931,4.28834355828221,0.17338659877136
2010,"Cluster of Excellence """"Multimodal Computing and Interaction"""" (MMCI)",MMCIl410m1,85,1000,614,386,1.47275405007364,5.93846153846154,0.0911947774802914
2010,"Cluster of Excellence """"Multimodal Computing and Interaction"""" (MMCI)",MMCIl410m1,86,1000,214,786,3.11526479750779,7.34579439252337,0.0680620678574778
2010,"Cluster of Excellence """"Multimodal Computing and Interaction"""" (MMCI)",MMCIl410m1,87,1000,349,651,2.05761316872428,4.75182481751825,0.253170561262716
2010,"Cluster of Excellence """"Multimodal Computing and Interaction"""" (MMCI)",MMCIl410m1,88,1000,520,480,1.54559505409583,3.77952755905512,0.0425622270724371
2010,"Cluster of Excellence """"Multimodal Computing and Interaction"""" (MMCI)",MMCIl410m1,89,410,18,392,4.01960784313726,4.66666666666667,0.630258097306383
2010,"Cluster of Excellence """"Multimodal Computing and Interaction"""" (MMCI)",MMCIl410m1,90,410,57,353,2.54658385093168,3.39423076923077,0.638742263158194
2010,"Cluster of Excellence """"Multimodal Computing and Interaction"""" (MMCI)",MMCIl410m1,91,1000,333,667,2.41545893719807,8.23456790123457,0.101053794474776
2010,"Cluster of Excellence """"Multimodal Computing and Interaction"""" (MMCI)",MMCIl410m1,92,410,9,401,6.02941176470588,6.79661016949153,0.590238319679309
2010,"Cluster of Excellence """"Multimodal Computing and Interaction"""" (MMCI)",MMCIl410m1,93,410,39,371,3.53448275862069,4.81818181818182,0.893028418999586
2010,"Cluster of Excellence """"Multimodal Computing and Interaction"""" (MMCI)",MMCIl410m1,94,410,28,382,3.98058252427184,5.09333333333333,0.627905847072563
2010,"Cluster of Excellence """"Multimodal Computing and Interaction"""" (MMCI)",MMCIl410m1,95,1000,461,539,1.71821305841924,4.45454545454545,0.313186686575478
2010,"Cluster of Excellence """"Multimodal Computing and Interaction"""" (MMCI)",MMCIl410m1,96,410,17,393,5.54054054054054,6.89473684210526,0.564699026735299
2010,"Cluster of Excellence """"Multimodal Computing and Interaction"""" (MMCI)",MMCIl410m1,97,1000,227,773,3.003003003003,7.29245283018868,0.0369557541510146
2010,"Cluster of Excellence """"Multimodal Computing and Interaction"""" (MMCI)",MMCIl410m1,98,410,20,390,6.83333333333333,9.75,0.500046198377967
2010,"Cluster of Excellence """"Multimodal Computing and Interaction"""" (MMCI)",MMCIl410m1,99,410,21,389,5.46666666666667,7.2037037037037,0.494154094936993
2010,"Cluster of Excellence """"Multimodal Computing and Interaction"""" (MMCI)",MMCIl410m1,100,1000,714,286,1.20918984280532,2.53097345132743,0.0888659525516023
2010,"Tsinghua University, Info Retrieval Group",THUIR10Qa,51,1000,1000,0,1,,0
2010,"Tsinghua University, Info Retrieval Group",THUIR10Qa,52,1000,1000,0,1,,0
2010,"Tsinghua University, Info Retrieval Group",THUIR10Qa,53,1000,998,2,1.001001001001,2,0.066248903619
2010,"Tsinghua University, Info Retrieval Group",THUIR10Qa,54,1000,998,2,1.001001001001,2,0.00894924452476787
2010,"Tsinghua University, Info Retrieval Group",THUIR10Qa,55,1000,1000,0,1,,0
2010,"Tsinghua University, Info Retrieval Group",THUIR10Qa,56,1000,1000,0,1,,0
2010,"Tsinghua University, Info Retrieval Group",THUIR10Qa,57,1000,1000,0,1,,0
2010,"Tsinghua University, Info Retrieval Group",THUIR10Qa,58,1000,1000,0,1,,0
2010,"Tsinghua University, Info Retrieval Group",THUIR10Qa,59,1000,1000,0,1,,0
2010,"Tsinghua University, Info Retrieval Group",THUIR10Qa,60,1000,1000,0,1,,0
2010,"Tsinghua University, Info Retrieval Group",THUIR10Qa,61,1000,1000,0,1,,0
2010,"Tsinghua University, Info Retrieval Group",THUIR10Qa,62,1000,1000,0,1,,0
2010,"Tsinghua University, Info Retrieval Group",THUIR10Qa,63,1000,1000,0,1,,0
2010,"Tsinghua University, Info Retrieval Group",THUIR10Qa,64,1000,1000,0,1,,0
2010,"Tsinghua University, Info Retrieval Group",THUIR10Qa,65,1000,998,2,1.001001001001,2,0.0168395824273398
2010,"Tsinghua University, Info Retrieval Group",THUIR10Qa,66,1000,1000,0,1,,0
2010,"Tsinghua University, Info Retrieval Group",THUIR10Qa,67,1000,1000,0,1,,0
2010,"Tsinghua University, Info Retrieval Group",THUIR10Qa,68,1000,1000,0,1,,0
2010,"Tsinghua University, Info Retrieval Group",THUIR10Qa,69,1000,1000,0,1,,0
2010,"Tsinghua University, Info Retrieval Group",THUIR10Qa,70,1000,998,2,1.001001001001,2,0.035207383588185
2010,"Tsinghua University, Info Retrieval Group",THUIR10Qa,71,1000,1000,0,1,,0
2010,"Tsinghua University, Info Retrieval Group",THUIR10Qa,72,1000,1000,0,1,,0
2010,"Tsinghua University, Info Retrieval Group",THUIR10Qa,73,1000,1000,0,1,,0
2010,"Tsinghua University, Info Retrieval Group",THUIR10Qa,74,1000,1000,0,1,,0
2010,"Tsinghua University, Info Retrieval Group",THUIR10Qa,75,1000,1000,0,1,,0
2010,"Tsinghua University, Info Retrieval Group",THUIR10Qa,76,1000,1000,0,1,,0
2010,"Tsinghua University, Info Retrieval Group",THUIR10Qa,77,1000,1000,0,1,,0
2010,"Tsinghua University, Info Retrieval Group",THUIR10Qa,78,1000,1000,0,1,,0
2010,"Tsinghua University, Info Retrieval Group",THUIR10Qa,79,1000,1000,0,1,,0
2010,"Tsinghua University, Info Retrieval Group",THUIR10Qa,80,1000,1000,0,1,,0
2010,"Tsinghua University, Info Retrieval Group",THUIR10Qa,81,1000,998,2,1.001001001001,2,0.171
2010,"Tsinghua University, Info Retrieval Group",THUIR10Qa,82,1000,1000,0,1,,0
2010,"Tsinghua University, Info Retrieval Group",THUIR10Qa,83,1000,1000,0,1,,0
2010,"Tsinghua University, Info Retrieval Group",THUIR10Qa,84,1000,1000,0,1,,0
2010,"Tsinghua University, Info Retrieval Group",THUIR10Qa,85,1000,1000,0,1,,0
2010,"Tsinghua University, Info Retrieval Group",THUIR10Qa,86,1000,1000,0,1,,0
2010,"Tsinghua University, Info Retrieval Group",THUIR10Qa,87,1000,1000,0,1,,0
2010,"Tsinghua University, Info Retrieval Group",THUIR10Qa,88,1000,1000,0,1,,0
2010,"Tsinghua University, Info Retrieval Group",THUIR10Qa,89,1000,1000,0,1,,0
2010,"Tsinghua University, Info Retrieval Group",THUIR10Qa,90,1000,1000,0,1,,0
2010,"Tsinghua University, Info Retrieval Group",THUIR10Qa,91,1000,1000,0,1,,0
2010,"Tsinghua University, Info Retrieval Group",THUIR10Qa,92,1000,1000,0,1,,0
2010,"Tsinghua University, Info Retrieval Group",THUIR10Qa,93,1000,998,2,1.001001001001,2,0.066248903619
2010,"Tsinghua University, Info Retrieval Group",THUIR10Qa,94,1000,1000,0,1,,0
2010,"Tsinghua University, Info Retrieval Group",THUIR10Qa,95,1000,1000,0,1,,0
2010,"Tsinghua University, Info Retrieval Group",THUIR10Qa,96,1000,1000,0,1,,0
2010,"Tsinghua University, Info Retrieval Group",THUIR10Qa,97,1000,1000,0,1,,0
2010,"Tsinghua University, Info Retrieval Group",THUIR10Qa,98,1000,1000,0,1,,0
2010,"Tsinghua University, Info Retrieval Group",THUIR10Qa,99,1000,1000,0,1,,0
2010,"Tsinghua University, Info Retrieval Group",THUIR10Qa,100,1000,1000,0,1,,0
2010,"Tsinghua University, Info Retrieval Group",THUIR10QaHt,51,1000,1000,0,1,,0
2010,"Tsinghua University, Info Retrieval Group",THUIR10QaHt,52,1000,1000,0,1,,0
2010,"Tsinghua University, Info Retrieval Group",THUIR10QaHt,53,1000,1000,0,1,,0
2010,"Tsinghua University, Info Retrieval Group",THUIR10QaHt,54,1000,1000,0,1,,0
2010,"Tsinghua University, Info Retrieval Group",THUIR10QaHt,55,1000,1000,0,1,,0
2010,"Tsinghua University, Info Retrieval Group",THUIR10QaHt,56,1000,1000,0,1,,0
2010,"Tsinghua University, Info Retrieval Group",THUIR10QaHt,57,1000,1000,0,1,,0
2010,"Tsinghua University, Info Retrieval Group",THUIR10QaHt,58,1000,1000,0,1,,0
2010,"Tsinghua University, Info Retrieval Group",THUIR10QaHt,59,1000,1000,0,1,,0
2010,"Tsinghua University, Info Retrieval Group",THUIR10QaHt,60,1000,1000,0,1,,0
2010,"Tsinghua University, Info Retrieval Group",THUIR10QaHt,61,1000,1000,0,1,,0
2010,"Tsinghua University, Info Retrieval Group",THUIR10QaHt,62,1000,1000,0,1,,0
2010,"Tsinghua University, Info Retrieval Group",THUIR10QaHt,63,1000,1000,0,1,,0
2010,"Tsinghua University, Info Retrieval Group",THUIR10QaHt,64,1000,1000,0,1,,0
2010,"Tsinghua University, Info Retrieval Group",THUIR10QaHt,65,1000,1000,0,1,,0
2010,"Tsinghua University, Info Retrieval Group",THUIR10QaHt,66,1000,1000,0,1,,0
2010,"Tsinghua University, Info Retrieval Group",THUIR10QaHt,67,1000,1000,0,1,,0
2010,"Tsinghua University, Info Retrieval Group",THUIR10QaHt,68,1000,1000,0,1,,0
2010,"Tsinghua University, Info Retrieval Group",THUIR10QaHt,69,1000,1000,0,1,,0
2010,"Tsinghua University, Info Retrieval Group",THUIR10QaHt,70,1000,1000,0,1,,0
2010,"Tsinghua University, Info Retrieval Group",THUIR10QaHt,71,1000,1000,0,1,,0
2010,"Tsinghua University, Info Retrieval Group",THUIR10QaHt,72,1000,1000,0,1,,0
2010,"Tsinghua University, Info Retrieval Group",THUIR10QaHt,73,1000,1000,0,1,,0
2010,"Tsinghua University, Info Retrieval Group",THUIR10QaHt,74,1000,1000,0,1,,0
2010,"Tsinghua University, Info Retrieval Group",THUIR10QaHt,75,1000,1000,0,1,,0
2010,"Tsinghua University, Info Retrieval Group",THUIR10QaHt,76,1000,1000,0,1,,0
2010,"Tsinghua University, Info Retrieval Group",THUIR10QaHt,77,1000,1000,0,1,,0
2010,"Tsinghua University, Info Retrieval Group",THUIR10QaHt,78,1000,1000,0,1,,0
2010,"Tsinghua University, Info Retrieval Group",THUIR10QaHt,79,1000,1000,0,1,,0
2010,"Tsinghua University, Info Retrieval Group",THUIR10QaHt,80,1000,1000,0,1,,0
2010,"Tsinghua University, Info Retrieval Group",THUIR10QaHt,81,1000,1000,0,1,,0
2010,"Tsinghua University, Info Retrieval Group",THUIR10QaHt,82,1000,1000,0,1,,0
2010,"Tsinghua University, Info Retrieval Group",THUIR10QaHt,83,1000,1000,0,1,,0
2010,"Tsinghua University, Info Retrieval Group",THUIR10QaHt,84,1000,1000,0,1,,0
2010,"Tsinghua University, Info Retrieval Group",THUIR10QaHt,85,1000,1000,0,1,,0
2010,"Tsinghua University, Info Retrieval Group",THUIR10QaHt,86,1000,1000,0,1,,0
2010,"Tsinghua University, Info Retrieval Group",THUIR10QaHt,87,1000,1000,0,1,,0
2010,"Tsinghua University, Info Retrieval Group",THUIR10QaHt,88,1000,1000,0,1,,0
2010,"Tsinghua University, Info Retrieval Group",THUIR10QaHt,89,1000,1000,0,1,,0
2010,"Tsinghua University, Info Retrieval Group",THUIR10QaHt,90,1000,1000,0,1,,0
2010,"Tsinghua University, Info Retrieval Group",THUIR10QaHt,91,1000,1000,0,1,,0
2010,"Tsinghua University, Info Retrieval Group",THUIR10QaHt,92,1000,1000,0,1,,0
2010,"Tsinghua University, Info Retrieval Group",THUIR10QaHt,93,1000,1000,0,1,,0
2010,"Tsinghua University, Info Retrieval Group",THUIR10QaHt,94,1000,1000,0,1,,0
2010,"Tsinghua University, Info Retrieval Group",THUIR10QaHt,95,1000,1000,0,1,,0
2010,"Tsinghua University, Info Retrieval Group",THUIR10QaHt,96,1000,1000,0,1,,0
2010,"Tsinghua University, Info Retrieval Group",THUIR10QaHt,97,1000,1000,0,1,,0
2010,"Tsinghua University, Info Retrieval Group",THUIR10QaHt,98,1000,1000,0,1,,0
2010,"Tsinghua University, Info Retrieval Group",THUIR10QaHt,99,1000,1000,0,1,,0
2010,"Tsinghua University, Info Retrieval Group",THUIR10QaHt,100,1000,1000,0,1,,0
2010,"Tsinghua University, Info Retrieval Group",THUIR10Str,51,1000,966,34,1.01936799184506,2.26666666666667,3.73608440131699e-05
2010,"Tsinghua University, Info Retrieval Group",THUIR10Str,52,1000,969,31,1.01626016260163,2.06666666666667,2.29821191804224e-10
2010,"Tsinghua University, Info Retrieval Group",THUIR10Str,53,1000,982,18,1.00908173562059,2,0.0230996133139917
2010,"Tsinghua University, Info Retrieval Group",THUIR10Str,54,1000,973,27,1.01522842639594,2.25,6.99657269098603e-26
2010,"Tsinghua University, Info Retrieval Group",THUIR10Str,55,1000,960,40,1.02040816326531,2,2.06116622778173e-05
2010,"Tsinghua University, Info Retrieval Group",THUIR10Str,56,1000,961,39,1.02459016393443,2.6,0.000104179460212959
2010,"Tsinghua University, Info Retrieval Group",THUIR10Str,57,1000,953,47,1.03305785123967,3.13333333333333,1.79998988617673e-07
2010,"Tsinghua University, Info Retrieval Group",THUIR10Str,58,1000,954,46,1.02880658436214,2.55555555555556,4.84044025965228e-07
2010,"Tsinghua University, Info Retrieval Group",THUIR10Str,59,1000,991,9,1.00502512562814,2.25,1.50991788777804e-10
2010,"Tsinghua University, Info Retrieval Group",THUIR10Str,60,1000,964,36,1.02145045965271,2.4,1.61403030416264e-10
2010,"Tsinghua University, Info Retrieval Group",THUIR10Str,61,1000,913,87,1.04712041884817,2.07142857142857,3.45591992869819e-06
2010,"Tsinghua University, Info Retrieval Group",THUIR10Str,62,1000,975,25,1.01522842639594,2.5,1.69973375754152e-22
2010,"Tsinghua University, Info Retrieval Group",THUIR10Str,63,1000,972,28,1.01419878296146,2,0.171000000427187
2010,"Tsinghua University, Info Retrieval Group",THUIR10Str,64,1000,921,79,1.04602510460251,2.25714285714286,0.00644472715164023
2010,"Tsinghua University, Info Retrieval Group",THUIR10Str,65,1000,963,37,1.02145045965271,2.3125,4.61223958559418e-05
2010,"Tsinghua University, Info Retrieval Group",THUIR10Str,66,1000,908,92,1.06837606837607,3.28571428571429,6.39200845832889e-05
2010,"Tsinghua University, Info Retrieval Group",THUIR10Str,67,1000,965,35,1.02040816326531,2.33333333333333,0.000450780361524907
2010,"Tsinghua University, Info Retrieval Group",THUIR10Str,68,1000,776,224,1.20192307692308,4,2.62375545975214e-05
2010,"Tsinghua University, Info Retrieval Group",THUIR10Str,69,1000,775,225,1.1454753722795,2.29591836734694,0.000114336321808613
2010,"Tsinghua University, Info Retrieval Group",THUIR10Str,70,1000,982,18,1.00908173562059,2,1.46672328619858e-11
2010,"Tsinghua University, Info Retrieval Group",THUIR10Str,71,1000,971,29,1.01626016260163,2.23076923076923,0.00254361286757278
2010,"Tsinghua University, Info Retrieval Group",THUIR10Str,72,1000,988,12,1.00603621730382,2,8.79479106606302e-11
2010,"Tsinghua University, Info Retrieval Group",THUIR10Str,73,1000,962,38,1.02354145342886,2.53333333333333,1.73749934527938e-07
2010,"Tsinghua University, Info Retrieval Group",THUIR10Str,74,1000,905,95,1.06269925611052,2.63888888888889,3.9524066480206e-08
2010,"Tsinghua University, Info Retrieval Group",THUIR10Str,75,1000,947,53,1.02880658436214,2.12,1.75966517140478e-06
2010,"Tsinghua University, Info Retrieval Group",THUIR10Str,76,1000,978,22,1.01214574898785,2.2,0.00252753098298532
2010,"Tsinghua University, Info Retrieval Group",THUIR10Str,77,1000,901,99,1.06044538706257,2.35714285714286,0.00954683096920797
2010,"Tsinghua University, Info Retrieval Group",THUIR10Str,78,1000,951,49,1.03412616339193,3.0625,0.00428217746655064
2010,"Tsinghua University, Info Retrieval Group",THUIR10Str,79,1000,946,54,1.02986611740474,2.16,1.99462717849908e-05
2010,"Tsinghua University, Info Retrieval Group",THUIR10Str,80,1000,957,43,1.0351966873706,4.77777777777778,2.88181622023281e-06
2010,"Tsinghua University, Info Retrieval Group",THUIR10Str,81,1000,919,81,1.04712041884817,2.25,1.99130427067432e-05
2010,"Tsinghua University, Info Retrieval Group",THUIR10Str,82,1000,939,61,1.03412616339193,2.17857142857143,1.61908055341979e-07
2010,"Tsinghua University, Info Retrieval Group",THUIR10Str,83,1000,925,75,1.04384133611691,2.27272727272727,0.0285213785933727
2010,"Tsinghua University, Info Retrieval Group",THUIR10Str,84,1000,829,171,1.11982082866741,2.671875,1.58377616494405e-06
2010,"Tsinghua University, Info Retrieval Group",THUIR10Str,85,1000,986,14,1.00704934541793,2,2.42121340299638e-18
2010,"Tsinghua University, Info Retrieval Group",THUIR10Str,86,1000,979,21,1.01112234580384,2.1,3.05459448525295e-05
2010,"Tsinghua University, Info Retrieval Group",THUIR10Str,87,1000,979,21,1.01112234580384,2.1,1.98541785030379e-05
2010,"Tsinghua University, Info Retrieval Group",THUIR10Str,88,1000,958,42,1.02145045965271,2,4.0259979508738e-07
2010,"Tsinghua University, Info Retrieval Group",THUIR10Str,89,1000,919,81,1.04602510460251,2.18918918918919,5.58113912515815e-05
2010,"Tsinghua University, Info Retrieval Group",THUIR10Str,90,1000,788,212,1.14025085518814,2.38202247191011,0.0150844778980087
2010,"Tsinghua University, Info Retrieval Group",THUIR10Str,91,1000,795,205,1.12359550561798,2.15789473684211,3.80071232088697e-05
2010,"Tsinghua University, Info Retrieval Group",THUIR10Str,92,1000,983,17,1.00908173562059,2.125,4.97572146404456e-18
2010,"Tsinghua University, Info Retrieval Group",THUIR10Str,93,1000,945,55,1.03305785123967,2.39130434782609,7.07464762800607e-05
2010,"Tsinghua University, Info Retrieval Group",THUIR10Str,94,1000,938,62,1.03734439834025,2.38461538461538,0.412958497972527
2010,"Tsinghua University, Info Retrieval Group",THUIR10Str,95,1000,817,183,1.15874855156431,3.97826086956522,5.77026243247962e-11
2010,"Tsinghua University, Info Retrieval Group",THUIR10Str,96,1000,956,44,1.02249488752556,2,0.000471045206112929
2010,"Tsinghua University, Info Retrieval Group",THUIR10Str,97,1000,974,26,1.01317122593718,2,0.000119142283341798
2010,"Tsinghua University, Info Retrieval Group",THUIR10Str,98,1000,902,98,1.06837606837607,2.88235294117647,0.0391193150985446
2010,"Tsinghua University, Info Retrieval Group",THUIR10Str,99,1000,901,99,1.06044538706257,2.35714285714286,4.13696807602101e-07
2010,"Tsinghua University, Info Retrieval Group",THUIR10Str,100,1000,972,28,1.01419878296146,2,1.72938027067299e-14
2010,University of Amsterdam (Kamps),UAMSA10d2a8,51,1000,929,71,1.04058272632674,2.21875,1.04692927148361e-07
2010,University of Amsterdam (Kamps),UAMSA10d2a8,52,1000,944,56,1.02986611740474,2.07407407407407,1.2136128300459e-15
2010,University of Amsterdam (Kamps),UAMSA10d2a8,53,1000,937,63,1.03950103950104,2.52,0.000228951186308376
2010,University of Amsterdam (Kamps),UAMSA10d2a8,54,1000,956,44,1.02459016393443,2.2,1.99264558050254e-05
2010,University of Amsterdam (Kamps),UAMSA10d2a8,55,1000,968,32,1.01626016260163,2,3.3281848966836e-06
2010,University of Amsterdam (Kamps),UAMSA10d2a8,56,1000,949,51,1.03412616339193,2.83333333333333,5.53669612360135e-05
2010,University of Amsterdam (Kamps),UAMSA10d2a8,57,1000,880,120,1.07874865156419,2.5531914893617,0.0169109973513731
2010,University of Amsterdam (Kamps),UAMSA10d2a8,58,1000,953,47,1.02986611740474,2.61111111111111,0.00130281649499957
2010,University of Amsterdam (Kamps),UAMSA10d2a8,59,1000,739,261,1.20627261761158,2.9,4.66155594541934e-05
2010,University of Amsterdam (Kamps),UAMSA10d2a8,60,1000,985,15,1.00806451612903,2.14285714285714,7.41475251725405e-29
2010,University of Amsterdam (Kamps),UAMSA10d2a8,61,1000,958,42,1.02669404517454,2.625,8.16238650582015e-09
2010,University of Amsterdam (Kamps),UAMSA10d2a8,62,1000,968,32,1.0183299389002,2.28571428571429,3.30429282144349e-13
2010,University of Amsterdam (Kamps),UAMSA10d2a8,63,1000,974,26,1.01419878296146,2.16666666666667,5.34406345389477e-16
2010,University of Amsterdam (Kamps),UAMSA10d2a8,64,1000,985,15,1.00806451612903,2.14285714285714,1.26277587773031e-32
2010,University of Amsterdam (Kamps),UAMSA10d2a8,65,1000,962,38,1.02040816326531,2.11111111111111,7.73320925443321e-11
2010,University of Amsterdam (Kamps),UAMSA10d2a8,66,1000,952,48,1.02986611740474,2.52631578947368,8.5650775013501e-11
2010,University of Amsterdam (Kamps),UAMSA10d2a8,67,1000,867,133,1.08225108225108,2.33333333333333,5.75362352206595e-10
2010,University of Amsterdam (Kamps),UAMSA10d2a8,68,1000,977,23,1.01214574898785,2.09090909090909,1.6770237243802e-16
2010,University of Amsterdam (Kamps),UAMSA10d2a8,69,1000,892,108,1.06496272630458,2.29787234042553,1.47975643235814e-05
2010,University of Amsterdam (Kamps),UAMSA10d2a8,70,1000,933,67,1.0351966873706,2.03030303030303,0.0078425549813589
2010,University of Amsterdam (Kamps),UAMSA10d2a8,71,1000,953,47,1.02564102564103,2.13636363636364,6.92288947953846e-06
2010,University of Amsterdam (Kamps),UAMSA10d2a8,72,1000,943,57,1.03199174406605,2.19230769230769,5.16571681823823e-09
2010,University of Amsterdam (Kamps),UAMSA10d2a8,73,1000,980,20,1.01010101010101,2,8.41868632276657e-07
2010,University of Amsterdam (Kamps),UAMSA10d2a8,74,1000,969,31,1.0183299389002,2.38461538461538,7.09447557175041e-25
2010,University of Amsterdam (Kamps),UAMSA10d2a8,75,1000,937,63,1.03626943005181,2.25,0.00149248246677982
2010,University of Amsterdam (Kamps),UAMSA10d2a8,76,1000,932,68,1.04058272632674,2.3448275862069,8.89440579525383e-13
2010,University of Amsterdam (Kamps),UAMSA10d2a8,77,1000,979,21,1.01214574898785,2.33333333333333,0.00227477788468679
2010,University of Amsterdam (Kamps),UAMSA10d2a8,78,1000,830,170,1.12739571589628,2.98245614035088,1.66032357582481e-07
2010,University of Amsterdam (Kamps),UAMSA10d2a8,79,1000,816,184,1.12866817155756,2.62857142857143,0.0346717609792474
2010,University of Amsterdam (Kamps),UAMSA10d2a8,80,1000,927,73,1.04275286757039,2.28125,3.95013632984968e-15
2010,University of Amsterdam (Kamps),UAMSA10d2a8,81,1000,794,206,1.18906064209275,4.38297872340426,1.30288245127864e-05
2010,University of Amsterdam (Kamps),UAMSA10d2a8,82,1000,972,28,1.01522842639594,2.15384615384615,2.10767808831117e-13
2010,University of Amsterdam (Kamps),UAMSA10d2a8,83,1000,913,87,1.05042016806723,2.23076923076923,0.00137221628010772
2010,University of Amsterdam (Kamps),UAMSA10d2a8,84,1000,898,102,1.06496272630458,2.48780487804878,1.19472880280302e-12
2010,University of Amsterdam (Kamps),UAMSA10d2a8,85,1000,952,48,1.02774922918808,2.28571428571429,1.75970562010298e-06
2010,University of Amsterdam (Kamps),UAMSA10d2a8,86,1000,969,31,1.01729399796541,2.21428571428571,2.03640684314602e-08
2010,University of Amsterdam (Kamps),UAMSA10d2a8,87,1000,954,46,1.02459016393443,2.09090909090909,0.0169885585507659
2010,University of Amsterdam (Kamps),UAMSA10d2a8,88,1000,878,122,1.07066381156317,2.17857142857143,8.19541595283659e-07
2010,University of Amsterdam (Kamps),UAMSA10d2a8,89,1000,984,16,1.00908173562059,2.28571428571429,1.01076175062994e-19
2010,University of Amsterdam (Kamps),UAMSA10d2a8,90,1000,865,135,1.07642626480086,2.109375,1.12502018589109e-08
2010,University of Amsterdam (Kamps),UAMSA10d2a8,91,1000,868,132,1.09289617486339,2.80851063829787,0.00294267398038881
2010,University of Amsterdam (Kamps),UAMSA10d2a8,92,1000,919,81,1.0482180293501,2.31428571428571,1.13047798083405e-08
2010,University of Amsterdam (Kamps),UAMSA10d2a8,93,1000,969,31,1.0183299389002,2.38461538461538,0.000146975275128142
2010,University of Amsterdam (Kamps),UAMSA10d2a8,94,1000,983,17,1.01010101010101,2.42857142857143,2.0282104623213e-21
2010,University of Amsterdam (Kamps),UAMSA10d2a8,95,1000,963,37,1.02145045965271,2.3125,5.03626773717854e-13
2010,University of Amsterdam (Kamps),UAMSA10d2a8,96,1000,970,30,1.0183299389002,2.5,1.04424360304565e-09
2010,University of Amsterdam (Kamps),UAMSA10d2a8,97,1000,831,169,1.14025085518814,3.67391304347826,0.000224068942898886
2010,University of Amsterdam (Kamps),UAMSA10d2a8,98,1000,925,75,1.04602510460251,2.41935483870968,8.41888657598311e-05
2010,University of Amsterdam (Kamps),UAMSA10d2a8,99,1000,917,83,1.0515247108307,2.44117647058824,7.02983401615056e-05
2010,University of Amsterdam (Kamps),UAMSA10d2a8,100,1000,908,92,1.06609808102345,3.06666666666667,1.71662625066256e-09
2010,University of Amsterdam (Kamps),UAMSA10mSF30,51,1000,933,67,1.03626943005181,2.09375,1.08070240780115e-06
2010,University of Amsterdam (Kamps),UAMSA10mSF30,52,1000,928,72,1.03842159916926,2.05714285714286,1.56444323213515e-14
2010,University of Amsterdam (Kamps),UAMSA10mSF30,53,1000,941,59,1.03412616339193,2.26923076923077,0.000278500968039289
2010,University of Amsterdam (Kamps),UAMSA10mSF30,54,1000,960,40,1.02249488752556,2.22222222222222,5.95494676031097e-07
2010,University of Amsterdam (Kamps),UAMSA10mSF30,55,1000,968,32,1.01626016260163,2,7.79432746518157e-06
2010,University of Amsterdam (Kamps),UAMSA10mSF30,56,1000,953,47,1.03199174406605,2.9375,0.000118151762340798
2010,University of Amsterdam (Kamps),UAMSA10mSF30,57,1000,902,98,1.05820105820106,2.27906976744186,0.0258807355900889
2010,University of Amsterdam (Kamps),UAMSA10mSF30,58,1000,960,40,1.02459016393443,2.5,0.000881295560451834
2010,University of Amsterdam (Kamps),UAMSA10mSF30,59,1000,748,252,1.19331742243437,2.8,0.000488979884941317
2010,University of Amsterdam (Kamps),UAMSA10mSF30,60,1000,979,21,1.01214574898785,2.33333333333333,1.80416924416384e-25
2010,University of Amsterdam (Kamps),UAMSA10mSF30,61,1000,969,31,1.01936799184506,2.58333333333333,3.62299121421915e-07
2010,University of Amsterdam (Kamps),UAMSA10mSF30,62,1000,968,32,1.0183299389002,2.28571428571429,1.81076949087915e-11
2010,University of Amsterdam (Kamps),UAMSA10mSF30,63,1000,943,57,1.03412616339193,2.375,4.5479845970396e-21
2010,University of Amsterdam (Kamps),UAMSA10mSF30,64,1000,982,18,1.00908173562059,2,2.11574940894008e-30
2010,University of Amsterdam (Kamps),UAMSA10mSF30,65,1000,926,74,1.05485232067511,3.36363636363636,6.33702703983524e-10
2010,University of Amsterdam (Kamps),UAMSA10mSF30,66,1000,946,54,1.03305785123967,2.45454545454545,2.49442812819795e-09
2010,University of Amsterdam (Kamps),UAMSA10mSF30,67,1000,871,129,1.07991360691145,2.34545454545455,3.51714971716723e-09
2010,University of Amsterdam (Kamps),UAMSA10mSF30,68,1000,969,31,1.0183299389002,2.38461538461538,1.72929382686864e-14
2010,University of Amsterdam (Kamps),UAMSA10mSF30,69,1000,888,112,1.06609808102345,2.24,8.73868254305054e-07
2010,University of Amsterdam (Kamps),UAMSA10mSF30,70,1000,940,60,1.03092783505155,2,0.00795626433058556
2010,University of Amsterdam (Kamps),UAMSA10mSF30,71,1000,945,55,1.02986611740474,2.11538461538462,4.61255567035428e-05
2010,University of Amsterdam (Kamps),UAMSA10mSF30,72,1000,935,65,1.03842159916926,2.32142857142857,1.20898913069466e-08
2010,University of Amsterdam (Kamps),UAMSA10mSF30,73,1000,958,42,1.02249488752556,2.1,3.67901935991975e-06
2010,University of Amsterdam (Kamps),UAMSA10mSF30,74,1000,953,47,1.02880658436214,2.47368421052632,1.39790007648705e-21
2010,University of Amsterdam (Kamps),UAMSA10mSF30,75,1000,942,58,1.03305785123967,2.23076923076923,0.00184257255428766
2010,University of Amsterdam (Kamps),UAMSA10mSF30,76,1000,933,67,1.03950103950104,2.31034482758621,9.22714012946166e-12
2010,University of Amsterdam (Kamps),UAMSA10mSF30,77,1000,983,17,1.00908173562059,2.125,0.00346712068996614
2010,University of Amsterdam (Kamps),UAMSA10mSF30,78,1000,887,113,1.07874865156419,2.825,2.21468666061995e-06
2010,University of Amsterdam (Kamps),UAMSA10mSF30,79,1000,785,215,1.16144018583043,2.82894736842105,0.00262877370629031
2010,University of Amsterdam (Kamps),UAMSA10mSF30,80,1000,907,93,1.05820105820106,2.44736842105263,1.38938288322879e-11
2010,University of Amsterdam (Kamps),UAMSA10mSF30,81,1000,803,197,1.17924528301887,4.37777777777778,5.16702978554453e-05
2010,University of Amsterdam (Kamps),UAMSA10mSF30,82,1000,964,36,1.01936799184506,2.11764705882353,7.99920151850421e-13
2010,University of Amsterdam (Kamps),UAMSA10mSF30,83,1000,914,86,1.04931794333683,2.20512820512821,4.77572112012026e-09
2010,University of Amsterdam (Kamps),UAMSA10mSF30,84,1000,917,83,1.05042016806723,2.37142857142857,1.69565738898515e-11
2010,University of Amsterdam (Kamps),UAMSA10mSF30,85,1000,962,38,1.02040816326531,2.11111111111111,3.31123806578446e-06
2010,University of Amsterdam (Kamps),UAMSA10mSF30,86,1000,963,37,1.02040816326531,2.17647058823529,3.89379462241086e-08
2010,University of Amsterdam (Kamps),UAMSA10mSF30,87,1000,957,43,1.02249488752556,2.04761904761905,0.0398436568404135
2010,University of Amsterdam (Kamps),UAMSA10mSF30,88,1000,890,110,1.06496272630458,2.24489795918367,3.71922243559044e-06
2010,University of Amsterdam (Kamps),UAMSA10mSF30,89,1000,982,18,1.01010101010101,2.25,1.26715350379556e-18
2010,University of Amsterdam (Kamps),UAMSA10mSF30,90,1000,852,148,1.08342361863489,2.08450704225352,6.29624650413996e-07
2010,University of Amsterdam (Kamps),UAMSA10mSF30,91,1000,857,143,1.1001100110011,2.75,0.00761632441108803
2010,University of Amsterdam (Kamps),UAMSA10mSF30,92,1000,922,78,1.04712041884817,2.36363636363636,5.51027746859128e-08
2010,University of Amsterdam (Kamps),UAMSA10mSF30,93,1000,972,28,1.01729399796541,2.54545454545455,0.00027655994285947
2010,University of Amsterdam (Kamps),UAMSA10mSF30,94,1000,984,16,1.00908173562059,2.28571428571429,2.70790246688507e-18
2010,University of Amsterdam (Kamps),UAMSA10mSF30,95,1000,938,62,1.03734439834025,2.38461538461538,1.70835775585808e-15
2010,University of Amsterdam (Kamps),UAMSA10mSF30,96,1000,966,34,1.02249488752556,2.83333333333333,6.61124312740329e-09
2010,University of Amsterdam (Kamps),UAMSA10mSF30,97,1000,833,167,1.13636363636364,3.5531914893617,0.000341441947907433
2010,University of Amsterdam (Kamps),UAMSA10mSF30,98,1000,924,76,1.04493207941484,2.3030303030303,0.000163400784082082
2010,University of Amsterdam (Kamps),UAMSA10mSF30,99,1000,899,101,1.06609808102345,2.58974358974359,0.000224013526552077
2010,University of Amsterdam (Kamps),UAMSA10mSF30,100,1000,908,92,1.06951871657754,3.40740740740741,9.15153481759926e-09
2010,University of Amsterdam (Kamps),UAMSA10mSFPR,51,1000,1000,0,1,,0
2010,University of Amsterdam (Kamps),UAMSA10mSFPR,52,1000,1000,0,1,,0
2010,University of Amsterdam (Kamps),UAMSA10mSFPR,53,1000,1000,0,1,,0
2010,University of Amsterdam (Kamps),UAMSA10mSFPR,54,1000,1000,0,1,,0
2010,University of Amsterdam (Kamps),UAMSA10mSFPR,55,1000,1000,0,1,,0
2010,University of Amsterdam (Kamps),UAMSA10mSFPR,56,1000,1000,0,1,,0
2010,University of Amsterdam (Kamps),UAMSA10mSFPR,57,1000,1000,0,1,,0
2010,University of Amsterdam (Kamps),UAMSA10mSFPR,58,1000,1000,0,1,,0
2010,University of Amsterdam (Kamps),UAMSA10mSFPR,59,1000,1000,0,1,,0
2010,University of Amsterdam (Kamps),UAMSA10mSFPR,60,1000,1000,0,1,,0
2010,University of Amsterdam (Kamps),UAMSA10mSFPR,61,1000,1000,0,1,,0
2010,University of Amsterdam (Kamps),UAMSA10mSFPR,62,1000,1000,0,1,,0
2010,University of Amsterdam (Kamps),UAMSA10mSFPR,63,1000,1000,0,1,,0
2010,University of Amsterdam (Kamps),UAMSA10mSFPR,64,1000,1000,0,1,,0
2010,University of Amsterdam (Kamps),UAMSA10mSFPR,65,1000,1000,0,1,,0
2010,University of Amsterdam (Kamps),UAMSA10mSFPR,66,1000,1000,0,1,,0
2010,University of Amsterdam (Kamps),UAMSA10mSFPR,67,1000,1000,0,1,,0
2010,University of Amsterdam (Kamps),UAMSA10mSFPR,68,1000,1000,0,1,,0
2010,University of Amsterdam (Kamps),UAMSA10mSFPR,69,1000,1000,0,1,,0
2010,University of Amsterdam (Kamps),UAMSA10mSFPR,70,1000,1000,0,1,,0
2010,University of Amsterdam (Kamps),UAMSA10mSFPR,71,1000,1000,0,1,,0
2010,University of Amsterdam (Kamps),UAMSA10mSFPR,72,1000,1000,0,1,,0
2010,University of Amsterdam (Kamps),UAMSA10mSFPR,73,1000,1000,0,1,,0
2010,University of Amsterdam (Kamps),UAMSA10mSFPR,74,1000,1000,0,1,,0
2010,University of Amsterdam (Kamps),UAMSA10mSFPR,75,1000,1000,0,1,,0
2010,University of Amsterdam (Kamps),UAMSA10mSFPR,76,1000,1000,0,1,,0
2010,University of Amsterdam (Kamps),UAMSA10mSFPR,77,1000,1000,0,1,,0
2010,University of Amsterdam (Kamps),UAMSA10mSFPR,78,1000,1000,0,1,,0
2010,University of Amsterdam (Kamps),UAMSA10mSFPR,79,1000,1000,0,1,,0
2010,University of Amsterdam (Kamps),UAMSA10mSFPR,80,1000,1000,0,1,,0
2010,University of Amsterdam (Kamps),UAMSA10mSFPR,81,1000,1000,0,1,,0
2010,University of Amsterdam (Kamps),UAMSA10mSFPR,82,1000,1000,0,1,,0
2010,University of Amsterdam (Kamps),UAMSA10mSFPR,83,1000,1000,0,1,,0
2010,University of Amsterdam (Kamps),UAMSA10mSFPR,84,1000,1000,0,1,,0
2010,University of Amsterdam (Kamps),UAMSA10mSFPR,85,1000,1000,0,1,,0
2010,University of Amsterdam (Kamps),UAMSA10mSFPR,86,1000,1000,0,1,,0
2010,University of Amsterdam (Kamps),UAMSA10mSFPR,87,1000,1000,0,1,,0
2010,University of Amsterdam (Kamps),UAMSA10mSFPR,88,1000,1000,0,1,,0
2010,University of Amsterdam (Kamps),UAMSA10mSFPR,89,1000,1000,0,1,,0
2010,University of Amsterdam (Kamps),UAMSA10mSFPR,90,1000,1000,0,1,,0
2010,University of Amsterdam (Kamps),UAMSA10mSFPR,91,1000,1000,0,1,,0
2010,University of Amsterdam (Kamps),UAMSA10mSFPR,92,1000,1000,0,1,,0
2010,University of Amsterdam (Kamps),UAMSA10mSFPR,93,1000,1000,0,1,,0
2010,University of Amsterdam (Kamps),UAMSA10mSFPR,94,1000,998,2,1.001001001001,2,5.51062917700813e-14
2010,University of Amsterdam (Kamps),UAMSA10mSFPR,95,1000,998,2,1.001001001001,2,4.85389902009891e-36
2010,University of Amsterdam (Kamps),UAMSA10mSFPR,96,1000,1000,0,1,,0
2010,University of Amsterdam (Kamps),UAMSA10mSFPR,97,1000,1000,0,1,,0
2010,University of Amsterdam (Kamps),UAMSA10mSFPR,98,1000,994,6,1.00401606425703,3,3.39709942267462e-25
2010,University of Amsterdam (Kamps),UAMSA10mSFPR,99,1000,1000,0,1,,0
2010,University of Amsterdam (Kamps),UAMSA10mSFPR,100,1000,1000,0,1,,0
2010,"SCSI, University College Dublin",UCDSIFTMAP,51,1000,1000,0,1,,0
2010,"SCSI, University College Dublin",UCDSIFTMAP,52,1000,1000,0,1,,0
2010,"SCSI, University College Dublin",UCDSIFTMAP,53,1000,1000,0,1,,0
2010,"SCSI, University College Dublin",UCDSIFTMAP,54,1000,1000,0,1,,0
2010,"SCSI, University College Dublin",UCDSIFTMAP,55,1000,1000,0,1,,0
2010,"SCSI, University College Dublin",UCDSIFTMAP,56,1000,1000,0,1,,0
2010,"SCSI, University College Dublin",UCDSIFTMAP,57,1000,1000,0,1,,0
2010,"SCSI, University College Dublin",UCDSIFTMAP,58,1000,1000,0,1,,0
2010,"SCSI, University College Dublin",UCDSIFTMAP,59,1000,1000,0,1,,0
2010,"SCSI, University College Dublin",UCDSIFTMAP,60,1000,1000,0,1,,0
2010,"SCSI, University College Dublin",UCDSIFTMAP,61,1000,1000,0,1,,0
2010,"SCSI, University College Dublin",UCDSIFTMAP,62,1000,1000,0,1,,0
2010,"SCSI, University College Dublin",UCDSIFTMAP,63,1000,1000,0,1,,0
2010,"SCSI, University College Dublin",UCDSIFTMAP,64,1000,1000,0,1,,0
2010,"SCSI, University College Dublin",UCDSIFTMAP,65,1000,1000,0,1,,0
2010,"SCSI, University College Dublin",UCDSIFTMAP,66,1000,1000,0,1,,0
2010,"SCSI, University College Dublin",UCDSIFTMAP,67,1000,1000,0,1,,0
2010,"SCSI, University College Dublin",UCDSIFTMAP,68,1000,1000,0,1,,0
2010,"SCSI, University College Dublin",UCDSIFTMAP,69,1000,1000,0,1,,0
2010,"SCSI, University College Dublin",UCDSIFTMAP,70,1000,1000,0,1,,0
2010,"SCSI, University College Dublin",UCDSIFTMAP,71,1000,1000,0,1,,0
2010,"SCSI, University College Dublin",UCDSIFTMAP,72,1000,1000,0,1,,0
2010,"SCSI, University College Dublin",UCDSIFTMAP,73,1000,1000,0,1,,0
2010,"SCSI, University College Dublin",UCDSIFTMAP,74,1000,1000,0,1,,0
2010,"SCSI, University College Dublin",UCDSIFTMAP,75,1000,1000,0,1,,0
2010,"SCSI, University College Dublin",UCDSIFTMAP,76,1000,1000,0,1,,0
2010,"SCSI, University College Dublin",UCDSIFTMAP,77,1000,1000,0,1,,0
2010,"SCSI, University College Dublin",UCDSIFTMAP,78,1000,1000,0,1,,0
2010,"SCSI, University College Dublin",UCDSIFTMAP,79,1000,1000,0,1,,0
2010,"SCSI, University College Dublin",UCDSIFTMAP,80,1000,1000,0,1,,0
2010,"SCSI, University College Dublin",UCDSIFTMAP,81,1000,1000,0,1,,0
2010,"SCSI, University College Dublin",UCDSIFTMAP,82,1000,1000,0,1,,0
2010,"SCSI, University College Dublin",UCDSIFTMAP,83,1000,1000,0,1,,0
2010,"SCSI, University College Dublin",UCDSIFTMAP,84,1000,1000,0,1,,0
2010,"SCSI, University College Dublin",UCDSIFTMAP,85,1000,1000,0,1,,0
2010,"SCSI, University College Dublin",UCDSIFTMAP,86,1000,1000,0,1,,0
2010,"SCSI, University College Dublin",UCDSIFTMAP,87,1000,1000,0,1,,0
2010,"SCSI, University College Dublin",UCDSIFTMAP,88,1000,1000,0,1,,0
2010,"SCSI, University College Dublin",UCDSIFTMAP,89,1000,1000,0,1,,0
2010,"SCSI, University College Dublin",UCDSIFTMAP,90,1000,1000,0,1,,0
2010,"SCSI, University College Dublin",UCDSIFTMAP,91,1000,1000,0,1,,0
2010,"SCSI, University College Dublin",UCDSIFTMAP,92,1000,1000,0,1,,0
2010,"SCSI, University College Dublin",UCDSIFTMAP,93,1000,1000,0,1,,0
2010,"SCSI, University College Dublin",UCDSIFTMAP,94,1000,1000,0,1,,0
2010,"SCSI, University College Dublin",UCDSIFTMAP,95,1000,1000,0,1,,0
2010,"SCSI, University College Dublin",UCDSIFTMAP,96,1000,1000,0,1,,0
2010,"SCSI, University College Dublin",UCDSIFTMAP,97,1000,1000,0,1,,0
2010,"SCSI, University College Dublin",UCDSIFTMAP,98,1000,1000,0,1,,0
2010,"SCSI, University College Dublin",UCDSIFTMAP,99,1000,1000,0,1,,0
2010,"SCSI, University College Dublin",UCDSIFTMAP,100,1000,1000,0,1,,0
2010,"SCSI, University College Dublin",UCDSIFTProb,51,1000,55,945,7.93650793650794,13.3098591549296,0.99901975583813
2010,"SCSI, University College Dublin",UCDSIFTProb,52,1000,33,967,8.92857142857143,12.2405063291139,0.996909684561736
2010,"SCSI, University College Dublin",UCDSIFTProb,53,1000,152,848,3.92156862745098,8.23300970873786,0.997173935781609
2010,"SCSI, University College Dublin",UCDSIFTProb,54,1000,105,895,5.3475935828877,10.9146341463415,0.933199007289773
2010,"SCSI, University College Dublin",UCDSIFTProb,55,1000,125,875,4.52488687782805,9.11458333333333,0.80835513493234
2010,"SCSI, University College Dublin",UCDSIFTProb,56,1000,126,874,5.05050505050505,12.1388888888889,0.936790116864986
2010,"SCSI, University College Dublin",UCDSIFTProb,57,1000,114,886,5,10.3023255813953,0.999904499500261
2010,"SCSI, University College Dublin",UCDSIFTProb,58,1000,117,883,4.42477876106195,8.10091743119266,0.97150529161258
2010,"SCSI, University College Dublin",UCDSIFTProb,59,1000,154,846,4.20168067226891,10.0714285714286,0.983641529339626
2010,"SCSI, University College Dublin",UCDSIFTProb,60,1000,63,937,6.28930817610063,9.76041666666667,0.980392250880628
2010,"SCSI, University College Dublin",UCDSIFTProb,61,1000,100,900,5.15463917525773,9.57446808510638,0.878988538929327
2010,"SCSI, University College Dublin",UCDSIFTProb,62,1000,111,889,4.65116279069768,8.54807692307692,0.999293034938757
2010,"SCSI, University College Dublin",UCDSIFTProb,63,1000,75,925,6.09756097560976,10.3932584269663,0.959615630750453
2010,"SCSI, University College Dublin",UCDSIFTProb,64,1000,49,951,7.19424460431655,10.5666666666667,0.995118265255073
2010,"SCSI, University College Dublin",UCDSIFTProb,65,1000,93,907,5.43478260869565,9.96703296703297,0.773468823702518
2010,"SCSI, University College Dublin",UCDSIFTProb,66,1000,167,833,3.66300366300366,7.85849056603774,0.998765514204291
2010,"SCSI, University College Dublin",UCDSIFTProb,67,1000,33,967,10.8695652173913,16.3898305084746,0.99903022477236
2010,"SCSI, University College Dublin",UCDSIFTProb,68,1000,71,929,6.02409638554217,9.77894736842105,0.999651411241009
2010,"SCSI, University College Dublin",UCDSIFTProb,69,1000,93,907,5.31914893617021,9.54736842105263,0.994948438128407
2010,"SCSI, University College Dublin",UCDSIFTProb,70,1000,46,954,11.2359550561798,22.1860465116279,0.918999999971934
2010,"SCSI, University College Dublin",UCDSIFTProb,71,1000,111,889,4.739336492891,8.89,0.965464950667004
2010,"SCSI, University College Dublin",UCDSIFTProb,72,1000,102,898,5.98802395209581,13.8153846153846,0.73607133538488
2010,"SCSI, University College Dublin",UCDSIFTProb,73,1000,57,943,7.19424460431655,11.5,0.9977468542032
2010,"SCSI, University College Dublin",UCDSIFTProb,74,1000,62,938,7.09219858156028,11.873417721519,0.981469754489156
2010,"SCSI, University College Dublin",UCDSIFTProb,75,1000,81,919,5.37634408602151,8.75238095238095,0.998815510462849
2010,"SCSI, University College Dublin",UCDSIFTProb,76,1000,126,874,4.80769230769231,10.6585365853659,0.999829621288354
2010,"SCSI, University College Dublin",UCDSIFTProb,77,1000,65,935,6.45161290322581,10.3888888888889,0.999999978589739
2010,"SCSI, University College Dublin",UCDSIFTProb,78,1000,127,873,5.46448087431694,15.5892857142857,0.739977209999998
2010,"SCSI, University College Dublin",UCDSIFTProb,79,1000,118,882,4.69483568075117,9.28421052631579,0.982318808786327
2010,"SCSI, University College Dublin",UCDSIFTProb,80,1000,119,881,4.58715596330275,8.8989898989899,0.950554873890715
2010,"SCSI, University College Dublin",UCDSIFTProb,81,1000,129,871,4.83091787439614,11.1666666666667,0.555964711988168
2010,"SCSI, University College Dublin",UCDSIFTProb,82,1000,129,871,4.71698113207547,10.4939759036145,0.952269053004763
2010,"SCSI, University College Dublin",UCDSIFTProb,83,1000,22,978,15.3846153846154,22.7441860465116,0.809999999999978
2010,"SCSI, University College Dublin",UCDSIFTProb,84,1000,44,956,8.26446280991735,12.4155844155844,0.999994446671328
2010,"SCSI, University College Dublin",UCDSIFTProb,85,1000,46,954,8.54700854700855,13.4366197183099,0.997496844495007
2010,"SCSI, University College Dublin",UCDSIFTProb,86,1000,92,908,4.92610837438424,8.18018018018018,0.999020586218932
2010,"SCSI, University College Dublin",UCDSIFTProb,87,1000,172,828,3.89105058365759,9.74117647058823,0.859751953512654
2010,"SCSI, University College Dublin",UCDSIFTProb,88,1000,70,930,6.89655172413793,12.4,0.999836700648965
2010,"SCSI, University College Dublin",UCDSIFTProb,89,1000,42,958,7.93650793650794,11.4047619047619,1
2010,"SCSI, University College Dublin",UCDSIFTProb,90,1000,53,947,6.89655172413793,10.2934782608696,0.998922466358567
2010,"SCSI, University College Dublin",UCDSIFTProb,91,1000,167,833,4.01606425702811,10.1585365853659,0.978444430973255
2010,"SCSI, University College Dublin",UCDSIFTProb,92,1000,118,882,5.88235294117647,16.9615384615385,0.382484956781701
2010,"SCSI, University College Dublin",UCDSIFTProb,93,1000,43,957,8.26446280991735,12.2692307692308,0.979410886789105
2010,"SCSI, University College Dublin",UCDSIFTProb,94,1000,129,871,4.18410041841004,7.91818181818182,0.99878505204711
2010,"SCSI, University College Dublin",UCDSIFTProb,95,1000,143,857,4.31034482758621,9.62921348314607,0.999773836919334
2010,"SCSI, University College Dublin",UCDSIFTProb,96,1000,135,865,4.42477876106195,9.50549450549451,0.892078599678641
2010,"SCSI, University College Dublin",UCDSIFTProb,97,1000,152,848,4.48430493273543,11.943661971831,0.955728126045246
2010,"SCSI, University College Dublin",UCDSIFTProb,98,1000,83,917,6.99300699300699,15.2833333333333,0.841809197467788
2010,"SCSI, University College Dublin",UCDSIFTProb,99,1000,105,895,5.0251256281407,9.52127659574468,0.911588026787433
2010,"SCSI, University College Dublin",UCDSIFTProb,100,1000,47,953,7.2463768115942,10.4725274725275,0.999999999938751
2010,"SCSI, University College Dublin",UCDSIFTSlide,51,1000,562,438,1.52439024390244,4.65957446808511,3.47912267616449e-07
2010,"SCSI, University College Dublin",UCDSIFTSlide,52,1000,711,289,1.2453300124533,3.14130434782609,2.05727338372641e-07
2010,"SCSI, University College Dublin",UCDSIFTSlide,53,1000,542,458,1.58982511923688,5.26436781609195,0.124907903896731
2010,"SCSI, University College Dublin",UCDSIFTSlide,54,1000,493,507,1.70068027210884,5.33684210526316,1.01378479907332e-09
2010,"SCSI, University College Dublin",UCDSIFTSlide,55,1000,504,496,1.72413793103448,6.52631578947368,3.24378143043682e-07
2010,"SCSI, University College Dublin",UCDSIFTSlide,56,1000,342,658,2.12765957446809,5.140625,0.178941303639986
2010,"SCSI, University College Dublin",UCDSIFTSlide,57,1000,544,456,1.6260162601626,6.42253521126761,5.85957679686139e-10
2010,"SCSI, University College Dublin",UCDSIFTSlide,58,1000,566,434,1.52439024390244,4.82222222222222,2.37075431679814e-05
2010,"SCSI, University College Dublin",UCDSIFTSlide,59,1000,519,481,1.63934426229508,5.28571428571429,1.90144116288553e-06
2010,"SCSI, University College Dublin",UCDSIFTSlide,60,1000,617,383,1.39275766016713,3.79207920792079,8.84822495555962e-09
2010,"SCSI, University College Dublin",UCDSIFTSlide,61,1000,513,487,1.64473684210526,5.12631578947369,2.67584825215723e-08
2010,"SCSI, University College Dublin",UCDSIFTSlide,62,1000,579,421,1.52439024390244,5.46753246753247,3.96424942185828e-08
2010,"SCSI, University College Dublin",UCDSIFTSlide,63,1000,551,449,1.57232704402516,5.28235294117647,1.36537294909957e-07
2010,"SCSI, University College Dublin",UCDSIFTSlide,64,1000,606,394,1.41843971631206,3.97979797979798,7.5917314958579e-07
2010,"SCSI, University College Dublin",UCDSIFTSlide,65,1000,489,511,1.69779286926995,5.11,4.37192511675933e-08
2010,"SCSI, University College Dublin",UCDSIFTSlide,66,1000,577,423,1.50602409638554,4.86206896551724,9.82484860522865e-09
2010,"SCSI, University College Dublin",UCDSIFTSlide,67,1000,655,345,1.2970168612192,2.97413793103448,1.83872509130085e-05
2010,"SCSI, University College Dublin",UCDSIFTSlide,68,1000,637,363,1.3531799729364,3.55882352941176,0.00532100200538637
2010,"SCSI, University College Dublin",UCDSIFTSlide,69,1000,550,450,1.55763239875389,4.89130434782609,0.0536635727934855
2010,"SCSI, University College Dublin",UCDSIFTSlide,70,1000,352,648,2.1978021978022,6.29126213592233,0.00281143355091586
2010,"SCSI, University College Dublin",UCDSIFTSlide,71,1000,447,553,1.87617260787993,6.43023255813954,0.00475665423781338
2010,"SCSI, University College Dublin",UCDSIFTSlide,72,1000,395,605,2.05338809034908,6.57608695652174,0.112421826583394
2010,"SCSI, University College Dublin",UCDSIFTSlide,73,1000,655,345,1.34048257372654,3.79120879120879,1.3378076534328e-08
2010,"SCSI, University College Dublin",UCDSIFTSlide,74,1000,664,336,1.3262599469496,3.73333333333333,1.84593014554009e-08
2010,"SCSI, University College Dublin",UCDSIFTSlide,75,1000,572,428,1.4792899408284,4.11538461538462,5.36317176678383e-07
2010,"SCSI, University College Dublin",UCDSIFTSlide,76,1000,494,506,1.69491525423729,5.27083333333333,2.31004873136537e-07
2010,"SCSI, University College Dublin",UCDSIFTSlide,77,1000,632,368,1.36986301369863,3.75510204081633,1.541509982647e-10
2010,"SCSI, University College Dublin",UCDSIFTSlide,78,1000,375,625,2.04498977505112,5.48245614035088,0.00439965652935043
2010,"SCSI, University College Dublin",UCDSIFTSlide,79,1000,497,503,1.70068027210884,5.52747252747253,5.02777695574893e-07
2010,"SCSI, University College Dublin",UCDSIFTSlide,80,1000,503,497,1.66389351081531,5.07142857142857,0.00186935602906303
2010,"SCSI, University College Dublin",UCDSIFTSlide,81,1000,413,587,1.953125,5.92929292929293,2.04750962206592e-06
2010,"SCSI, University College Dublin",UCDSIFTSlide,82,1000,426,574,1.9047619047619,5.7979797979798,6.42904452166e-07
2010,"SCSI, University College Dublin",UCDSIFTSlide,83,1000,283,717,2.47524752475248,5.92561983471074,7.29517882636669e-05
2010,"SCSI, University College Dublin",UCDSIFTSlide,84,1000,662,338,1.32802124833997,3.71428571428571,6.13620882657095e-07
2010,"SCSI, University College Dublin",UCDSIFTSlide,85,1000,580,420,1.48588410104012,4.51612903225807,1.06096776159233e-07
2010,"SCSI, University College Dublin",UCDSIFTSlide,86,1000,614,386,1.41043723554302,4.06315789473684,1.93290336976505e-07
2010,"SCSI, University College Dublin",UCDSIFTSlide,87,1000,452,548,1.82149362477231,5.64948453608248,2.45908490636544e-05
2010,"SCSI, University College Dublin",UCDSIFTSlide,88,1000,548,452,1.58478605388273,5.44578313253012,3.40175061117484e-06
2010,"SCSI, University College Dublin",UCDSIFTSlide,89,1000,737,263,1.20481927710843,2.82795698924731,2.50551837747052e-10
2010,"SCSI, University College Dublin",UCDSIFTSlide,90,1000,685,315,1.27713920817369,3.21428571428571,2.21805700654881e-07
2010,"SCSI, University College Dublin",UCDSIFTSlide,91,1000,465,535,1.8018018018018,5.94444444444445,0.000120852988011744
2010,"SCSI, University College Dublin",UCDSIFTSlide,92,1000,377,623,2.08333333333333,6.04854368932039,0.00209194298299117
2010,"SCSI, University College Dublin",UCDSIFTSlide,93,1000,631,369,1.36612021857924,3.65346534653465,6.66853004651316e-07
2010,"SCSI, University College Dublin",UCDSIFTSlide,94,1000,572,428,1.50375939849624,4.60215053763441,9.71890959004637e-08
2010,"SCSI, University College Dublin",UCDSIFTSlide,95,1000,511,489,1.70648464163823,6.52,0.00204925566856787
2010,"SCSI, University College Dublin",UCDSIFTSlide,96,1000,503,497,1.68634064080944,5.52222222222222,1.30690188516e-05
2010,"SCSI, University College Dublin",UCDSIFTSlide,97,1000,446,554,1.85873605947955,6.02173913043478,5.63949567882996e-08
2010,"SCSI, University College Dublin",UCDSIFTSlide,98,1000,379,621,2.02020202020202,5.35344827586207,0.210448190087437
2010,"SCSI, University College Dublin",UCDSIFTSlide,99,1000,490,510,1.74216027874564,6.07142857142857,1.27446932793269e-07
2010,"SCSI, University College Dublin",UCDSIFTSlide,100,1000,637,363,1.3531799729364,3.55882352941176,3.31495679771608e-08
2010,The University of Melbourne,UMa10BASF,51,1000,39,961,11.6279069767442,20.4468085106383,0.431606361834182
2010,The University of Melbourne,UMa10BASF,52,1000,1,999,52.6315789473684,55.5,0.9717570463519
2010,The University of Melbourne,UMa10BASF,53,1000,202,798,3.3003300330033,7.9009900990099,0.115766579766518
2010,The University of Melbourne,UMa10BASF,54,1000,103,897,7.69230769230769,33.2222222222222,0.0313514308645192
2010,The University of Melbourne,UMa10BASF,55,1000,0,1000,166.666666666667,166.666666666667,1
2010,The University of Melbourne,UMa10BASF,56,1000,314,686,2.17864923747277,4.73103448275862,0.137440599459784
2010,The University of Melbourne,UMa10BASF,57,1000,33,967,16.9491525423729,37.1923076923077,0.21268017442835
2010,The University of Melbourne,UMa10BASF,58,1000,0,1000,166.666666666667,166.666666666667,1
2010,The University of Melbourne,UMa10BASF,59,1000,144,856,4.0650406504065,8.3921568627451,0.214963735804846
2010,The University of Melbourne,UMa10BASF,60,1000,1,999,62.5,66.6,0.999996356461058
2010,The University of Melbourne,UMa10BASF,61,1000,0,1000,166.666666666667,166.666666666667,1
2010,The University of Melbourne,UMa10BASF,62,1000,225,775,2.91545189504373,6.56779661016949,0.113294504832977
2010,The University of Melbourne,UMa10BASF,63,1000,0,1000,58.8235294117647,58.8235294117647,1
2010,The University of Melbourne,UMa10BASF,64,1000,1,999,62.5,66.6,0.999999981222019
2010,The University of Melbourne,UMa10BASF,65,1000,72,928,7.8740157480315,16.8727272727273,0.431721626794763
2010,The University of Melbourne,UMa10BASF,66,1000,428,572,1.98412698412698,7.52631578947368,0.000305860966191471
2010,The University of Melbourne,UMa10BASF,67,1000,12,988,19.2307692307692,24.7,0.58019450699533
2010,The University of Melbourne,UMa10BASF,68,1000,2,998,66.6666666666667,76.7692307692308,0.999994446671327
2010,The University of Melbourne,UMa10BASF,69,1000,63,937,8.69565217391304,18.0192307692308,0.424427679025885
2010,The University of Melbourne,UMa10BASF,70,1000,7,993,58.8235294117647,99.3,0.569601101402754
2010,The University of Melbourne,UMa10BASF,71,1000,70,930,7.63358778625954,15.2459016393443,0.116138801679268
2010,The University of Melbourne,UMa10BASF,72,1000,7,993,52.6315789473684,82.75,0.728078952339666
2010,The University of Melbourne,UMa10BASF,73,1000,69,931,8.33333333333333,18.2549019607843,0.592870439192751
2010,The University of Melbourne,UMa10BASF,74,1000,0,1000,55.5555555555556,55.5555555555556,1
2010,The University of Melbourne,UMa10BASF,75,1000,0,1000,111.111111111111,111.111111111111,1
2010,The University of Melbourne,UMa10BASF,76,1000,46,954,10.989010989011,21.2,0.58775984169469
2010,The University of Melbourne,UMa10BASF,77,1000,1,999,55.5555555555556,58.764705882353,0.999999996868362
2010,The University of Melbourne,UMa10BASF,78,1000,0,1000,200,200,1
2010,The University of Melbourne,UMa10BASF,79,1000,1,999,55.5555555555556,58.764705882353,0.999958890168329
2010,The University of Melbourne,UMa10BASF,80,1000,109,891,5.15463917525773,10.4823529411765,0.259065900241324
2010,The University of Melbourne,UMa10BASF,81,1000,0,1000,166.666666666667,166.666666666667,1
2010,The University of Melbourne,UMa10BASF,82,1000,0,1000,125,125,1
2010,The University of Melbourne,UMa10BASF,83,1000,0,1000,166.666666666667,166.666666666667,1
2010,The University of Melbourne,UMa10BASF,84,1000,80,920,7.2463768115942,15.8620689655172,0.363479991232582
2010,The University of Melbourne,UMa10BASF,85,1000,124,876,4.80769230769231,10.4285714285714,0.135693918645467
2010,The University of Melbourne,UMa10BASF,86,1000,103,897,5.43478260869565,11.0740740740741,0.250825891863674
2010,The University of Melbourne,UMa10BASF,87,1000,84,916,5.74712643678161,10.1777777777778,0.316962532925694
2010,The University of Melbourne,UMa10BASF,88,1000,42,958,10.4166666666667,17.7407407407407,0.415007034076674
2010,The University of Melbourne,UMa10BASF,89,1000,1,999,55.5555555555556,58.764705882353,1
2010,The University of Melbourne,UMa10BASF,90,1000,0,1000,55.5555555555556,55.5555555555556,1
2010,The University of Melbourne,UMa10BASF,91,1000,167,833,3.33333333333333,6.26315789473684,0.0254041099173807
2010,The University of Melbourne,UMa10BASF,92,1000,0,1000,83.3333333333333,83.3333333333333,1
2010,The University of Melbourne,UMa10BASF,93,1000,2,998,52.6315789473684,58.7058823529412,0.997218716105563
2010,The University of Melbourne,UMa10BASF,94,1000,0,1000,90.9090909090909,90.9090909090909,1
2010,The University of Melbourne,UMa10BASF,95,1000,297,703,2.5062656641604,6.8921568627451,0.0104822997114529
2010,The University of Melbourne,UMa10BASF,96,1000,0,1000,166.666666666667,166.666666666667,1
2010,The University of Melbourne,UMa10BASF,97,1000,11,989,22.2222222222222,29.0882352941177,0.857584358215757
2010,The University of Melbourne,UMa10BASF,98,1000,1,999,71.4285714285714,76.8461538461538,0.9
2010,The University of Melbourne,UMa10BASF,99,1000,0,1000,166.666666666667,166.666666666667,1
2010,The University of Melbourne,UMa10BASF,100,1000,126,874,4.95049504950495,11.5,0.436221066638678
2010,The University of Melbourne,UMa10BSF,51,1000,1,999,71.4285714285714,76.8461538461538,1
2010,The University of Melbourne,UMa10BSF,52,1000,0,1000,1000,1000,1
2010,The University of Melbourne,UMa10BSF,53,1000,18,982,17.2413793103448,24.55,0.939357772238671
2010,The University of Melbourne,UMa10BSF,54,1000,5,995,31.25,36.8518518518519,0.834384446671328
2010,The University of Melbourne,UMa10BSF,55,1000,0,1000,1000,1000,1
2010,The University of Melbourne,UMa10BSF,56,1000,187,813,3.18471337579618,6.40157480314961,0.226382714649448
2010,The University of Melbourne,UMa10BSF,57,1000,0,1000,100,100,1
2010,The University of Melbourne,UMa10BSF,58,1000,0,1000,1000,1000,1
2010,The University of Melbourne,UMa10BSF,59,1000,3,997,47.6190476190476,55.3888888888889,1
2010,The University of Melbourne,UMa10BSF,60,1000,0,1000,1000,1000,1
2010,The University of Melbourne,UMa10BSF,61,1000,0,1000,1000,1000,1
2010,The University of Melbourne,UMa10BSF,62,1000,42,958,8.62068965517242,12.9459459459459,0.803265169661279
2010,The University of Melbourne,UMa10BSF,63,1000,0,1000,1000,1000,1
2010,The University of Melbourne,UMa10BSF,64,1000,0,1000,1000,1000,1
2010,The University of Melbourne,UMa10BSF,65,1000,0,1000,333.333333333333,333.333333333333,1
2010,The University of Melbourne,UMa10BSF,66,1000,17,983,19.2307692307692,28.0857142857143,0.840741193524889
2010,The University of Melbourne,UMa10BSF,67,1000,2,998,30.3030303030303,32.1935483870968,0.8612579511
2010,The University of Melbourne,UMa10BSF,68,1000,0,1000,1000,1000,1
2010,The University of Melbourne,UMa10BSF,69,1000,1,999,45.4545454545455,47.5714285714286,0.999999453124351
2010,The University of Melbourne,UMa10BSF,70,1000,0,1000,1000,1000,1
2010,The University of Melbourne,UMa10BSF,71,1000,0,1000,100,100,1
2010,The University of Melbourne,UMa10BSF,72,1000,0,1000,1000,1000,1
2010,The University of Melbourne,UMa10BSF,73,1000,0,1000,250,250,1
2010,The University of Melbourne,UMa10BSF,74,1000,0,1000,1000,1000,1
2010,The University of Melbourne,UMa10BSF,75,1000,0,1000,1000,1000,1
2010,The University of Melbourne,UMa10BSF,76,1000,0,1000,166.666666666667,166.666666666667,1
2010,The University of Melbourne,UMa10BSF,77,1000,0,1000,1000,1000,1
2010,The University of Melbourne,UMa10BSF,78,1000,0,1000,1000,1000,1
2010,The University of Melbourne,UMa10BSF,79,1000,0,1000,1000,1000,1
2010,The University of Melbourne,UMa10BSF,80,1000,0,1000,166.666666666667,166.666666666667,1
2010,The University of Melbourne,UMa10BSF,81,1000,0,1000,1000,1000,1
2010,The University of Melbourne,UMa10BSF,82,1000,0,1000,1000,1000,1
2010,The University of Melbourne,UMa10BSF,83,1000,0,1000,1000,1000,1
2010,The University of Melbourne,UMa10BSF,84,1000,1,999,55.5555555555556,58.764705882353,0.9
2010,The University of Melbourne,UMa10BSF,85,1000,41,959,8.47457627118644,12.4545454545455,0.946724529544299
2010,The University of Melbourne,UMa10BSF,86,1000,3,997,23.2558139534884,24.925,0.814942334540943
2010,The University of Melbourne,UMa10BSF,87,1000,5,995,18.1818181818182,19.9,0.933496128760654
2010,The University of Melbourne,UMa10BSF,88,1000,7,993,31.25,39.72,0.898356650621915
2010,The University of Melbourne,UMa10BSF,89,1000,0,1000,1000,1000,1
2010,The University of Melbourne,UMa10BSF,90,1000,0,1000,500,500,1
2010,The University of Melbourne,UMa10BSF,91,1000,32,968,7.75193798449612,9.97938144329897,0.82063589992396
2010,The University of Melbourne,UMa10BSF,92,1000,0,1000,1000,1000,1
2010,The University of Melbourne,UMa10BSF,93,1000,0,1000,1000,1000,1
2010,The University of Melbourne,UMa10BSF,94,1000,0,1000,1000,1000,1
2010,The University of Melbourne,UMa10BSF,95,1000,17,983,14.2857142857143,18.5471698113208,0.768016518372058
2010,The University of Melbourne,UMa10BSF,96,1000,0,1000,1000,1000,1
2010,The University of Melbourne,UMa10BSF,97,1000,0,1000,1000,1000,1
2010,The University of Melbourne,UMa10BSF,98,1000,0,1000,1000,1000,1
2010,The University of Melbourne,UMa10BSF,99,1000,0,1000,1000,1000,1
2010,The University of Melbourne,UMa10BSF,100,1000,4,996,31.25,35.5714285714286,1
2010,The University of Melbourne,UMa10IASF,51,1000,21,979,17.5438596491228,27.1944444444444,0.552653228844923
2010,The University of Melbourne,UMa10IASF,52,1000,1,999,58.8235294117647,62.4375,0.9717570463519
2010,The University of Melbourne,UMa10IASF,53,1000,141,859,4.36681222707424,9.76136363636364,0.155544843916252
2010,The University of Melbourne,UMa10IASF,54,1000,90,910,7.93650793650794,25.2777777777778,0.085353410159484
2010,The University of Melbourne,UMa10IASF,55,1000,0,1000,166.666666666667,166.666666666667,1
2010,The University of Melbourne,UMa10IASF,56,1000,141,859,4.18410041841004,8.76530612244898,0.238639398316968
2010,The University of Melbourne,UMa10IASF,57,1000,28,972,21.2765957446809,51.1578947368421,0.216914310242067
2010,The University of Melbourne,UMa10IASF,58,1000,0,1000,166.666666666667,166.666666666667,1
2010,The University of Melbourne,UMa10IASF,59,1000,109,891,5.15463917525773,10.4823529411765,0.204723943909502
2010,The University of Melbourne,UMa10IASF,60,1000,1,999,62.5,66.6,0.999996356461058
2010,The University of Melbourne,UMa10IASF,61,1000,0,1000,166.666666666667,166.666666666667,1
2010,The University of Melbourne,UMa10IASF,62,1000,143,857,4.58715596330275,11.4266666666667,0.154020168717415
2010,The University of Melbourne,UMa10IASF,63,1000,0,1000,58.8235294117647,58.8235294117647,1
2010,The University of Melbourne,UMa10IASF,64,1000,1,999,62.5,66.6,0.999999981222019
2010,The University of Melbourne,UMa10IASF,65,1000,53,947,10.1010101010101,20.5869565217391,0.45994602517689
2010,The University of Melbourne,UMa10IASF,66,1000,305,695,2.54452926208651,7.89772727272727,0.0012955212208074
2010,The University of Melbourne,UMa10IASF,67,1000,9,991,29.4117647058824,39.64,0.547098702557349
2010,The University of Melbourne,UMa10IASF,68,1000,2,998,66.6666666666667,76.7692307692308,0.999994446671327
2010,The University of Melbourne,UMa10IASF,69,1000,61,939,8.92857142857143,18.4117647058824,0.418181669010356
2010,The University of Melbourne,UMa10IASF,70,1000,7,993,58.8235294117647,99.3,0.569601101402754
2010,The University of Melbourne,UMa10IASF,71,1000,59,941,9.25925925925926,19.2040816326531,0.117197313509821
2010,The University of Melbourne,UMa10IASF,72,1000,7,993,52.6315789473684,82.75,0.807721299123859
2010,The University of Melbourne,UMa10IASF,73,1000,36,964,13.1578947368421,24.1,0.62157516899672
2010,The University of Melbourne,UMa10IASF,74,1000,0,1000,55.5555555555556,55.5555555555556,1
2010,The University of Melbourne,UMa10IASF,75,1000,0,1000,111.111111111111,111.111111111111,1
2010,The University of Melbourne,UMa10IASF,76,1000,46,954,11.1111111111111,21.6818181818182,0.604481154478031
2010,The University of Melbourne,UMa10IASF,77,1000,1,999,55.5555555555556,58.764705882353,0.999999996868362
2010,The University of Melbourne,UMa10IASF,78,1000,0,1000,200,200,1
2010,The University of Melbourne,UMa10IASF,79,1000,1,999,55.5555555555556,58.764705882353,0.999958890168329
2010,The University of Melbourne,UMa10IASF,80,1000,82,918,6.25,11.7692307692308,0.272075862240933
2010,The University of Melbourne,UMa10IASF,81,1000,0,1000,166.666666666667,166.666666666667,1
2010,The University of Melbourne,UMa10IASF,82,1000,0,1000,125,125,1
2010,The University of Melbourne,UMa10IASF,83,1000,0,1000,166.666666666667,166.666666666667,1
2010,The University of Melbourne,UMa10IASF,84,1000,68,932,8.40336134453782,18.2745098039216,0.371899560214362
2010,The University of Melbourne,UMa10IASF,85,1000,78,922,6.99300699300699,14.1846153846154,0.267482353421688
2010,The University of Melbourne,UMa10IASF,86,1000,78,922,6.57894736842105,12.4594594594595,0.261518452549004
2010,The University of Melbourne,UMa10IASF,87,1000,40,960,10.4166666666667,17.1428571428571,0.346227444072158
2010,The University of Melbourne,UMa10IASF,88,1000,30,970,15.625,28.5294117647059,0.442668169956772
2010,The University of Melbourne,UMa10IASF,89,1000,0,1000,62.5,62.5,1
2010,The University of Melbourne,UMa10IASF,90,1000,0,1000,66.6666666666667,66.6666666666667,1
2010,The University of Melbourne,UMa10IASF,91,1000,93,907,6.41025641025641,14.3968253968254,0.0417245222751465
2010,The University of Melbourne,UMa10IASF,92,1000,0,1000,83.3333333333333,83.3333333333333,1
2010,The University of Melbourne,UMa10IASF,93,1000,1,999,55.5555555555556,58.764705882353,0.997218716105563
2010,The University of Melbourne,UMa10IASF,94,1000,0,1000,90.9090909090909,90.9090909090909,1
2010,The University of Melbourne,UMa10IASF,95,1000,155,845,4.13223140495868,9.71264367816092,0.0326908744921672
2010,The University of Melbourne,UMa10IASF,96,1000,0,1000,166.666666666667,166.666666666667,1
2010,The University of Melbourne,UMa10IASF,97,1000,11,989,22.2222222222222,29.0882352941177,0.854378744473221
2010,The University of Melbourne,UMa10IASF,98,1000,1,999,71.4285714285714,76.8461538461538,0.9
2010,The University of Melbourne,UMa10IASF,99,1000,0,1000,166.666666666667,166.666666666667,1
2010,The University of Melbourne,UMa10IASF,100,1000,99,901,6.06060606060606,13.6515151515152,0.51810552738632
2010,N/A,blv79y00prob,51,1000,1,999,11.7647058823529,11.8928571428571,0.9
2010,N/A,blv79y00prob,52,1000,0,1000,31.25,31.25,1
2010,N/A,blv79y00prob,53,1000,875,125,1.06951871657754,2.08333333333333,0.0118993617625895
2010,N/A,blv79y00prob,54,1000,688,312,1.21951219512195,2.36363636363636,0.0121908987832235
2010,N/A,blv79y00prob,55,1000,572,428,1.32978723404255,2.37777777777778,0.257799700090244
2010,N/A,blv79y00prob,56,325,272,53,1.12847222222222,3.3125,0.109647623881414
2010,N/A,blv79y00prob,57,1000,813,187,1.11234705228031,2.17441860465116,0.0265330858796643
2010,N/A,blv79y00prob,58,1000,94,906,2.89855072463768,3.60956175298805,0.346942088436709
2010,N/A,blv79y00prob,59,1000,544,456,1.33689839572193,2.23529411764706,0.0644059799028451
2010,N/A,blv79y00prob,60,1000,6,994,7.8740157480315,8.21487603305785,0.854452239168507
2010,N/A,blv79y00prob,61,1000,116,884,2.80898876404494,3.68333333333333,0.498822029811686
2010,N/A,blv79y00prob,62,1000,891,109,1.07642626480086,2.86842105263158,0.57180756826222
2010,N/A,blv79y00prob,63,1000,209,791,2.06611570247934,2.87636363636364,0.399042815720644
2010,N/A,blv79y00prob,64,1000,4,996,11.1111111111111,11.5813953488372,0.721441
2010,N/A,blv79y00prob,65,1000,530,470,1.37931034482759,2.41025641025641,0.153697582373403
2010,N/A,blv79y00prob,66,1000,923,77,1.04058272632674,2.02631578947368,0.155523122610369
2010,N/A,blv79y00prob,67,1000,407,593,2.11864406779661,9.12307692307692,0.791972518202836
2010,N/A,blv79y00prob,68,1000,4,996,8.26446280991735,8.51282051282051,0.7056479511
2010,N/A,blv79y00prob,69,1000,433,567,1.49253731343284,2.39240506329114,0.195517284615515
2010,N/A,blv79y00prob,70,1000,950,50,1.02669404517454,2.08333333333333,0.138510681730176
2010,N/A,blv79y00prob,71,1000,834,166,1.09529025191676,2.10126582278481,0.00587458011936572
2010,N/A,blv79y00prob,72,1000,837,163,1.10253583241455,2.32857142857143,2.37988652442641e-07
2010,N/A,blv79y00prob,73,1000,385,615,1.59744408945687,2.55186721991701,0.18697299699206
2010,N/A,blv79y00prob,74,1000,11,989,7.19424460431655,7.7265625,0.524111568733885
2010,N/A,blv79y00prob,75,1000,6,994,8.84955752212389,9.28971962616822,0.759387358462451
2010,N/A,blv79y00prob,76,1000,909,91,1.0482180293501,2.02222222222222,0.00346731582017221
2010,N/A,blv79y00prob,77,1000,0,1000,19.2307692307692,19.2307692307692,1
2010,N/A,blv79y00prob,78,1000,520,480,1.36425648021828,2.25352112676056,0.0544095882006242
2010,N/A,blv79y00prob,79,1000,13,987,6.99300699300699,7.59230769230769,0.586399366551664
2010,N/A,blv79y00prob,80,1000,656,344,1.22699386503067,2.16352201257862,0.0432907728578349
2010,N/A,blv79y00prob,81,1000,525,475,1.40056022408964,2.51322751322751,0.0192298273977543
2010,N/A,blv79y00prob,82,1000,742,258,1.16279069767442,2.1864406779661,0.010812755468287
2010,N/A,blv79y00prob,83,1000,248,752,1.91204588910134,2.73454545454545,0.231771873816467
2010,N/A,blv79y00prob,84,1000,557,443,1.35869565217391,2.47486033519553,0.475948772161462
2010,N/A,blv79y00prob,85,1000,633,367,1.25944584382872,2.27950310559006,0.416305456619166
2010,N/A,blv79y00prob,86,1000,716,284,1.24069478908189,3.15555555555556,0.422011108452713
2010,N/A,blv79y00prob,87,1000,887,113,1.06609808102345,2.2156862745098,0.00170986622904549
2010,N/A,blv79y00prob,88,1000,808,192,1.11482720178372,2.15730337078652,0.575900506293861
2010,N/A,blv79y00prob,89,1000,0,1000,34.4827586206897,34.4827586206897,1
2010,N/A,blv79y00prob,90,1000,61,939,4.95049504950495,6.65957446808511,1
2010,N/A,blv79y00prob,91,1000,950,50,1.02774922918808,2.17391304347826,5.35687851445165e-05
2010,N/A,blv79y00prob,92,1000,907,93,1.0515247108307,2.11363636363636,0.00228697650407396
2010,N/A,blv79y00prob,93,1000,4,996,9.80392156862745,10.1632653061224,0.69413215599
2010,N/A,blv79y00prob,94,1000,80,920,3.15457413249211,3.88185654008439,0.876381407674643
2010,N/A,blv79y00prob,95,1000,876,124,1.07296137339056,2.21428571428571,0.00934394795763815
2010,N/A,blv79y00prob,96,1000,416,584,1.54559505409583,2.52813852813853,0.0151431036968879
2010,N/A,blv79y00prob,97,1000,417,583,1.50375939849624,2.3508064516129,0.0692212196313429
2010,N/A,blv79y00prob,98,1000,871,129,1.07066381156317,2.04761904761905,0.0229235532871178
2010,N/A,blv79y00prob,99,1000,586,414,1.30890052356021,2.32584269662921,0.0131195882627115
2010,N/A,blv79y00prob,100,1000,155,845,2.40384615384615,3.23754789272031,0.609111660347012
2010,N/A,blv79y00shnk,51,1000,964,36,1.0183299389002,2,0.0191796172921741
2010,N/A,blv79y00shnk,52,1000,936,64,1.03412616339193,2.06451612903226,0.253809838598106
2010,N/A,blv79y00shnk,53,1000,978,22,1.01214574898785,2.2,2.80257938250235e-10
2010,N/A,blv79y00shnk,54,1000,960,40,1.02040816326531,2,0.0148557804218219
2010,N/A,blv79y00shnk,55,1000,885,115,1.06609808102345,2.16981132075472,0.310645321482909
2010,N/A,blv79y00shnk,56,325,303,22,1.03503184713376,2,0.029862059322677
2010,N/A,blv79y00shnk,57,1000,984,16,1.00806451612903,2,5.35579174906636e-09
2010,N/A,blv79y00shnk,58,1000,952,48,1.02459016393443,2,0.134182858545111
2010,N/A,blv79y00shnk,59,1000,974,26,1.01317122593718,2,1.17237025252809e-05
2010,N/A,blv79y00shnk,60,1000,943,57,1.03092783505155,2.11111111111111,0.00105069351097064
2010,N/A,blv79y00shnk,61,1000,895,105,1.05820105820106,2.1,4.14596697716108e-05
2010,N/A,blv79y00shnk,62,1000,958,42,1.02459016393443,2.33333333333333,0.00920902557990363
2010,N/A,blv79y00shnk,63,1000,952,48,1.02564102564103,2.08695652173913,0.00805432007229853
2010,N/A,blv79y00shnk,64,1000,901,99,1.05596620908131,2.15217391304348,0.0746360907222103
2010,N/A,blv79y00shnk,65,1000,954,46,1.02459016393443,2.09090909090909,0.0421448431318131
2010,N/A,blv79y00shnk,66,1000,976,24,1.01214574898785,2,0.000343891455881327
2010,N/A,blv79y00shnk,67,1000,928,72,1.04058272632674,2.18181818181818,0.327647471841347
2010,N/A,blv79y00shnk,68,1000,966,34,1.0183299389002,2.125,0.0203689602701524
2010,N/A,blv79y00shnk,69,1000,940,60,1.0351966873706,2.30769230769231,0.0122760557398744
2010,N/A,blv79y00shnk,70,1000,964,36,1.01936799184506,2.11764705882353,0.138515046666057
2010,N/A,blv79y00shnk,71,1000,974,26,1.01317122593718,2,6.13871198973583e-14
2010,N/A,blv79y00shnk,72,1000,912,88,1.05263157894737,2.31578947368421,9.42268457486009e-08
2010,N/A,blv79y00shnk,73,1000,944,56,1.02986611740474,2.07407407407407,3.93424599147783e-05
2010,N/A,blv79y00shnk,74,1000,953,47,1.02669404517454,2.23809523809524,0.265054559836007
2010,N/A,blv79y00shnk,75,1000,927,73,1.04058272632674,2.14705882352941,0.077622220244884
2010,N/A,blv79y00shnk,76,1000,976,24,1.01317122593718,2.18181818181818,1.40362102992589e-07
2010,N/A,blv79y00shnk,77,1000,945,55,1.02986611740474,2.11538461538462,0.147548300485299
2010,N/A,blv79y00shnk,78,1000,990,10,1.00502512562814,2,9.47661926092638e-13
2010,N/A,blv79y00shnk,79,1000,926,74,1.04058272632674,2.11428571428571,0.000331195304936209
2010,N/A,blv79y00shnk,80,1000,994,6,1.00300902708124,2,1.72572954881858e-21
2010,N/A,blv79y00shnk,81,1000,909,91,1.05485232067511,2.33333333333333,0.00200724339082892
2010,N/A,blv79y00shnk,82,1000,906,94,1.05263157894737,2.13636363636364,0.108355127300802
2010,N/A,blv79y00shnk,83,1000,881,119,1.07066381156317,2.24528301886792,0.0358988522344725
2010,N/A,blv79y00shnk,84,1000,935,65,1.0351966873706,2.09677419354839,0.0740449341885737
2010,N/A,blv79y00shnk,85,1000,962,38,1.01936799184506,2,0.00134323359780803
2010,N/A,blv79y00shnk,86,1000,967,33,1.0183299389002,2.2,0.154144798606563
2010,N/A,blv79y00shnk,87,1000,965,35,1.0183299389002,2.05882352941176,0.0204400636181089
2010,N/A,blv79y00shnk,88,1000,956,44,1.02354145342886,2.0952380952381,2.72349625035854e-05
2010,N/A,blv79y00shnk,89,1000,947,53,1.02774922918808,2.03846153846154,0.00224479232827495
2010,N/A,blv79y00shnk,90,1000,962,38,1.02145045965271,2.23529411764706,0.0723722590728907
2010,N/A,blv79y00shnk,91,1000,972,28,1.01522842639594,2.15384615384615,2.57984276710939e-06
2010,N/A,blv79y00shnk,92,1000,946,54,1.02986611740474,2.16,0.00908090150811506
2010,N/A,blv79y00shnk,93,1000,965,35,1.01936799184506,2.1875,0.101024643519394
2010,N/A,blv79y00shnk,94,1000,937,63,1.0351966873706,2.17241379310345,0.0912464065832219
2010,N/A,blv79y00shnk,95,1000,932,68,1.05596620908131,4.53333333333333,8.58225099031101e-06
2010,N/A,blv79y00shnk,96,1000,935,65,1.03412616339193,2.03125,4.10148060284598e-05
2010,N/A,blv79y00shnk,97,1000,975,25,1.01317122593718,2.08333333333333,1.6804957251811e-09
2010,N/A,blv79y00shnk,98,1000,962,38,1.01936799184506,2,0.0208166268859889
2010,N/A,blv79y00shnk,99,1000,908,92,1.05596620908131,2.35897435897436,0.00732847231430187
2010,N/A,blv79y00shnk,100,1000,992,8,1.00401606425703,2,3.78582415053287e-14
2010,Carnegie Mellon University,cmuBase10,51,1000,959,41,1.02145045965271,2.05,1.73321724293706e-05
2010,Carnegie Mellon University,cmuBase10,52,1000,938,62,1.03842159916926,2.48,0.00312040901269841
2010,Carnegie Mellon University,cmuBase10,53,1000,956,44,1.02249488752556,2,0.00834480038804042
2010,Carnegie Mellon University,cmuBase10,54,1000,936,64,1.03842159916926,2.37037037037037,6.83287502199508e-05
2010,Carnegie Mellon University,cmuBase10,55,1000,781,219,1.17370892018779,3.08450704225352,3.74146221867332e-05
2010,Carnegie Mellon University,cmuBase10,56,1000,901,99,1.05374077976818,2.0625,0.0122763462883404
2010,Carnegie Mellon University,cmuBase10,57,1000,922,78,1.04712041884817,2.36363636363636,5.95622717802597e-09
2010,Carnegie Mellon University,cmuBase10,58,1000,942,58,1.02986611740474,2,1.92505483097187e-12
2010,Carnegie Mellon University,cmuBase10,59,1000,972,28,1.01419878296146,2,2.68200588098779e-06
2010,Carnegie Mellon University,cmuBase10,60,1000,954,46,1.02564102564103,2.19047619047619,0.00057164332055338
2010,Carnegie Mellon University,cmuBase10,61,1000,943,57,1.02986611740474,2.03571428571429,0.104516527301305
2010,Carnegie Mellon University,cmuBase10,62,1000,976,24,1.01214574898785,2,0.00475599897365971
2010,Carnegie Mellon University,cmuBase10,63,1000,942,58,1.03412616339193,2.32,6.94545291369984e-14
2010,Carnegie Mellon University,cmuBase10,64,1000,901,99,1.05820105820106,2.25,0.0219702755972851
2010,Carnegie Mellon University,cmuBase10,65,1000,950,50,1.02774922918808,2.17391304347826,0.000174003188847046
2010,Carnegie Mellon University,cmuBase10,66,1000,960,40,1.02145045965271,2.10526315789474,2.32792694193083e-05
2010,Carnegie Mellon University,cmuBase10,67,1000,918,82,1.04275286757039,2,0.0153161533334917
2010,Carnegie Mellon University,cmuBase10,68,1000,966,34,1.01729399796541,2,3.56781632783389e-08
2010,Carnegie Mellon University,cmuBase10,69,1000,914,86,1.05042016806723,2.26315789473684,0.0254027734317863
2010,Carnegie Mellon University,cmuBase10,70,1000,951,49,1.02564102564103,2.04166666666667,0.00278424915337472
2010,Carnegie Mellon University,cmuBase10,71,1000,949,51,1.02880658436214,2.21739130434783,2.13693211207972e-14
2010,Carnegie Mellon University,cmuBase10,72,1000,929,71,1.03842159916926,2.08823529411765,0.00948961397149885
2010,Carnegie Mellon University,cmuBase10,73,1000,954,46,1.02354145342886,2,0.000146975359713131
2010,Carnegie Mellon University,cmuBase10,74,1000,919,81,1.04602510460251,2.18918918918919,0.00200289414763791
2010,Carnegie Mellon University,cmuBase10,75,1000,918,82,1.04384133611691,2.05,0.00998446450253871
2010,Carnegie Mellon University,cmuBase10,76,1000,970,30,1.01626016260163,2.14285714285714,3.73614447857004e-05
2010,Carnegie Mellon University,cmuBase10,77,1000,950,50,1.02564102564103,2,0.000112000656805455
2010,Carnegie Mellon University,cmuBase10,78,1000,970,30,1.01522842639594,2,0.00724888806616001
2010,Carnegie Mellon University,cmuBase10,79,1000,912,88,1.05263157894737,2.31578947368421,8.59912548227658e-06
2010,Carnegie Mellon University,cmuBase10,80,1000,963,37,1.02040816326531,2.17647058823529,0.00409165449180109
2010,Carnegie Mellon University,cmuBase10,81,1000,945,55,1.02986611740474,2.11538461538462,8.04342677503981e-18
2010,Carnegie Mellon University,cmuBase10,82,1000,966,34,1.01936799184506,2.26666666666667,3.33986888353929e-09
2010,Carnegie Mellon University,cmuBase10,83,1000,85,915,4.739336492891,7.26190476190476,0.392432061376842
2010,Carnegie Mellon University,cmuBase10,84,1000,907,93,1.05263157894737,2.16279069767442,0.0455488570806119
2010,Carnegie Mellon University,cmuBase10,85,1000,963,37,1.01936799184506,2.05555555555556,1.21119503620513e-06
2010,Carnegie Mellon University,cmuBase10,86,1000,952,48,1.02669404517454,2.18181818181818,7.91092004860028e-06
2010,Carnegie Mellon University,cmuBase10,87,1000,959,41,1.02145045965271,2.05,0.00475599837733663
2010,Carnegie Mellon University,cmuBase10,88,1000,974,26,1.01419878296146,2.16666666666667,0.000582305816501187
2010,Carnegie Mellon University,cmuBase10,89,1000,937,63,1.04275286757039,2.86363636363636,1.87201495299429e-09
2010,Carnegie Mellon University,cmuBase10,90,1000,808,192,1.12994350282486,2.49350649350649,0.198604536078488
2010,Carnegie Mellon University,cmuBase10,91,1000,952,48,1.02774922918808,2.28571428571429,2.7382496206124e-12
2010,Carnegie Mellon University,cmuBase10,92,1000,931,69,1.03734439834025,2.09090909090909,9.92330404128111e-10
2010,Carnegie Mellon University,cmuBase10,93,1000,967,33,1.01729399796541,2.0625,8.04109527840762e-11
2010,Carnegie Mellon University,cmuBase10,94,1000,949,51,1.02669404517454,2.04,2.83518546384604e-06
2010,Carnegie Mellon University,cmuBase10,95,1000,941,59,1.03305785123967,2.18518518518519,0.00109338542014914
2010,Carnegie Mellon University,cmuBase10,96,1000,986,14,1.00704934541793,2,9.19017644964256e-15
2010,Carnegie Mellon University,cmuBase10,97,1000,946,54,1.02986611740474,2.16,2.10860858306198e-08
2010,Carnegie Mellon University,cmuBase10,98,1000,917,83,1.04931794333683,2.30555555555556,1.53974819973364e-06
2010,Carnegie Mellon University,cmuBase10,99,1000,896,104,1.06269925611052,2.31111111111111,0.172633937135765
2010,Carnegie Mellon University,cmuBase10,100,1000,972,28,1.01419878296146,2,0.0285179807077299
2010,Carnegie Mellon University,cmuFuTop10,51,1000,975,25,1.01317122593718,2.08333333333333,2.41382080286152e-06
2010,Carnegie Mellon University,cmuFuTop10,52,1000,797,203,1.17647058823529,3.83018867924528,3.17882268423779e-09
2010,Carnegie Mellon University,cmuFuTop10,53,1000,936,64,1.03305785123967,2,0.079255188363874
2010,Carnegie Mellon University,cmuFuTop10,54,1000,921,79,1.04712041884817,2.32352941176471,0.00587293399865386
2010,Carnegie Mellon University,cmuFuTop10,55,1000,959,41,1.02145045965271,2.05,3.82329458799141e-05
2010,Carnegie Mellon University,cmuFuTop10,56,1000,873,127,1.06951871657754,2.04838709677419,0.00385237452630713
2010,Carnegie Mellon University,cmuFuTop10,57,1000,959,41,1.02459016393443,2.41176470588235,5.21477250434545e-15
2010,Carnegie Mellon University,cmuFuTop10,58,1000,978,22,1.01112234580384,2,7.89900944577229e-18
2010,Carnegie Mellon University,cmuFuTop10,59,1000,978,22,1.01112234580384,2,1.32005096523364e-11
2010,Carnegie Mellon University,cmuFuTop10,60,1000,968,32,1.01626016260163,2,1.06434164125042e-05
2010,Carnegie Mellon University,cmuFuTop10,61,1000,956,44,1.02249488752556,2,1.29727945249064e-08
2010,Carnegie Mellon University,cmuFuTop10,62,1000,974,26,1.01317122593718,2,0.0908764299608427
2010,Carnegie Mellon University,cmuFuTop10,63,1000,928,72,1.04275286757039,2.32258064516129,0.00305753262533892
2010,Carnegie Mellon University,cmuFuTop10,64,1000,935,65,1.03626943005181,2.16666666666667,0.0202779399964664
2010,Carnegie Mellon University,cmuFuTop10,65,1000,932,68,1.03734439834025,2.125,5.10835840668414e-05
2010,Carnegie Mellon University,cmuFuTop10,66,1000,937,63,1.03305785123967,2.03225806451613,6.65904626024869e-05
2010,Carnegie Mellon University,cmuFuTop10,67,1000,932,68,1.03842159916926,2.19354838709677,0.1551838868523
2010,Carnegie Mellon University,cmuFuTop10,68,1000,964,36,1.0183299389002,2,2.34805402744043e-15
2010,Carnegie Mellon University,cmuFuTop10,69,1000,968,32,1.0183299389002,2.28571428571429,7.85373340718487e-06
2010,Carnegie Mellon University,cmuFuTop10,70,1000,984,16,1.00806451612903,2,0.001492481770143
2010,Carnegie Mellon University,cmuFuTop10,71,1000,959,41,1.02249488752556,2.15789473684211,4.70251345099333e-05
2010,Carnegie Mellon University,cmuFuTop10,72,1000,922,78,1.04384133611691,2.16666666666667,0.00813242875246549
2010,Carnegie Mellon University,cmuFuTop10,73,1000,976,24,1.01214574898785,2,3.61725042056632e-06
2010,Carnegie Mellon University,cmuFuTop10,74,1000,918,82,1.0482180293501,2.27777777777778,0.00227894293436048
2010,Carnegie Mellon University,cmuFuTop10,75,1000,921,79,1.04166666666667,2.02564102564103,0.053975641900836
2010,Carnegie Mellon University,cmuFuTop10,76,1000,968,32,1.01626016260163,2,0.00018145094067801
2010,Carnegie Mellon University,cmuFuTop10,77,1000,962,38,1.01936799184506,2,0.00230201271555585
2010,Carnegie Mellon University,cmuFuTop10,78,1000,956,44,1.02249488752556,2,4.6739409594862e-11
2010,Carnegie Mellon University,cmuFuTop10,79,1000,916,84,1.05042016806723,2.33333333333333,2.63697318651293e-05
2010,Carnegie Mellon University,cmuFuTop10,80,1000,957,43,1.02354145342886,2.15,0.000143764586611173
2010,Carnegie Mellon University,cmuFuTop10,81,1000,962,38,1.01936799184506,2,2.86993282471391e-10
2010,Carnegie Mellon University,cmuFuTop10,82,1000,954,46,1.02459016393443,2.09090909090909,3.67910730785867e-06
2010,Carnegie Mellon University,cmuFuTop10,83,1000,127,873,4.0983606557377,7.46153846153846,0.175499843073172
2010,Carnegie Mellon University,cmuFuTop10,84,1000,949,51,1.02774922918808,2.125,0.0845387577069784
2010,Carnegie Mellon University,cmuFuTop10,85,1000,972,28,1.01419878296146,2,0.000107147271140589
2010,Carnegie Mellon University,cmuFuTop10,86,1000,971,29,1.01522842639594,2.07142857142857,0.00032575485083364
2010,Carnegie Mellon University,cmuFuTop10,87,1000,943,57,1.02986611740474,2.03571428571429,0.100973816697628
2010,Carnegie Mellon University,cmuFuTop10,88,1000,962,38,1.01936799184506,2,0.00428039591359968
2010,Carnegie Mellon University,cmuFuTop10,89,1000,948,52,1.03734439834025,3.25,1.88590469683169e-18
2010,Carnegie Mellon University,cmuFuTop10,90,1000,807,193,1.13250283125708,2.53947368421053,0.0796702146268931
2010,Carnegie Mellon University,cmuFuTop10,91,1000,960,40,1.02040816326531,2,0.053661611931392
2010,Carnegie Mellon University,cmuFuTop10,92,1000,921,79,1.04275286757039,2.07894736842105,1.15611504690032e-06
2010,Carnegie Mellon University,cmuFuTop10,93,1000,975,25,1.01317122593718,2.08333333333333,1.06924127563445e-11
2010,Carnegie Mellon University,cmuFuTop10,94,1000,932,68,1.04712041884817,2.95652173913043,8.00060178068293e-11
2010,Carnegie Mellon University,cmuFuTop10,95,1000,922,78,1.04493207941484,2.22857142857143,5.70680326497315e-05
2010,Carnegie Mellon University,cmuFuTop10,96,1000,972,28,1.01419878296146,2,5.0515906408242e-13
2010,Carnegie Mellon University,cmuFuTop10,97,1000,968,32,1.01729399796541,2.13333333333333,2.30552888696604e-09
2010,Carnegie Mellon University,cmuFuTop10,98,1000,954,46,1.02459016393443,2.09090909090909,9.06891040255905e-09
2010,Carnegie Mellon University,cmuFuTop10,99,1000,866,134,1.08813928182807,2.52830188679245,0.150018319842544
2010,Carnegie Mellon University,cmuFuTop10,100,1000,974,26,1.01317122593718,2,0.0434659056646583
2010,Carnegie Mellon University,cmuWiki10,51,1000,974,26,1.01317122593718,2,0.0207896133692414
2010,Carnegie Mellon University,cmuWiki10,52,1000,886,114,1.085776330076,3.25714285714286,0.000189998874673241
2010,Carnegie Mellon University,cmuWiki10,53,1000,936,64,1.03305785123967,2,0.0435906603621308
2010,Carnegie Mellon University,cmuWiki10,54,1000,932,68,1.03626943005181,2.06060606060606,8.4518620784512e-07
2010,Carnegie Mellon University,cmuWiki10,55,1000,953,47,1.02459016393443,2.04347826086957,0.0589275275439394
2010,Carnegie Mellon University,cmuWiki10,56,1000,862,138,1.07642626480086,2.05970149253731,0.0151556628067915
2010,Carnegie Mellon University,cmuWiki10,57,1000,922,78,1.04712041884817,2.36363636363636,5.95622717802597e-09
2010,Carnegie Mellon University,cmuWiki10,58,1000,955,45,1.02354145342886,2.04545454545455,1.57473686042701e-07
2010,Carnegie Mellon University,cmuWiki10,59,1000,952,48,1.02459016393443,2,2.60311507264856e-08
2010,Carnegie Mellon University,cmuWiki10,60,1000,966,34,1.01729399796541,2,0.000793171968410037
2010,Carnegie Mellon University,cmuWiki10,61,1000,949,51,1.02774922918808,2.125,4.96982179252869e-07
2010,Carnegie Mellon University,cmuWiki10,62,1000,966,34,1.01729399796541,2,0.124659192541298
2010,Carnegie Mellon University,cmuWiki10,63,1000,930,70,1.04712041884817,2.8,1.54358439938783e-11
2010,Carnegie Mellon University,cmuWiki10,64,1000,937,63,1.0351966873706,2.17241379310345,0.0346607049844353
2010,Carnegie Mellon University,cmuWiki10,65,1000,931,69,1.03842159916926,2.15625,0.00994360625277081
2010,Carnegie Mellon University,cmuWiki10,66,1000,933,67,1.0351966873706,2.03030303030303,3.87551181860454e-05
2010,Carnegie Mellon University,cmuWiki10,67,1000,875,125,1.07066381156317,2.11864406779661,0.398901509340096
2010,Carnegie Mellon University,cmuWiki10,68,1000,969,31,1.01626016260163,2.06666666666667,0.0285749221622344
2010,Carnegie Mellon University,cmuWiki10,69,1000,952,48,1.02669404517454,2.18181818181818,0.000201876381400046
2010,Carnegie Mellon University,cmuWiki10,70,1000,951,49,1.02564102564103,2.04166666666667,0.00278424915337472
2010,Carnegie Mellon University,cmuWiki10,71,1000,913,87,1.04712041884817,2.07142857142857,0.0947764133770256
2010,Carnegie Mellon University,cmuWiki10,72,1000,911,89,1.04931794333683,2.11904761904762,0.0323489683812708
2010,Carnegie Mellon University,cmuWiki10,73,1000,945,55,1.02986611740474,2.11538461538462,7.02978122195064e-05
2010,Carnegie Mellon University,cmuWiki10,74,1000,953,47,1.02564102564103,2.13636363636364,0.0916961947225618
2010,Carnegie Mellon University,cmuWiki10,75,1000,941,59,1.03092783505155,2.03448275862069,0.000820484267069263
2010,Carnegie Mellon University,cmuWiki10,76,1000,972,28,1.01522842639594,2.15384615384615,0.000224013506977035
2010,Carnegie Mellon University,cmuWiki10,77,1000,963,37,1.01936799184506,2.05555555555556,0.0207896079349881
2010,Carnegie Mellon University,cmuWiki10,78,1000,951,49,1.02564102564103,2.04166666666667,0.000642465114674167
2010,Carnegie Mellon University,cmuWiki10,79,1000,936,64,1.03842159916926,2.37037037037037,4.40747142100597e-08
2010,Carnegie Mellon University,cmuWiki10,80,1000,955,45,1.02459016393443,2.14285714285714,3.55446548607929e-05
2010,Carnegie Mellon University,cmuWiki10,81,1000,951,49,1.02564102564103,2.04166666666667,0.0285882785303109
2010,Carnegie Mellon University,cmuWiki10,82,1000,920,80,1.05263157894737,2.66666666666667,0.00111031185585785
2010,Carnegie Mellon University,cmuWiki10,83,1000,383,617,1.70648464163823,3.03940886699507,0.136271328577085
2010,Carnegie Mellon University,cmuWiki10,84,1000,948,52,1.02774922918808,2.08,0.0142087461082923
2010,Carnegie Mellon University,cmuWiki10,85,1000,966,34,1.01729399796541,2,0.017927602630197
2010,Carnegie Mellon University,cmuWiki10,86,1000,974,26,1.01317122593718,2,0.000168915869611136
2010,Carnegie Mellon University,cmuWiki10,87,1000,743,257,1.17096018735363,2.31531531531532,0.126328051018401
2010,Carnegie Mellon University,cmuWiki10,88,1000,860,140,1.08225108225108,2.1875,2.84108278971964e-05
2010,Carnegie Mellon University,cmuWiki10,89,1000,960,40,1.02145045965271,2.10526315789474,5.60740644316993e-06
2010,Carnegie Mellon University,cmuWiki10,90,1000,784,216,1.14942528735632,2.51162790697674,0.129567232976487
2010,Carnegie Mellon University,cmuWiki10,91,1000,923,77,1.04493207941484,2.26470588235294,0.190001780565508
2010,Carnegie Mellon University,cmuWiki10,92,1000,941,59,1.03092783505155,2.03448275862069,5.88941158785439e-06
2010,Carnegie Mellon University,cmuWiki10,93,1000,966,34,1.01729399796541,2,2.54991881503573e-13
2010,Carnegie Mellon University,cmuWiki10,94,1000,966,34,1.01729399796541,2,0.100973790724074
2010,Carnegie Mellon University,cmuWiki10,95,1000,941,59,1.03305785123967,2.18518518518519,0.00109338542014914
2010,Carnegie Mellon University,cmuWiki10,96,1000,972,28,1.01419878296146,2,6.31639291419379e-12
2010,Carnegie Mellon University,cmuWiki10,97,1000,951,49,1.02669404517454,2.1304347826087,4.41677582007271e-08
2010,Carnegie Mellon University,cmuWiki10,98,1000,956,44,1.02249488752556,2,6.33605971365838e-05
2010,Carnegie Mellon University,cmuWiki10,99,1000,744,256,1.20192307692308,2.90909090909091,0.131974126692978
2010,Carnegie Mellon University,cmuWiki10,100,1000,978,22,1.01112234580384,2,0.0434659056644259
2010,Mugla University,irra10b,51,1000,816,184,1.11234705228031,2.21686746987952,0.0732064746146221
2010,Mugla University,irra10b,52,1000,738,262,1.18063754427391,2.40366972477064,0.0975041871124766
2010,Mugla University,irra10b,53,1000,677,323,1.26582278481013,2.85840707964602,0.24074510069992
2010,Mugla University,irra10b,54,1000,610,390,1.32802124833997,2.72727272727273,0.184204728883011
2010,Mugla University,irra10b,55,1000,724,276,1.20192307692308,2.55555555555556,0.411523723315176
2010,Mugla University,irra10b,56,1000,693,307,1.2531328320802,2.92380952380952,0.104571870380055
2010,Mugla University,irra10b,57,1000,791,209,1.13507377979569,2.32222222222222,0.00929272412052482
2010,Mugla University,irra10b,58,1000,743,257,1.17647058823529,2.4018691588785,0.581655106089474
2010,Mugla University,irra10b,59,1000,839,161,1.09529025191676,2.17567567567568,0.00226023016806461
2010,Mugla University,irra10b,60,1000,661,339,1.22850122850123,2.2156862745098,0.154357132912584
2010,Mugla University,irra10b,61,1000,629,371,1.28700128700129,2.50675675675676,0.291464104614364
2010,Mugla University,irra10b,62,1000,825,175,1.11482720178372,2.43055555555556,0.605495955976351
2010,Mugla University,irra10b,63,1000,742,258,1.17924528301887,2.43396226415094,0.570483000840389
2010,Mugla University,irra10b,64,1000,733,267,1.18764845605701,2.44954128440367,0.21972995636802
2010,Mugla University,irra10b,65,1000,733,267,1.18203309692671,2.36283185840708,0.602915036493134
2010,Mugla University,irra10b,66,1000,815,185,1.13507377979569,2.8030303030303,0.073594634401055
2010,Mugla University,irra10b,67,1000,751,249,1.18906064209275,2.76666666666667,0.383088801993255
2010,Mugla University,irra10b,68,1000,825,175,1.10497237569061,2.1875,0.0266312365609467
2010,Mugla University,irra10b,69,1000,865,135,1.08108108108108,2.25,0.026199205980277
2010,Mugla University,irra10b,70,1000,960,40,1.02040816326531,2,0.0763834599662561
2010,Mugla University,irra10b,71,1000,775,225,1.16009280742459,2.58620689655172,0.000148584583142719
2010,Mugla University,irra10b,72,1000,701,299,1.24069478908189,2.84761904761905,0.806914247907578
2010,Mugla University,irra10b,73,1000,698,302,1.21802679658953,2.45528455284553,0.188506370417493
2010,Mugla University,irra10b,74,1000,756,244,1.15606936416185,2.23853211009174,0.331210801284996
2010,Mugla University,irra10b,75,1000,711,289,1.20481927710843,2.42857142857143,0.520831396093232
2010,Mugla University,irra10b,76,1000,857,143,1.09649122807018,2.6,0.00898877554534736
2010,Mugla University,irra10b,77,1000,785,215,1.13250283125708,2.19387755102041,0.579820698729331
2010,Mugla University,irra10b,78,1000,815,185,1.11607142857143,2.28395061728395,0.708803392791984
2010,Mugla University,irra10b,79,1000,724,276,1.18764845605701,2.33898305084746,0.277299258983426
2010,Mugla University,irra10b,80,1000,871,129,1.09170305676856,2.86666666666667,0.0316866880988193
2010,Mugla University,irra10b,81,1000,677,323,1.27388535031847,2.99074074074074,0.125259537564572
2010,Mugla University,irra10b,82,1000,767,233,1.16822429906542,2.61797752808989,0.304125317630078
2010,Mugla University,irra10b,83,1000,659,341,1.2987012987013,3.07207207207207,0.696515672537146
2010,Mugla University,irra10b,84,1000,771,229,1.16550116550117,2.63218390804598,0.564557518795513
2010,Mugla University,irra10b,85,1000,760,240,1.16822429906542,2.5,0.266408783292516
2010,Mugla University,irra10b,86,1000,865,135,1.08225108225108,2.28813559322034,0.174994919134029
2010,Mugla University,irra10b,87,1000,810,190,1.13378684807256,2.63888888888889,0.0187189533767062
2010,Mugla University,irra10b,88,1000,830,170,1.11856823266219,2.65625,0.0980916966973656
2010,Mugla University,irra10b,89,1000,824,176,1.1037527593819,2.14634146341463,0.171992753467928
2010,Mugla University,irra10b,90,1000,675,325,1.23456790123457,2.40740740740741,0.406460160666014
2010,Mugla University,irra10b,91,1000,737,263,1.20481927710843,2.82795698924731,0.125910058252975
2010,Mugla University,irra10b,92,1000,802,198,1.13507377979569,2.50632911392405,0.369740937111638
2010,Mugla University,irra10b,93,1000,771,229,1.14155251141553,2.18095238095238,0.272720170967432
2010,Mugla University,irra10b,94,1000,688,312,1.21951219512195,2.36363636363636,0.43251572002688
2010,Mugla University,irra10b,95,1000,920,80,1.04712041884817,2.28571428571429,0.000422366421280489
2010,Mugla University,irra10b,96,1000,740,260,1.18063754427391,2.42990654205607,0.421278410742632
2010,Mugla University,irra10b,97,1000,840,160,1.11234705228031,2.71186440677966,0.323738711676835
2010,Mugla University,irra10b,98,1000,804,196,1.13636363636364,2.57894736842105,0.197689292417971
2010,Mugla University,irra10b,99,1000,722,278,1.21951219512195,2.83673469387755,0.640860009706165
2010,Mugla University,irra10b,100,1000,826,174,1.12359550561798,2.71875,0.334351730119372
2010,Mugla University,irra10hp,51,1000,827,173,1.10987791342952,2.33783783783784,0.0627419240218494
2010,Mugla University,irra10hp,52,1000,785,215,1.13507377979569,2.23958333333333,0.041558565077474
2010,Mugla University,irra10hp,53,1000,748,252,1.194743130227,2.8314606741573,0.0723418113420748
2010,Mugla University,irra10hp,54,1000,816,184,1.11856823266219,2.35897435897436,0.000177744825839988
2010,Mugla University,irra10hp,55,1000,737,263,1.19617224880383,2.65656565656566,0.047792151780717
2010,Mugla University,irra10hp,56,1000,746,254,1.20048019207683,2.91954022988506,0.0684670072736268
2010,Mugla University,irra10hp,57,1000,855,145,1.09529025191676,2.5,0.00139956986062505
2010,Mugla University,irra10hp,58,1000,803,197,1.12612612612613,2.31764705882353,0.168213754870396
2010,Mugla University,irra10hp,59,1000,863,137,1.08108108108108,2.20967741935484,0.0317390529163973
2010,Mugla University,irra10hp,60,1000,798,202,1.11731843575419,2.08247422680412,2.13740673696972e-05
2010,Mugla University,irra10hp,61,1000,721,279,1.20336943441637,2.53636363636364,0.0144725547760555
2010,Mugla University,irra10hp,62,1000,840,160,1.10497237569061,2.46153846153846,0.312960948131648
2010,Mugla University,irra10hp,63,1000,816,184,1.12359550561798,2.48648648648649,0.0434613218974194
2010,Mugla University,irra10hp,64,1000,774,226,1.15340253748558,2.43010752688172,0.0833412432625091
2010,Mugla University,irra10hp,65,1000,794,206,1.12866817155756,2.23913043478261,0.170591084789174
2010,Mugla University,irra10hp,66,1000,907,93,1.06269925611052,2.73529411764706,0.0464555324785058
2010,Mugla University,irra10hp,67,1000,793,207,1.15606936416185,2.875,0.186555379467666
2010,Mugla University,irra10hp,68,1000,835,165,1.09769484083425,2.17105263157895,0.00013814338315398
2010,Mugla University,irra10hp,69,1000,803,197,1.16822429906542,3.71698113207547,0.124714658958008
2010,Mugla University,irra10hp,70,1000,947,53,1.02774922918808,2.03846153846154,0.190019952717511
2010,Mugla University,irra10hp,71,1000,895,105,1.06382978723404,2.33333333333333,0.000227326021503064
2010,Mugla University,irra10hp,72,1000,736,264,1.21506682867558,3.03448275862069,0.00382222874295038
2010,Mugla University,irra10hp,73,1000,819,181,1.11856823266219,2.41333333333333,0.103021317156504
2010,Mugla University,irra10hp,74,1000,807,193,1.11856823266219,2.2183908045977,0.179658987379572
2010,Mugla University,irra10hp,75,1000,745,255,1.16959064327485,2.31818181818182,0.374373204697375
2010,Mugla University,irra10hp,76,1000,893,107,1.06044538706257,2.14,0.00773659659102254
2010,Mugla University,irra10hp,77,1000,838,162,1.09529025191676,2.16,0.355482095513134
2010,Mugla University,irra10hp,78,1000,947,53,1.03092783505155,2.30434782608696,1.65490415104457e-10
2010,Mugla University,irra10hp,79,1000,785,215,1.1454753722795,2.44318181818182,0.0379913516818745
2010,Mugla University,irra10hp,80,1000,981,19,1.01010101010101,2.11111111111111,2.2700892998181e-10
2010,Mugla University,irra10hp,81,1000,777,223,1.17370892018779,2.97333333333333,0.168972027788592
2010,Mugla University,irra10hp,82,1000,824,176,1.11731843575419,2.47887323943662,0.00147597716732039
2010,Mugla University,irra10hp,83,1000,875,125,1.08459869848156,2.65957446808511,0.0839818092731314
2010,Mugla University,irra10hp,84,1000,813,187,1.12612612612613,2.49333333333333,0.328640251706719
2010,Mugla University,irra10hp,85,1000,839,161,1.10132158590308,2.33333333333333,0.292282923428148
2010,Mugla University,irra10hp,86,1000,900,100,1.05932203389831,2.27272727272727,0.174927915600537
2010,Mugla University,irra10hp,87,1000,921,79,1.04384133611691,2.13513513513514,2.27055297702443e-11
2010,Mugla University,irra10hp,88,1000,855,145,1.09170305676856,2.37704918032787,0.183980867112826
2010,Mugla University,irra10hp,89,1000,853,147,1.08342361863489,2.1,0.0853334369045577
2010,Mugla University,irra10hp,90,1000,753,247,1.16414435389988,2.33018867924528,0.11669352806097
2010,Mugla University,irra10hp,91,1000,907,93,1.05596620908131,2.325,0.000647200886310051
2010,Mugla University,irra10hp,92,1000,849,151,1.09649122807018,2.3968253968254,0.0525829741882188
2010,Mugla University,irra10hp,93,1000,776,224,1.13765642775882,2.1747572815534,0.226238911786026
2010,Mugla University,irra10hp,94,1000,833,167,1.10132158590308,2.22666666666667,0.165207530174698
2010,Mugla University,irra10hp,95,1000,855,145,1.13507377979569,5.57692307692308,0.00897910943021693
2010,Mugla University,irra10hp,96,1000,802,198,1.12994350282486,2.3855421686747,0.335197304152081
2010,Mugla University,irra10hp,97,1000,935,65,1.0351966873706,2.09677419354839,0.0357200023083214
2010,Mugla University,irra10hp,98,1000,714,286,1.20627261761158,2.48695652173913,0.0144796700111916
2010,Mugla University,irra10hp,99,1000,853,147,1.10987791342952,3.0625,0.00268003394511678
2010,Mugla University,irra10hp,100,1000,921,79,1.04384133611691,2.13513513513514,0.215015925549309
2010,Mugla University,irra10rob,51,1000,832,168,1.10253583241455,2.24,0.0861137276440893
2010,Mugla University,irra10rob,52,1000,783,217,1.14285714285714,2.35869565217391,0.105364076251118
2010,Mugla University,irra10rob,53,1000,701,299,1.23915737298637,2.82075471698113,0.177905650333138
2010,Mugla University,irra10rob,54,1000,755,245,1.16550116550117,2.37864077669903,0.00150772413531661
2010,Mugla University,irra10rob,55,1000,764,236,1.16686114352392,2.53763440860215,0.434065071953953
2010,Mugla University,irra10rob,56,1000,723,277,1.21802679658953,2.8265306122449,0.109058285007435
2010,Mugla University,irra10rob,57,1000,826,174,1.11234705228031,2.38356164383562,0.00909356521508856
2010,Mugla University,irra10rob,58,1000,766,234,1.15207373271889,2.29411764705882,0.508567426182381
2010,Mugla University,irra10rob,59,1000,855,145,1.08459869848156,2.16417910447761,0.00266341729627239
2010,Mugla University,irra10rob,60,1000,675,325,1.21506682867558,2.19594594594595,0.105118442790367
2010,Mugla University,irra10rob,61,1000,617,383,1.29198966408269,2.43949044585987,0.290857139647421
2010,Mugla University,irra10rob,62,1000,849,151,1.0989010989011,2.47540983606557,0.483391837298557
2010,Mugla University,irra10rob,63,1000,741,259,1.18203309692671,2.46666666666667,0.309112658759108
2010,Mugla University,irra10rob,64,1000,723,277,1.19617224880383,2.45132743362832,0.216912369907496
2010,Mugla University,irra10rob,65,1000,759,241,1.15207373271889,2.21100917431193,0.374345655641383
2010,Mugla University,irra10rob,66,1000,849,151,1.10741971207087,2.7962962962963,0.250593152064786
2010,Mugla University,irra10rob,67,1000,786,214,1.16279069767442,2.89189189189189,0.256853017031915
2010,Mugla University,irra10rob,68,1000,819,181,1.10987791342952,2.20731707317073,0.0304401681846799
2010,Mugla University,irra10rob,69,1000,867,133,1.07991360691145,2.25423728813559,0.0089516941235334
2010,Mugla University,irra10rob,70,1000,943,57,1.02986611740474,2.03571428571429,0.171051328018069
2010,Mugla University,irra10rob,71,1000,857,143,1.08695652173913,2.26984126984127,0.00135254891288431
2010,Mugla University,irra10rob,72,1000,548,452,1.50829562594268,3.9304347826087,0.185819271461519
2010,Mugla University,irra10rob,73,1000,774,226,1.15473441108545,2.45652173913043,0.0581175745743943
2010,Mugla University,irra10rob,74,1000,775,225,1.14285714285714,2.25,0.316469330397688
2010,Mugla University,irra10rob,75,1000,738,262,1.17508813160987,2.31858407079646,0.515742409023713
2010,Mugla University,irra10rob,76,1000,871,129,1.08813928182807,2.6875,0.0210518710214249
2010,Mugla University,irra10rob,77,1000,801,199,1.12233445566779,2.21111111111111,0.489969936637108
2010,Mugla University,irra10rob,78,1000,837,163,1.0989010989011,2.23287671232877,0.29224127847558
2010,Mugla University,irra10rob,79,1000,755,245,1.15606936416185,2.22727272727273,0.271268049316229
2010,Mugla University,irra10rob,80,1000,966,34,1.0183299389002,2.125,0.00134323359338963
2010,Mugla University,irra10rob,81,1000,691,309,1.25786163522013,2.97115384615385,0.0616955047578429
2010,Mugla University,irra10rob,82,1000,783,217,1.14942528735632,2.49425287356322,0.435562279184777
2010,Mugla University,irra10rob,83,1000,759,241,1.16009280742459,2.33980582524272,0.705600248969428
2010,Mugla University,irra10rob,84,1000,788,212,1.14942528735632,2.58536585365854,0.41372856444895
2010,Mugla University,irra10rob,85,1000,819,181,1.11482720178372,2.32051282051282,0.311941182895716
2010,Mugla University,irra10rob,86,1000,884,116,1.06951871657754,2.27450980392157,0.174941692855005
2010,Mugla University,irra10rob,87,1000,899,101,1.06157112526539,2.34883720930233,0.00209971792923933
2010,Mugla University,irra10rob,88,1000,870,130,1.08225108225108,2.40740740740741,0.113811482021217
2010,Mugla University,irra10rob,89,1000,845,155,1.08932461873638,2.12328767123288,0.118482054813832
2010,Mugla University,irra10rob,90,1000,788,212,1.13895216400911,2.35555555555556,0.406798213939269
2010,Mugla University,irra10rob,91,1000,864,136,1.085776330076,2.3859649122807,0.000345329308620399
2010,Mugla University,irra10rob,92,1000,796,204,1.13895216400911,2.48780487804878,0.184026090483831
2010,Mugla University,irra10rob,93,1000,774,226,1.14025085518814,2.19417475728155,0.306687043243726
2010,Mugla University,irra10rob,94,1000,728,272,1.17647058823529,2.22950819672131,0.422068355266584
2010,Mugla University,irra10rob,95,1000,912,88,1.06723585912487,3.52,1.18511747439882e-05
2010,Mugla University,irra10rob,96,1000,738,262,1.18063754427391,2.40366972477064,0.407417689431685
2010,Mugla University,irra10rob,97,1000,872,128,1.08108108108108,2.41509433962264,0.125001133237789
2010,Mugla University,irra10rob,98,1000,806,194,1.12233445566779,2.28235294117647,0.271793856216845
2010,Mugla University,irra10rob,99,1000,737,263,1.20336943441637,2.79787234042553,0.661488599858725
2010,Mugla University,irra10rob,100,1000,881,119,1.08108108108108,2.70454545454545,0.34619997678031
2010,Microsoft Research,msrsv1,51,1000,994,6,1.00300902708124,2,4.99744339088457e-41
2010,Microsoft Research,msrsv1,52,1000,979,21,1.01214574898785,2.33333333333333,0.00385237017870888
2010,Microsoft Research,msrsv1,53,1000,992,8,1.00401606425703,2,4.14262466374255e-12
2010,Microsoft Research,msrsv1,54,1000,962,38,1.02145045965271,2.23529411764706,7.33735130681138e-19
2010,Microsoft Research,msrsv1,55,1000,986,14,1.00704934541793,2,9.64952915961121e-12
2010,Microsoft Research,msrsv1,56,1000,967,33,1.01729399796541,2.0625,0.000918735753842156
2010,Microsoft Research,msrsv1,57,1000,992,8,1.00401606425703,2,0.0230995643793657
2010,Microsoft Research,msrsv1,58,1000,984,16,1.00806451612903,2,3.06657703435951e-11
2010,Microsoft Research,msrsv1,59,1000,967,33,1.01936799184506,2.35714285714286,1.5429517687769e-08
2010,Microsoft Research,msrsv1,60,1000,990,10,1.00502512562814,2,7.00083266723962e-19
2010,Microsoft Research,msrsv1,61,1000,990,10,1.00502512562814,2,2.51193455786126e-24
2010,Microsoft Research,msrsv1,62,1000,994,6,1.00300902708124,2,0.000341431956983742
2010,Microsoft Research,msrsv1,63,1000,994,6,1.00300902708124,2,0.066248903619
2010,Microsoft Research,msrsv1,64,1000,990,10,1.00502512562814,2,2.10675987162407e-08
2010,Microsoft Research,msrsv1,65,1000,998,2,1.001001001001,2,2.67647718527035e-13
2010,Microsoft Research,msrsv1,66,1000,996,4,1.00200400801603,2,4.25398322920574e-24
2010,Microsoft Research,msrsv1,67,1000,941,59,1.03734439834025,2.56521739130435,0.0739894104855101
2010,Microsoft Research,msrsv1,68,1000,979,21,1.01112234580384,2.1,8.27115876580038e-15
2010,Microsoft Research,msrsv1,69,1000,990,10,1.00502512562814,2,0.00994360502751986
2010,Microsoft Research,msrsv1,70,1000,992,8,1.00401606425703,2,1.17236938768654e-05
2010,Microsoft Research,msrsv1,71,1000,998,2,1.001001001001,2,7.07982263992173e-32
2010,Microsoft Research,msrsv1,72,1000,998,2,1.001001001001,2,1.88049993192334e-36
2010,Microsoft Research,msrsv1,73,1000,993,7,1.00401606425703,2.33333333333333,1.02323972930665e-07
2010,Microsoft Research,msrsv1,74,1000,996,4,1.00200400801603,2,0.0058715993327002
2010,Microsoft Research,msrsv1,75,1000,977,23,1.01214574898785,2.09090909090909,7.40719475714752e-11
2010,Microsoft Research,msrsv1,76,1000,986,14,1.00704934541793,2,1.69532702821064e-12
2010,Microsoft Research,msrsv1,77,1000,994,6,1.00300902708124,2,0.0230995797304876
2010,Microsoft Research,msrsv1,78,1000,1000,0,1,,0
2010,Microsoft Research,msrsv1,79,1000,992,8,1.00401606425703,2,4.31985306506827e-23
2010,Microsoft Research,msrsv1,80,1000,1000,0,1,,0
2010,Microsoft Research,msrsv1,81,1000,994,6,1.00300902708124,2,3.82140171530941e-31
2010,Microsoft Research,msrsv1,82,1000,998,2,1.001001001001,2,5.56131906627835e-34
2010,Microsoft Research,msrsv1,83,1000,992,8,1.00401606425703,2,1.17579844386077e-19
2010,Microsoft Research,msrsv1,84,1000,856,144,1.12866817155756,4.8,0.241049530479378
2010,Microsoft Research,msrsv1,85,1000,990,10,1.00502512562814,2,1.06703744497188e-18
2010,Microsoft Research,msrsv1,86,1000,973,27,1.01522842639594,2.25,0.0530447617918211
2010,Microsoft Research,msrsv1,87,1000,998,2,1.001001001001,2,2.47368005993644e-25
2010,Microsoft Research,msrsv1,88,1000,973,27,1.01626016260163,2.45454545454545,7.86177407510832e-14
2010,Microsoft Research,msrsv1,89,1000,986,14,1.00704934541793,2,2.30244337016584e-16
2010,Microsoft Research,msrsv1,90,1000,986,14,1.00704934541793,2,2.63209413715536e-10
2010,Microsoft Research,msrsv1,91,1000,989,11,1.00603621730382,2.2,4.14370123521123e-12
2010,Microsoft Research,msrsv1,92,1000,994,6,1.00300902708124,2,9.20915756463751e-08
2010,Microsoft Research,msrsv1,93,1000,986,14,1.00704934541793,2,0.00111007940877096
2010,Microsoft Research,msrsv1,94,1000,998,2,1.001001001001,2,1.3472245934686e-44
2010,Microsoft Research,msrsv1,95,1000,994,6,1.00300902708124,2,8.50710533749091e-07
2010,Microsoft Research,msrsv1,96,1000,986,14,1.00704934541793,2,4.21567360909162e-07
2010,Microsoft Research,msrsv1,97,1000,1000,0,1,,0
2010,Microsoft Research,msrsv1,98,1000,996,4,1.00200400801603,2,2.17950055839223e-10
2010,Microsoft Research,msrsv1,99,1000,1000,0,1,,0
2010,Microsoft Research,msrsv1,100,1000,986,14,1.00908173562059,2.8,1.24402063133262e-08
2010,Microsoft Research,msrsv2,51,1000,994,6,1.00300902708124,2,4.99744339088457e-41
2010,Microsoft Research,msrsv2,52,1000,975,25,1.01419878296146,2.27272727272727,0.0571287450994212
2010,Microsoft Research,msrsv2,53,1000,992,8,1.00401606425703,2,5.68261270746577e-12
2010,Microsoft Research,msrsv2,54,1000,962,38,1.02145045965271,2.23529411764706,8.19403385845656e-19
2010,Microsoft Research,msrsv2,55,1000,986,14,1.00704934541793,2,9.64952915961121e-12
2010,Microsoft Research,msrsv2,56,1000,967,33,1.01729399796541,2.0625,0.000918735753842156
2010,Microsoft Research,msrsv2,57,1000,992,8,1.00401606425703,2,0.0256661826437397
2010,Microsoft Research,msrsv2,58,1000,984,16,1.00806451612903,2,1.06925227858714e-11
2010,Microsoft Research,msrsv2,59,1000,967,33,1.01936799184506,2.35714285714286,1.5429517687769e-08
2010,Microsoft Research,msrsv2,60,1000,990,10,1.00502512562814,2,7.00083266723962e-19
2010,Microsoft Research,msrsv2,61,1000,990,10,1.00502512562814,2,2.51193455786125e-24
2010,Microsoft Research,msrsv2,62,1000,994,6,1.00300902708124,2,0.000341431956983742
2010,Microsoft Research,msrsv2,63,1000,994,6,1.00300902708124,2,0.124659
2010,Microsoft Research,msrsv2,64,1000,990,10,1.00502512562814,2,2.10675987371464e-08
2010,Microsoft Research,msrsv2,65,1000,998,2,1.001001001001,2,2.40882946674332e-13
2010,Microsoft Research,msrsv2,66,1000,996,4,1.00200400801603,2,4.25398322920574e-24
2010,Microsoft Research,msrsv2,67,1000,941,59,1.03734439834025,2.56521739130435,0.0739894104855101
2010,Microsoft Research,msrsv2,68,1000,979,21,1.01112234580384,2.1,9.19017640644487e-15
2010,Microsoft Research,msrsv2,69,1000,990,10,1.00502512562814,2,0.0151556241846058
2010,Microsoft Research,msrsv2,70,1000,992,8,1.00401606425703,2,1.17236938768654e-05
2010,Microsoft Research,msrsv2,71,1000,998,2,1.001001001001,2,7.07982263992173e-32
2010,Microsoft Research,msrsv2,72,1000,998,2,1.001001001001,2,1.88049993192334e-36
2010,Microsoft Research,msrsv2,73,1000,991,9,1.00502512562814,2.25,8.62116700331117e-06
2010,Microsoft Research,msrsv2,74,1000,995,5,1.00300902708124,2.5,0.00837475483769345
2010,Microsoft Research,msrsv2,75,1000,975,25,1.01317122593718,2.08333333333333,8.23021639683091e-11
2010,Microsoft Research,msrsv2,76,1000,986,14,1.00704934541793,2,1.88369669801182e-12
2010,Microsoft Research,msrsv2,77,1000,994,6,1.00300902708124,2,0.100973808960839
2010,Microsoft Research,msrsv2,78,1000,1000,0,1,,0
2010,Microsoft Research,msrsv2,79,1000,992,8,1.00401606425703,2,9.03173962672195e-23
2010,Microsoft Research,msrsv2,80,1000,1000,0,1,,0
2010,Microsoft Research,msrsv2,81,1000,994,6,1.00300902708124,2,2.25649949887306e-31
2010,Microsoft Research,msrsv2,82,1000,996,4,1.00200400801603,2,0.124659
2010,Microsoft Research,msrsv2,83,1000,992,8,1.00401606425703,2,1.45160301711206e-19
2010,Microsoft Research,msrsv2,84,1000,856,144,1.12866817155756,4.8,0.241058684560108
2010,Microsoft Research,msrsv2,85,1000,990,10,1.00502512562814,2,1.06703744497188e-18
2010,Microsoft Research,msrsv2,86,1000,973,27,1.01522842639594,2.25,0.0530447617918211
2010,Microsoft Research,msrsv2,87,1000,998,2,1.001001001001,2,2.47368005993644e-25
2010,Microsoft Research,msrsv2,88,1000,973,27,1.01626016260163,2.45454545454545,7.86177407510832e-14
2010,Microsoft Research,msrsv2,89,1000,986,14,1.00704934541793,2,2.84279693213899e-16
2010,Microsoft Research,msrsv2,90,1000,986,14,1.00704934541793,2,2.63209413715536e-10
2010,Microsoft Research,msrsv2,91,1000,989,11,1.00603621730382,2.2,4.14370123521123e-12
2010,Microsoft Research,msrsv2,92,1000,994,6,1.00300902708124,2,1.02323972940417e-07
2010,Microsoft Research,msrsv2,93,1000,986,14,1.00704934541793,2,0.00111007940877096
2010,Microsoft Research,msrsv2,94,1000,998,2,1.001001001001,2,1.21250213412174e-44
2010,Microsoft Research,msrsv2,95,1000,994,6,1.00300902708124,2,8.50710533749091e-07
2010,Microsoft Research,msrsv2,96,1000,986,14,1.00704934541793,2,3.79401743446106e-07
2010,Microsoft Research,msrsv2,97,1000,1000,0,1,,0
2010,Microsoft Research,msrsv2,98,1000,996,4,1.00200400801603,2,5.5399979922012e-11
2010,Microsoft Research,msrsv2,99,1000,998,2,1.001001001001,2,9.92311008756486e-10
2010,Microsoft Research,msrsv2,100,1000,986,14,1.00908173562059,2.8,1.11961856819936e-08
2010,Microsoft Research,msrsv3,51,1000,994,6,1.00300902708124,2,2.39026168178558e-41
2010,Microsoft Research,msrsv3,52,1000,979,21,1.01214574898785,2.33333333333333,0.00280837512098693
2010,Microsoft Research,msrsv3,53,1000,877,123,1.09289617486339,3.23684210526316,1.42238978128359e-13
2010,Microsoft Research,msrsv3,54,1000,960,40,1.02249488752556,2.22222222222222,1.56041559153683e-21
2010,Microsoft Research,msrsv3,55,1000,986,14,1.00704934541793,2,9.64952915960658e-12
2010,Microsoft Research,msrsv3,56,1000,939,61,1.0351966873706,2.25925925925926,0.00557253680725296
2010,Microsoft Research,msrsv3,57,1000,992,8,1.00401606425703,2,0.0136400617689077
2010,Microsoft Research,msrsv3,58,1000,984,16,1.00806451612903,2,3.06657266351576e-11
2010,Microsoft Research,msrsv3,59,1000,955,45,1.02564102564103,2.25,1.57999481877821e-07
2010,Microsoft Research,msrsv3,60,1000,990,10,1.00502512562814,2,5.10360701441769e-19
2010,Microsoft Research,msrsv3,61,1000,990,10,1.00502512562814,2,9.73174914608116e-25
2010,Microsoft Research,msrsv3,62,1000,994,6,1.00300902708124,2,0.000107144965946361
2010,Microsoft Research,msrsv3,63,1000,994,6,1.00300902708124,2,0.066248903619
2010,Microsoft Research,msrsv3,64,1000,990,10,1.00502512562814,2,1.89608388293765e-08
2010,Microsoft Research,msrsv3,65,1000,998,2,1.001001001001,2,2.40882946674332e-13
2010,Microsoft Research,msrsv3,66,1000,990,10,1.00502512562814,2,0.00134323359312909
2010,Microsoft Research,msrsv3,67,1000,941,59,1.03734439834025,2.56521739130435,0.0739894104855101
2010,Microsoft Research,msrsv3,68,1000,979,21,1.01112234580384,2.1,8.27115876580038e-15
2010,Microsoft Research,msrsv3,69,1000,990,10,1.00502512562814,2,0.00652399925855578
2010,Microsoft Research,msrsv3,70,1000,998,2,1.001001001001,2,0.0013432335931287
2010,Microsoft Research,msrsv3,71,1000,994,6,1.00300902708124,2,6.59890641714702e-16
2010,Microsoft Research,msrsv3,72,1000,998,2,1.001001001001,2,7.97165702506957e-38
2010,Microsoft Research,msrsv3,73,1000,993,7,1.00401606425703,2.33333333333333,1.02323972930665e-07
2010,Microsoft Research,msrsv3,74,1000,996,4,1.00200400801603,2,0.0058715993327002
2010,Microsoft Research,msrsv3,75,1000,977,23,1.01214574898785,2.09090909090909,6.66647528143237e-11
2010,Microsoft Research,msrsv3,76,1000,986,14,1.00704934541793,2,9.95368333619561e-13
2010,Microsoft Research,msrsv3,77,1000,994,6,1.00300902708124,2,0.020789619131173
2010,Microsoft Research,msrsv3,78,1000,1000,0,1,,0
2010,Microsoft Research,msrsv3,79,1000,992,8,1.00401606425703,2,2.29574703275295e-23
2010,Microsoft Research,msrsv3,80,1000,1000,0,1,,0
2010,Microsoft Research,msrsv3,81,1000,994,6,1.00300902708124,2,2.50722166541451e-31
2010,Microsoft Research,msrsv3,82,1000,998,2,1.001001001001,2,1.41361268950075e-34
2010,Microsoft Research,msrsv3,83,1000,992,8,1.00401606425703,2,7.70899186639385e-20
2010,Microsoft Research,msrsv3,84,1000,867,133,1.11482720178372,4.43333333333333,0.241039446343698
2010,Microsoft Research,msrsv3,85,1000,990,10,1.00502512562814,2,4.52329531741806e-20
2010,Microsoft Research,msrsv3,86,1000,973,27,1.01522842639594,2.25,0.0375458361890275
2010,Microsoft Research,msrsv3,87,1000,990,10,1.00502512562814,2,0.00589365953103691
2010,Microsoft Research,msrsv3,88,1000,973,27,1.01626016260163,2.45454545454545,4.17806907624964e-14
2010,Microsoft Research,msrsv3,89,1000,986,14,1.00704934541793,2,2.30206350242397e-16
2010,Microsoft Research,msrsv3,90,1000,986,14,1.00704934541793,2,1.39880273873614e-10
2010,Microsoft Research,msrsv3,91,1000,992,8,1.00401606425703,2,1.98542870828079e-05
2010,Microsoft Research,msrsv3,92,1000,994,6,1.00300902708124,2,3.96424036312288e-08
2010,Microsoft Research,msrsv3,93,1000,986,14,1.00704934541793,2,0.00111007940877096
2010,Microsoft Research,msrsv3,94,1000,998,2,1.001001001001,2,5.2194241079443e-45
2010,Microsoft Research,msrsv3,95,1000,992,8,1.00401606425703,2,1.22651970586625e-09
2010,Microsoft Research,msrsv3,96,1000,986,14,1.00704934541793,2,3.39929526270746e-07
2010,Microsoft Research,msrsv3,97,1000,1000,0,1,,0
2010,Microsoft Research,msrsv3,98,1000,996,4,1.00200400801603,2,4.98599819298108e-11
2010,Microsoft Research,msrsv3,99,1000,1000,0,1,,0
2010,Microsoft Research,msrsv3,100,1000,986,14,1.00908173562059,2.8,1.11961856819936e-08
2010,Peking University,pkusewm1,51,1000,787,213,1.14155251141553,2.39325842696629,0.19679388442307
2010,Peking University,pkusewm1,52,1000,694,306,1.21802679658953,2.40944881889764,0.224985027153878
2010,Peking University,pkusewm1,53,1000,489,511,1.64744645799012,4.33050847457627,0.176854236093884
2010,Peking University,pkusewm1,54,1000,592,408,1.32978723404255,2.55,0.156863894949825
2010,Peking University,pkusewm1,55,1000,570,430,1.44927536231884,3.58333333333333,0.203449052136314
2010,Peking University,pkusewm1,56,1000,764,236,1.15074798619102,2.24761904761905,0.289627445037026
2010,Peking University,pkusewm1,57,1000,826,174,1.11982082866741,2.59701492537313,0.0192193516079191
2010,Peking University,pkusewm1,58,1000,691,309,1.21359223300971,2.32330827067669,0.0397217754097598
2010,Peking University,pkusewm1,59,1000,861,139,1.08342361863489,2.24193548387097,0.157341763021584
2010,Peking University,pkusewm1,60,1000,671,329,1.23152709359606,2.33333333333333,0.0613791244045928
2010,Peking University,pkusewm1,61,1000,578,422,1.36612021857924,2.74025974025974,0.305274030848589
2010,Peking University,pkusewm1,62,1000,770,230,1.16414435389988,2.58426966292135,0.365853807143252
2010,Peking University,pkusewm1,63,1000,701,299,1.22100122100122,2.53389830508475,0.000797905151607137
2010,Peking University,pkusewm1,64,1000,659,341,1.26262626262626,2.56390977443609,0.0611543300980302
2010,Peking University,pkusewm1,65,1000,668,332,1.26903553299492,2.76666666666667,0.452922132538255
2010,Peking University,pkusewm1,66,1000,794,206,1.1454753722795,2.60759493670886,0.17336909774551
2010,Peking University,pkusewm1,67,1000,719,281,1.23152709359606,3.02150537634409,0.623458101983658
2010,Peking University,pkusewm1,68,1000,744,256,1.16822429906542,2.28571428571429,0.0127347679516497
2010,Peking University,pkusewm1,69,1000,767,233,1.19331742243437,3.28169014084507,0.040365727374879
2010,Peking University,pkusewm1,70,1000,669,331,1.23609394313968,2.36428571428571,0.0161757181901784
2010,Peking University,pkusewm1,71,1000,761,239,1.22249388753056,4.19298245614035,0.114742090341548
2010,Peking University,pkusewm1,72,1000,604,396,1.3351134846462,2.73103448275862,0.198593359181146
2010,Peking University,pkusewm1,73,1000,769,231,1.16009280742459,2.48387096774194,0.31498541794782
2010,Peking University,pkusewm1,74,1000,708,292,1.19617224880383,2.28125,0.315942422871596
2010,Peking University,pkusewm1,75,1000,595,405,1.33333333333333,2.61290322580645,0.181609803871398
2010,Peking University,pkusewm1,76,1000,839,161,1.11482720178372,2.77586206896552,0.00210814965684372
2010,Peking University,pkusewm1,77,1000,660,340,1.26582278481013,2.61538461538462,0.0955733289323563
2010,Peking University,pkusewm1,78,1000,530,470,1.3869625520111,2.46073298429319,0.33603423240807
2010,Peking University,pkusewm1,79,1000,716,284,1.19189511323004,2.30894308943089,0.0747537913633487
2010,Peking University,pkusewm1,80,1000,882,118,1.07642626480086,2.51063829787234,0.000764277811610151
2010,Peking University,pkusewm1,81,1000,585,415,1.36612021857924,2.82312925170068,0.216411153526818
2010,Peking University,pkusewm1,82,1000,738,262,1.18623962040332,2.4952380952381,0.0279976349941821
2010,Peking University,pkusewm1,83,1000,12,988,25.6410256410256,36.5925925925926,0.736078491746046
2010,Peking University,pkusewm1,84,1000,729,271,1.19904076738609,2.58095238095238,0.377987728195826
2010,Peking University,pkusewm1,85,1000,715,285,1.20918984280532,2.54464285714286,0.284402784219596
2010,Peking University,pkusewm1,86,1000,799,201,1.13122171945701,2.36470588235294,0.340170745691338
2010,Peking University,pkusewm1,87,1000,828,172,1.11111111111111,2.38888888888889,0.00823980886361249
2010,Peking University,pkusewm1,88,1000,816,184,1.12233445566779,2.45333333333333,0.0800183895686553
2010,Peking University,pkusewm1,89,1000,747,253,1.16144018583043,2.21929824561404,0.167256267851667
2010,Peking University,pkusewm1,90,1000,661,339,1.2453300124533,2.38732394366197,0.0921534952942348
2010,Peking University,pkusewm1,91,1000,845,155,1.11234705228031,2.87037037037037,0.0532492090971884
2010,Peking University,pkusewm1,92,1000,827,173,1.10619469026549,2.24675324675325,0.0818790090218253
2010,Peking University,pkusewm1,93,1000,674,326,1.23304562268804,2.37956204379562,0.133345322060061
2010,Peking University,pkusewm1,94,1000,712,288,1.19760479041916,2.34146341463415,0.241900561764943
2010,Peking University,pkusewm1,95,1000,844,156,1.11358574610245,2.88888888888889,0.0715489698834024
2010,Peking University,pkusewm1,96,1000,543,457,1.36798905608755,2.43085106382979,0.0705071865603907
2010,Peking University,pkusewm1,97,1000,624,376,1.30718954248366,2.66666666666667,0.0052230583513839
2010,Peking University,pkusewm1,98,1000,293,707,1.91938579654511,3.10087719298246,0.09049853368787
2010,Peking University,pkusewm1,99,1000,613,387,1.31752305665349,2.65068493150685,0.126755965002882
2010,Peking University,pkusewm1,100,1000,786,214,1.15340253748558,2.64197530864198,0.0485730604187724
2010,"Computer and Automation Research Institute, Hungarian Academy of Scien",sztaki1,51,1000,992,8,1.00401606425703,2,0.0971275175958159
2010,"Computer and Automation Research Institute, Hungarian Academy of Scien",sztaki1,52,1000,990,10,1.00502512562814,2,1.34047096849341e-10
2010,"Computer and Automation Research Institute, Hungarian Academy of Scien",sztaki1,53,1000,757,243,1.16822429906542,2.45454545454545,0.964851781611177
2010,"Computer and Automation Research Institute, Hungarian Academy of Scien",sztaki1,54,1000,682,318,1.25944584382872,2.83928571428571,0.999554583526552
2010,"Computer and Automation Research Institute, Hungarian Academy of Scien",sztaki1,55,1000,736,264,1.21359223300971,3,0.999927511821144
2010,"Computer and Automation Research Institute, Hungarian Academy of Scien",sztaki1,56,1000,993,7,1.00401606425703,2.33333333333333,3.49901323099032e-23
2010,"Computer and Automation Research Institute, Hungarian Academy of Scien",sztaki1,57,1000,724,276,1.18203309692671,2.26229508196721,0.776146933120324
2010,"Computer and Automation Research Institute, Hungarian Academy of Scien",sztaki1,58,1000,706,294,1.20918984280532,2.4297520661157,0.795401045346711
2010,"Computer and Automation Research Institute, Hungarian Academy of Scien",sztaki1,59,1000,772,228,1.14678899082569,2.28,0.945010010929597
2010,"Computer and Automation Research Institute, Hungarian Academy of Scien",sztaki1,60,1000,990,10,1.00502512562814,2,1.42534489740096e-06
2010,"Computer and Automation Research Institute, Hungarian Academy of Scien",sztaki1,61,1000,750,250,1.17924528301887,2.55102040816327,0.975832673133637
2010,"Computer and Automation Research Institute, Hungarian Academy of Scien",sztaki1,62,1000,779,221,1.15074798619102,2.45555555555556,0.405324624820048
2010,"Computer and Automation Research Institute, Hungarian Academy of Scien",sztaki1,63,1000,749,251,1.18063754427391,2.56122448979592,0.735235407748671
2010,"Computer and Automation Research Institute, Hungarian Academy of Scien",sztaki1,64,1000,982,18,1.00908173562059,2,4.76862779945723e-11
2010,"Computer and Automation Research Institute, Hungarian Academy of Scien",sztaki1,65,1000,739,261,1.17924528301887,2.39449541284404,0.953415500802752
2010,"Computer and Automation Research Institute, Hungarian Academy of Scien",sztaki1,66,1000,736,264,1.18623962040332,2.46728971962617,0.944876428556005
2010,"Computer and Automation Research Institute, Hungarian Academy of Scien",sztaki1,67,1000,992,8,1.00401606425703,2,0.00502644627833243
2010,"Computer and Automation Research Institute, Hungarian Academy of Scien",sztaki1,68,1000,780,220,1.13378684807256,2.15686274509804,0.0646995870423345
2010,"Computer and Automation Research Institute, Hungarian Academy of Scien",sztaki1,69,1000,792,208,1.13122171945701,2.26086956521739,0.241683144321591
2010,"Computer and Automation Research Institute, Hungarian Academy of Scien",sztaki1,70,1000,678,322,1.26742712294043,2.9009009009009,0.999818059707926
2010,"Computer and Automation Research Institute, Hungarian Academy of Scien",sztaki1,71,1000,688,312,1.24843945068664,2.76106194690265,0.99955426138207
2010,"Computer and Automation Research Institute, Hungarian Academy of Scien",sztaki1,72,1000,704,296,1.23609394313968,2.81904761904762,0.9998162648941
2010,"Computer and Automation Research Institute, Hungarian Academy of Scien",sztaki1,73,1000,763,237,1.15874855156431,2.37,0.923499251449654
2010,"Computer and Automation Research Institute, Hungarian Academy of Scien",sztaki1,74,1000,990,10,1.00502512562814,2,5.42670726624206e-15
2010,"Computer and Automation Research Institute, Hungarian Academy of Scien",sztaki1,75,1000,778,222,1.14810562571757,2.38709677419355,0.938178327732593
2010,"Computer and Automation Research Institute, Hungarian Academy of Scien",sztaki1,76,1000,686,314,1.24223602484472,2.63865546218487,0.977808098834581
2010,"Computer and Automation Research Institute, Hungarian Academy of Scien",sztaki1,77,1000,964,36,1.02354145342886,2.76923076923077,1.40948052513109e-07
2010,"Computer and Automation Research Institute, Hungarian Academy of Scien",sztaki1,78,1000,741,259,1.17508813160987,2.35454545454545,0.951008902808355
2010,"Computer and Automation Research Institute, Hungarian Academy of Scien",sztaki1,79,1000,770,230,1.15740740740741,2.4468085106383,0.952771784393645
2010,"Computer and Automation Research Institute, Hungarian Academy of Scien",sztaki1,80,1000,778,222,1.15074798619102,2.43956043956044,0.928216651642186
2010,"Computer and Automation Research Institute, Hungarian Academy of Scien",sztaki1,81,1000,708,292,1.21802679658953,2.58407079646018,0.994106592626838
2010,"Computer and Automation Research Institute, Hungarian Academy of Scien",sztaki1,82,1000,643,357,1.2987012987013,2.81102362204724,0.989720133744539
2010,"Computer and Automation Research Institute, Hungarian Academy of Scien",sztaki1,83,1000,761,239,1.18764845605701,2.95061728395062,0.999850231003597
2010,"Computer and Automation Research Institute, Hungarian Academy of Scien",sztaki1,84,1000,778,222,1.14678899082569,2.36170212765957,0.567965838225879
2010,"Computer and Automation Research Institute, Hungarian Academy of Scien",sztaki1,85,1000,998,2,1.001001001001,2,2.44608107469669e-12
2010,"Computer and Automation Research Institute, Hungarian Academy of Scien",sztaki1,86,1000,990,10,1.00502512562814,2,8.67874224156472e-05
2010,"Computer and Automation Research Institute, Hungarian Academy of Scien",sztaki1,87,1000,698,302,1.23304562268804,2.67256637168142,0.992967785590979
2010,"Computer and Automation Research Institute, Hungarian Academy of Scien",sztaki1,88,1000,971,29,1.01522842639594,2.07142857142857,0.350003453530418
2010,"Computer and Automation Research Institute, Hungarian Academy of Scien",sztaki1,89,1000,978,22,1.01112234580384,2,1.15451525836307e-06
2010,"Computer and Automation Research Institute, Hungarian Academy of Scien",sztaki1,90,1000,990,10,1.00502512562814,2,1.72929382686787e-14
2010,"Computer and Automation Research Institute, Hungarian Academy of Scien",sztaki1,91,1000,729,271,1.21065375302663,2.79381443298969,0.997896404830079
2010,"Computer and Automation Research Institute, Hungarian Academy of Scien",sztaki1,92,1000,658,342,1.30039011703511,3.08108108108108,0.999485752795431
2010,"Computer and Automation Research Institute, Hungarian Academy of Scien",sztaki1,93,1000,990,10,1.00502512562814,2,0.00165831307793667
2010,"Computer and Automation Research Institute, Hungarian Academy of Scien",sztaki1,94,1000,790,210,1.13507377979569,2.30769230769231,0.754426284623353
2010,"Computer and Automation Research Institute, Hungarian Academy of Scien",sztaki1,95,1000,710,290,1.21359223300971,2.54385964912281,0.981389364609931
2010,"Computer and Automation Research Institute, Hungarian Academy of Scien",sztaki1,96,1000,723,277,1.20336943441637,2.56481481481482,0.994556760454968
2010,"Computer and Automation Research Institute, Hungarian Academy of Scien",sztaki1,97,1000,651,349,1.30890052356021,3.08849557522124,0.999994494594536
2010,"Computer and Automation Research Institute, Hungarian Academy of Scien",sztaki1,98,1000,726,274,1.20048019207683,2.5607476635514,0.971265325300196
2010,"Computer and Automation Research Institute, Hungarian Academy of Scien",sztaki1,99,1000,691,309,1.23304562268804,2.575,0.997797317858152
2010,"Computer and Automation Research Institute, Hungarian Academy of Scien",sztaki1,100,1000,1000,0,1,,0
2010,University of Delaware,udelIndriB,51,1000,923,77,1.04384133611691,2.2,0.00171090354768512
2010,University of Delaware,udelIndriB,52,1000,904,96,1.05820105820106,2.34146341463415,0.000473096709877403
2010,University of Delaware,udelIndriB,53,1000,872,128,1.0752688172043,2.20689655172414,0.0193305454766227
2010,University of Delaware,udelIndriB,54,1000,771,229,1.15606936416185,2.43617021276596,0.0391065577245837
2010,University of Delaware,udelIndriB,55,1000,821,179,1.12866817155756,2.75384615384615,0.000151214799916664
2010,University of Delaware,udelIndriB,56,1000,775,225,1.19047619047619,3.46153846153846,0.0865451357781075
2010,University of Delaware,udelIndriB,57,1000,879,121,1.07642626480086,2.42,5.11095272084286e-06
2010,University of Delaware,udelIndriB,58,1000,828,172,1.11482720178372,2.49275362318841,0.0573670702522382
2010,University of Delaware,udelIndriB,59,1000,894,106,1.06382978723404,2.30434782608696,0.160070757863932
2010,University of Delaware,udelIndriB,60,1000,909,91,1.05263157894737,2.21951219512195,5.50194524986654e-08
2010,University of Delaware,udelIndriB,61,1000,801,199,1.14025085518814,2.61842105263158,0.0100181603067427
2010,University of Delaware,udelIndriB,62,1000,904,96,1.06044538706257,2.46153846153846,0.252791573993395
2010,University of Delaware,udelIndriB,63,1000,854,146,1.08813928182807,2.24615384615385,0.00243208709810961
2010,University of Delaware,udelIndriB,64,1000,723,277,1.2453300124533,3.4625,0.0385038288531623
2010,University of Delaware,udelIndriB,65,1000,907,93,1.05485232067511,2.26829268292683,0.000745513824409964
2010,University of Delaware,udelIndriB,66,1000,943,57,1.03626943005181,2.59090909090909,2.09833194137135e-05
2010,University of Delaware,udelIndriB,67,1000,818,182,1.14025085518814,3.08474576271186,0.239248959032639
2010,University of Delaware,udelIndriB,68,1000,914,86,1.04712041884817,2.09756097560976,1.30177645195686e-06
2010,University of Delaware,udelIndriB,69,1000,825,175,1.15473441108545,4.26829268292683,1.62163975912339e-09
2010,University of Delaware,udelIndriB,70,1000,918,82,1.0515247108307,2.48484848484849,1.12879801708952e-07
2010,University of Delaware,udelIndriB,71,1000,937,63,1.03626943005181,2.25,5.00013034078279e-08
2010,University of Delaware,udelIndriB,72,1000,853,147,1.1001100110011,2.625,0.00108802518050554
2010,University of Delaware,udelIndriB,73,1000,912,88,1.05596620908131,2.51428571428571,4.61476333667644e-05
2010,University of Delaware,udelIndriB,74,1000,914,86,1.0482180293501,2.15,0.0408683843887303
2010,University of Delaware,udelIndriB,75,1000,761,239,1.15606936416185,2.29807692307692,0.291829589957337
2010,University of Delaware,udelIndriB,76,1000,958,42,1.02145045965271,2,3.62335557923539e-07
2010,University of Delaware,udelIndriB,77,1000,917,83,1.04931794333683,2.30555555555556,0.0120745114757946
2010,University of Delaware,udelIndriB,78,1000,956,44,1.02354145342886,2.0952380952381,0.0490629201255607
2010,University of Delaware,udelIndriB,79,1000,846,154,1.10497237569061,2.61016949152542,8.48071141297291e-06
2010,University of Delaware,udelIndriB,80,1000,972,28,1.01522842639594,2.15384615384615,3.35398231078775e-12
2010,University of Delaware,udelIndriB,81,1000,816,184,1.14285714285714,3.11864406779661,0.00109321825178466
2010,University of Delaware,udelIndriB,82,1000,830,170,1.11607142857143,2.57575757575758,0.000163677595956434
2010,University of Delaware,udelIndriB,83,1000,611,389,1.30208333333333,2.47770700636943,0.179761362156236
2010,University of Delaware,udelIndriB,84,1000,857,143,1.09409190371991,2.50877192982456,0.168438147224034
2010,University of Delaware,udelIndriB,85,1000,899,101,1.05485232067511,2.06122448979592,0.309819776482384
2010,University of Delaware,udelIndriB,86,1000,912,88,1.05374077976818,2.37837837837838,0.0136198786338236
2010,University of Delaware,udelIndriB,87,1000,891,109,1.06496272630458,2.27083333333333,0.00505100112403358
2010,University of Delaware,udelIndriB,88,1000,928,72,1.04602510460251,2.57142857142857,1.16953589890435e-08
2010,University of Delaware,udelIndriB,89,1000,925,75,1.04384133611691,2.27272727272727,0.00347956354309054
2010,University of Delaware,udelIndriB,90,1000,875,125,1.07411385606874,2.23214285714286,0.213785201697716
2010,University of Delaware,udelIndriB,91,1000,901,99,1.06951871657754,2.91176470588235,7.69191554519342e-06
2010,University of Delaware,udelIndriB,92,1000,887,113,1.06609808102345,2.2156862745098,1.61398298916806e-06
2010,University of Delaware,udelIndriB,93,1000,920,80,1.04384133611691,2.10526315789474,0.0111647179198264
2010,University of Delaware,udelIndriB,94,1000,889,111,1.06837606837607,2.36170212765957,0.0330763487008123
2010,University of Delaware,udelIndriB,95,1000,937,63,1.03305785123967,2.03225806451613,0.00102929729856166
2010,University of Delaware,udelIndriB,96,1000,894,106,1.06723585912487,2.46511627906977,0.000246333963621117
2010,University of Delaware,udelIndriB,97,1000,942,58,1.03626943005181,2.52173913043478,1.78713461788778e-05
2010,University of Delaware,udelIndriB,98,1000,872,128,1.08695652173913,2.66666666666667,0.178413097289368
2010,University of Delaware,udelIndriB,99,1000,877,123,1.09409190371991,3.32432432432432,0.0282619473165784
2010,University of Delaware,udelIndriB,100,1000,968,32,1.01626016260163,2,3.17411947862208e-05
2010,University of Delaware,udelIndriB2,51,1000,924,76,1.04384133611691,2.23529411764706,0.00286908542229557
2010,University of Delaware,udelIndriB2,52,1000,904,96,1.05820105820106,2.34146341463415,0.000314756425668931
2010,University of Delaware,udelIndriB2,53,1000,874,126,1.07296137339056,2.17241379310345,0.0104322910356888
2010,University of Delaware,udelIndriB2,54,1000,824,176,1.11482720178372,2.41095890410959,0.000839107616144543
2010,University of Delaware,udelIndriB2,55,1000,852,148,1.10741971207087,2.90196078431373,2.59783520373583e-09
2010,University of Delaware,udelIndriB2,56,1000,766,234,1.20048019207683,3.49253731343284,0.0864005600287812
2010,University of Delaware,udelIndriB2,57,1000,875,125,1.07874865156419,2.40384615384615,1.79226414876999e-05
2010,University of Delaware,udelIndriB2,58,1000,843,157,1.10497237569061,2.53225806451613,0.00565092791633044
2010,University of Delaware,udelIndriB2,59,1000,881,119,1.07066381156317,2.24528301886792,0.1276516836621
2010,University of Delaware,udelIndriB2,60,1000,913,87,1.0515247108307,2.28947368421053,3.68443907721598e-06
2010,University of Delaware,udelIndriB2,61,1000,809,191,1.13507377979569,2.65277777777778,0.00108913973269282
2010,University of Delaware,udelIndriB2,62,1000,902,98,1.06157112526539,2.45,0.244610438922688
2010,University of Delaware,udelIndriB2,63,1000,854,146,1.08695652173913,2.21212121212121,0.000157145059312913
2010,University of Delaware,udelIndriB2,64,1000,738,262,1.22699386503067,3.4025974025974,0.0130466539348966
2010,University of Delaware,udelIndriB2,65,1000,900,100,1.05932203389831,2.27272727272727,0.00903628558854011
2010,University of Delaware,udelIndriB2,66,1000,955,45,1.02986611740474,2.8125,2.41145930775384e-05
2010,University of Delaware,udelIndriB2,67,1000,818,182,1.14025085518814,3.08474576271186,0.243025315664617
2010,University of Delaware,udelIndriB2,68,1000,913,87,1.04712041884817,2.07142857142857,1.02477208681367e-09
2010,University of Delaware,udelIndriB2,69,1000,826,174,1.14810562571757,3.86666666666667,7.10552942139608e-05
2010,University of Delaware,udelIndriB2,70,1000,941,59,1.03734439834025,2.56521739130435,6.31384340384621e-12
2010,University of Delaware,udelIndriB2,71,1000,927,73,1.04166666666667,2.21212121212121,3.81927920036767e-08
2010,University of Delaware,udelIndriB2,72,1000,890,110,1.06496272630458,2.24489795918367,3.0260903070504e-05
2010,University of Delaware,udelIndriB2,73,1000,910,90,1.05708245243129,2.5,2.45390297070168e-05
2010,University of Delaware,udelIndriB2,74,1000,912,88,1.04931794333683,2.14634146341463,0.00466137928394138
2010,University of Delaware,udelIndriB2,75,1000,757,243,1.16009280742459,2.31428571428571,0.103139740456227
2010,University of Delaware,udelIndriB2,76,1000,949,51,1.02669404517454,2.04,2.37747984424941e-07
2010,University of Delaware,udelIndriB2,77,1000,918,82,1.04931794333683,2.34285714285714,0.00222458016985952
2010,University of Delaware,udelIndriB2,78,1000,967,33,1.0183299389002,2.2,2.98000760696745e-06
2010,University of Delaware,udelIndriB2,79,1000,860,140,1.09409190371991,2.59259259259259,1.35192398456475e-07
2010,University of Delaware,udelIndriB2,80,1000,982,18,1.00908173562059,2,2.89041305321737e-08
2010,University of Delaware,udelIndriB2,81,1000,857,143,1.10987791342952,3.25,5.91287929468369e-07
2010,University of Delaware,udelIndriB2,82,1000,848,152,1.1037527593819,2.62068965517241,4.13975171045651e-07
2010,University of Delaware,udelIndriB2,83,1000,634,366,1.27551020408163,2.44,0.00428373765650035
2010,University of Delaware,udelIndriB2,84,1000,857,143,1.09409190371991,2.50877192982456,0.14530625164219
2010,University of Delaware,udelIndriB2,85,1000,901,99,1.05374077976818,2.0625,0.308598480482491
2010,University of Delaware,udelIndriB2,86,1000,901,99,1.06044538706257,2.35714285714286,0.00527962754140289
2010,University of Delaware,udelIndriB2,87,1000,884,116,1.06951871657754,2.27450980392157,0.00182635734675521
2010,University of Delaware,udelIndriB2,88,1000,922,78,1.0482180293501,2.4375,4.1526580592667e-05
2010,University of Delaware,udelIndriB2,89,1000,927,73,1.04275286757039,2.28125,0.00252996376108067
2010,University of Delaware,udelIndriB2,90,1000,867,133,1.07874865156419,2.21666666666667,0.181907724960877
2010,University of Delaware,udelIndriB2,91,1000,886,114,1.07758620689655,2.71428571428571,1.09215195095132e-05
2010,University of Delaware,udelIndriB2,92,1000,925,75,1.04384133611691,2.27272727272727,1.2061286850302e-12
2010,University of Delaware,udelIndriB2,93,1000,922,78,1.04275286757039,2.10810810810811,0.00288638933863836
2010,University of Delaware,udelIndriB2,94,1000,895,105,1.06269925611052,2.28260869565217,0.000463722516620673
2010,University of Delaware,udelIndriB2,95,1000,951,49,1.02564102564103,2.04166666666667,0.00197779903674739
2010,University of Delaware,udelIndriB2,96,1000,897,103,1.06496272630458,2.45238095238095,1.07697415960582e-08
2010,University of Delaware,udelIndriB2,97,1000,958,42,1.02249488752556,2.1,2.13957874447715e-12
2010,University of Delaware,udelIndriB2,98,1000,877,123,1.08342361863489,2.67391304347826,0.0689204081566389
2010,University of Delaware,udelIndriB2,99,1000,887,113,1.085776330076,3.32352941176471,0.020639233572343
2010,University of Delaware,udelIndriB2,100,1000,978,22,1.01112234580384,2,2.40159414921277e-05
2010,University of Delaware,udelIndriWP,51,1000,572,428,1.38888888888889,2.89189189189189,0.378794849815304
2010,University of Delaware,udelIndriWP,52,1000,614,386,1.32450331125828,2.73758865248227,0.0055202081519747
2010,University of Delaware,udelIndriWP,53,1000,701,299,1.19904076738609,2.24812030075188,0.372799180389022
2010,University of Delaware,udelIndriWP,54,1000,658,342,1.25470514429109,2.46043165467626,0.434834905281553
2010,University of Delaware,udelIndriWP,55,1000,661,339,1.24378109452736,2.37062937062937,0.407408342324121
2010,University of Delaware,udelIndriWP,56,1000,767,233,1.15207373271889,2.30693069306931,0.18612867283023
2010,University of Delaware,udelIndriWP,57,1000,656,344,1.25628140703518,2.45714285714286,0.490475497028361
2010,University of Delaware,udelIndriWP,58,1000,692,308,1.230012300123,2.54545454545455,0.375939301742586
2010,University of Delaware,udelIndriWP,59,1000,676,324,1.24069478908189,2.49230769230769,0.280613445191485
2010,University of Delaware,udelIndriWP,60,1000,508,492,1.62337662337662,4.55555555555556,0.272693459669571
2010,University of Delaware,udelIndriWP,61,1000,605,395,1.32978723404255,2.68707482993197,0.357326420934352
2010,University of Delaware,udelIndriWP,62,1000,674,326,1.2531328320802,2.62903225806452,0.365445780609155
2010,University of Delaware,udelIndriWP,63,1000,494,506,1.51515151515152,3.04819277108434,0.279309799427711
2010,University of Delaware,udelIndriWP,64,1000,550,450,1.45137880986938,3.23741007194245,0.258530085295548
2010,University of Delaware,udelIndriWP,65,1000,581,419,1.35869565217391,2.70322580645161,0.404830942008602
2010,University of Delaware,udelIndriWP,66,1000,612,388,1.31926121372032,2.65753424657534,0.0418777958412798
2010,University of Delaware,udelIndriWP,67,1000,509,491,1.4903129657228,3.03086419753086,0.508397588718054
2010,University of Delaware,udelIndriWP,68,1000,433,567,1.64203612479475,3.22159090909091,0.489323694334216
2010,University of Delaware,udelIndriWP,69,1000,646,354,1.30039011703511,2.87804878048781,0.263334972012648
2010,University of Delaware,udelIndriWP,70,1000,699,301,1.22249388753056,2.52941176470588,0.40626408846559
2010,University of Delaware,udelIndriWP,71,1000,708,292,1.19617224880383,2.28125,0.0685785912672982
2010,University of Delaware,udelIndriWP,72,1000,673,327,1.25470514429109,2.63709677419355,0.0762848167897536
2010,University of Delaware,udelIndriWP,73,1000,743,257,1.18063754427391,2.47115384615385,0.0219265298444649
2010,University of Delaware,udelIndriWP,74,1000,652,348,1.25156445556946,2.36734693877551,0.464935247367951
2010,University of Delaware,udelIndriWP,75,1000,676,324,1.23609394313968,2.43609022556391,0.486934782512884
2010,University of Delaware,udelIndriWP,76,1000,714,286,1.20336943441637,2.44444444444444,0.268112883972843
2010,University of Delaware,udelIndriWP,77,1000,656,344,1.26103404791929,2.51094890510949,0.481973428579175
2010,University of Delaware,udelIndriWP,78,1000,548,452,1.40646976090014,2.77300613496933,0.51044933590976
2010,University of Delaware,udelIndriWP,79,1000,748,252,1.17233294255569,2.4,0.353964965508757
2010,University of Delaware,udelIndriWP,80,1000,653,347,1.29032258064516,2.84426229508197,0.314055040471805
2010,University of Delaware,udelIndriWP,81,1000,575,425,1.39470013947001,2.99295774647887,0.0367374850999562
2010,University of Delaware,udelIndriWP,82,1000,626,374,1.29032258064516,2.51006711409396,0.354234492840488
2010,University of Delaware,udelIndriWP,83,1000,649,351,1.26582278481013,2.48936170212766,0.31351743284542
2010,University of Delaware,udelIndriWP,84,1000,567,433,1.40449438202247,2.98620689655172,0.709797845947714
2010,University of Delaware,udelIndriWP,85,1000,642,358,1.26262626262626,2.38666666666667,0.446867468782436
2010,University of Delaware,udelIndriWP,86,1000,637,363,1.26582278481013,2.37254901960784,0.254521924538762
2010,University of Delaware,udelIndriWP,87,1000,576,424,1.37362637362637,2.78947368421053,0.502379990444596
2010,University of Delaware,udelIndriWP,88,1000,592,408,1.35869565217391,2.83333333333333,0.21019188694226
2010,University of Delaware,udelIndriWP,89,1000,459,541,1.51975683890578,2.71859296482412,0.450487397701254
2010,University of Delaware,udelIndriWP,90,1000,523,477,1.43266475644699,2.72571428571429,0.427762681701827
2010,University of Delaware,udelIndriWP,91,1000,750,250,1.16279069767442,2.27272727272727,0.100401116917893
2010,University of Delaware,udelIndriWP,92,1000,688,312,1.22850122850123,2.47619047619048,0.315726659530359
2010,University of Delaware,udelIndriWP,93,1000,610,390,1.2970168612192,2.42236024844721,0.226149093778645
2010,University of Delaware,udelIndriWP,94,1000,678,322,1.25156445556946,2.66115702479339,0.338029376889378
2010,University of Delaware,udelIndriWP,95,1000,705,295,1.20481927710843,2.36,0.178346478627464
2010,University of Delaware,udelIndriWP,96,1000,685,315,1.23456790123457,2.52,0.323301888679142
2010,University of Delaware,udelIndriWP,97,1000,638,362,1.37174211248285,3.97802197802198,0.0113663138007715
2010,University of Delaware,udelIndriWP,98,1000,596,404,1.36239782016349,2.92753623188406,0.285836396435532
2010,University of Delaware,udelIndriWP,99,1000,618,382,1.33155792276964,2.87218045112782,0.828911819081031
2010,University of Delaware,udelIndriWP,100,1000,754,246,1.15874855156431,2.25688073394495,0.13013447850756
2010,"Center of Intelligent Info Retrieval, UMass",umassSDM,51,1000,937,63,1.0351966873706,2.17241379310345,4.27524917291048e-06
2010,"Center of Intelligent Info Retrieval, UMass",umassSDM,52,1000,933,67,1.0351966873706,2.03030303030303,6.7348615085245e-08
2010,"Center of Intelligent Info Retrieval, UMass",umassSDM,53,1000,859,141,1.08225108225108,2.16923076923077,0.0716824208665917
2010,"Center of Intelligent Info Retrieval, UMass",umassSDM,54,1000,926,74,1.04493207941484,2.38709677419355,0.000605136452969821
2010,"Center of Intelligent Info Retrieval, UMass",umassSDM,55,1000,442,558,1.83150183150183,5.36538461538462,0.171166490343047
2010,"Center of Intelligent Info Retrieval, UMass",umassSDM,56,1000,937,63,1.03305785123967,2.03225806451613,0.00582673497847661
2010,"Center of Intelligent Info Retrieval, UMass",umassSDM,57,1000,485,515,1.62337662337662,3.93129770992366,0.000729251888474361
2010,"Center of Intelligent Info Retrieval, UMass",umassSDM,58,1000,833,167,1.0989010989011,2.16883116883117,0.13820263543832
2010,"Center of Intelligent Info Retrieval, UMass",umassSDM,59,1000,963,37,1.01936799184506,2.05555555555556,5.47715656909499e-06
2010,"Center of Intelligent Info Retrieval, UMass",umassSDM,60,1000,852,148,1.085776330076,2.14492753623188,0.000243458982351371
2010,"Center of Intelligent Info Retrieval, UMass",umassSDM,61,1000,893,107,1.05820105820106,2.05769230769231,0.0726852728293893
2010,"Center of Intelligent Info Retrieval, UMass",umassSDM,62,1000,950,50,1.02564102564103,2,0.082583253744957
2010,"Center of Intelligent Info Retrieval, UMass",umassSDM,63,1000,873,127,1.08225108225108,2.49019607843137,0.0558027274155114
2010,"Center of Intelligent Info Retrieval, UMass",umassSDM,64,1000,914,86,1.04493207941484,2,0.0362771188480456
2010,"Center of Intelligent Info Retrieval, UMass",umassSDM,65,1000,898,102,1.05820105820106,2.17021276595745,0.0851759343263466
2010,"Center of Intelligent Info Retrieval, UMass",umassSDM,66,1000,928,72,1.03842159916926,2.05714285714286,6.5164007055113e-07
2010,"Center of Intelligent Info Retrieval, UMass",umassSDM,67,1000,950,50,1.02880658436214,2.27272727272727,0.00753144996124116
2010,"Center of Intelligent Info Retrieval, UMass",umassSDM,68,1000,890,110,1.05932203389831,2.03703703703704,0.000181457847511764
2010,"Center of Intelligent Info Retrieval, UMass",umassSDM,69,1000,934,66,1.03734439834025,2.2,0.000824249483055088
2010,"Center of Intelligent Info Retrieval, UMass",umassSDM,70,1000,905,95,1.0515247108307,2.06521739130435,7.44739367643187e-05
2010,"Center of Intelligent Info Retrieval, UMass",umassSDM,71,1000,827,173,1.10253583241455,2.1625,0.0152277750330052
2010,"Center of Intelligent Info Retrieval, UMass",umassSDM,72,1000,952,48,1.02459016393443,2,0.00079319965490626
2010,"Center of Intelligent Info Retrieval, UMass",umassSDM,73,1000,928,72,1.03842159916926,2.05714285714286,1.30263282790665e-05
2010,"Center of Intelligent Info Retrieval, UMass",umassSDM,74,1000,831,169,1.10253583241455,2.22368421052632,0.170196721234063
2010,"Center of Intelligent Info Retrieval, UMass",umassSDM,75,1000,872,128,1.07066381156317,2.06451612903226,0.00132784404303795
2010,"Center of Intelligent Info Retrieval, UMass",umassSDM,76,1000,940,60,1.03092783505155,2,3.46139746261949e-10
2010,"Center of Intelligent Info Retrieval, UMass",umassSDM,77,1000,870,130,1.07296137339056,2.09677419354839,0.0911023129001497
2010,"Center of Intelligent Info Retrieval, UMass",umassSDM,78,1000,893,107,1.05820105820106,2.05769230769231,7.81774641348386e-05
2010,"Center of Intelligent Info Retrieval, UMass",umassSDM,79,1000,867,133,1.0752688172043,2.11111111111111,7.13563602203633e-06
2010,"Center of Intelligent Info Retrieval, UMass",umassSDM,80,1000,911,89,1.04931794333683,2.11904761904762,0.000138745368694602
2010,"Center of Intelligent Info Retrieval, UMass",umassSDM,81,1000,864,136,1.0752688172043,2.06060606060606,4.17094876261583e-06
2010,"Center of Intelligent Info Retrieval, UMass",umassSDM,82,1000,895,105,1.06157112526539,2.23404255319149,0.0185721292220796
2010,"Center of Intelligent Info Retrieval, UMass",umassSDM,83,1000,725,275,1.20192307692308,2.57009345794393,0.00132070022275994
2010,"Center of Intelligent Info Retrieval, UMass",umassSDM,84,1000,893,107,1.06269925611052,2.22916666666667,0.213595118337414
2010,"Center of Intelligent Info Retrieval, UMass",umassSDM,85,1000,946,54,1.02774922918808,2,0.00165834518837054
2010,"Center of Intelligent Info Retrieval, UMass",umassSDM,86,1000,934,66,1.03412616339193,2,0.0187325983346219
2010,"Center of Intelligent Info Retrieval, UMass",umassSDM,87,1000,879,121,1.06837606837607,2.12280701754386,0.204758958385288
2010,"Center of Intelligent Info Retrieval, UMass",umassSDM,88,1000,943,57,1.03092783505155,2.11111111111111,1.759669260447e-06
2010,"Center of Intelligent Info Retrieval, UMass",umassSDM,89,1000,888,112,1.07066381156317,2.43478260869565,1.40268176028956e-09
2010,"Center of Intelligent Info Retrieval, UMass",umassSDM,90,1000,856,144,1.08342361863489,2.14925373134328,0.321042970071044
2010,"Center of Intelligent Info Retrieval, UMass",umassSDM,91,1000,916,84,1.04384133611691,2,0.0736098970746304
2010,"Center of Intelligent Info Retrieval, UMass",umassSDM,92,1000,743,257,1.17096018735363,2.31531531531532,2.93465243580875e-07
2010,"Center of Intelligent Info Retrieval, UMass",umassSDM,93,1000,889,111,1.06157112526539,2.09433962264151,0.0018589230553374
2010,"Center of Intelligent Info Retrieval, UMass",umassSDM,94,1000,929,71,1.03950103950104,2.15151515151515,0.104549831572514
2010,"Center of Intelligent Info Retrieval, UMass",umassSDM,95,1000,755,245,1.17924528301887,2.63440860215054,0.00874065479214938
2010,"Center of Intelligent Info Retrieval, UMass",umassSDM,96,1000,905,95,1.05042016806723,2.02127659574468,2.17956415971711e-06
2010,"Center of Intelligent Info Retrieval, UMass",umassSDM,97,1000,883,117,1.06496272630458,2.08928571428571,0.000358674287823437
2010,"Center of Intelligent Info Retrieval, UMass",umassSDM,98,1000,840,160,1.09529025191676,2.19178082191781,0.0101237887736213
2010,"Center of Intelligent Info Retrieval, UMass",umassSDM,99,1000,867,133,1.07991360691145,2.25423728813559,0.0733832981263722
2010,"Center of Intelligent Info Retrieval, UMass",umassSDM,100,1000,934,66,1.03412616339193,2,0.0359971463319252
2010,"Center of Intelligent Info Retrieval, UMass",umassSDMW,51,1000,937,63,1.0351966873706,2.17241379310345,0.0110574150471209
2010,"Center of Intelligent Info Retrieval, UMass",umassSDMW,52,1000,925,75,1.04058272632674,2.08333333333333,4.90674894443796e-08
2010,"Center of Intelligent Info Retrieval, UMass",umassSDMW,53,1000,879,121,1.06723585912487,2.08620689655172,0.0867305834504535
2010,"Center of Intelligent Info Retrieval, UMass",umassSDMW,54,1000,779,221,1.12994350282486,2.08490566037736,0.0261992291621375
2010,"Center of Intelligent Info Retrieval, UMass",umassSDMW,55,1000,595,405,1.48588410104012,5.19230769230769,0.36245803097674
2010,"Center of Intelligent Info Retrieval, UMass",umassSDMW,56,1000,885,115,1.06382978723404,2.09090909090909,0.00099773675428895
2010,"Center of Intelligent Info Retrieval, UMass",umassSDMW,57,1000,485,515,1.62337662337662,3.93129770992366,0.000729251888474361
2010,"Center of Intelligent Info Retrieval, UMass",umassSDMW,58,1000,860,140,1.08108108108108,2.15384615384615,0.249852670085614
2010,"Center of Intelligent Info Retrieval, UMass",umassSDMW,59,1000,947,53,1.02774922918808,2.03846153846154,0.0254176315639336
2010,"Center of Intelligent Info Retrieval, UMass",umassSDMW,60,1000,864,136,1.07874865156419,2.15873015873016,0.121261956517345
2010,"Center of Intelligent Info Retrieval, UMass",umassSDMW,61,1000,903,97,1.05263157894737,2.06382978723404,0.16251868545207
2010,"Center of Intelligent Info Retrieval, UMass",umassSDMW,62,1000,938,62,1.03199174406605,2,0.124087105538433
2010,"Center of Intelligent Info Retrieval, UMass",umassSDMW,63,1000,821,179,1.13636363636364,3.03389830508475,0.129625221149301
2010,"Center of Intelligent Info Retrieval, UMass",umassSDMW,64,1000,902,98,1.05374077976818,2.08510638297872,0.137188978008811
2010,"Center of Intelligent Info Retrieval, UMass",umassSDMW,65,1000,889,111,1.06157112526539,2.09433962264151,0.00778798922235481
2010,"Center of Intelligent Info Retrieval, UMass",umassSDMW,66,1000,892,108,1.05932203389831,2.07692307692308,2.77717635455534e-05
2010,"Center of Intelligent Info Retrieval, UMass",umassSDMW,67,1000,936,64,1.03734439834025,2.28571428571429,0.101112705086608
2010,"Center of Intelligent Info Retrieval, UMass",umassSDMW,68,1000,888,112,1.06044538706257,2.03636363636364,8.67900951966074e-05
2010,"Center of Intelligent Info Retrieval, UMass",umassSDMW,69,1000,936,64,1.03626943005181,2.20689655172414,0.000354812375369016
2010,"Center of Intelligent Info Retrieval, UMass",umassSDMW,70,1000,883,117,1.06723585912487,2.16666666666667,0.101494296433691
2010,"Center of Intelligent Info Retrieval, UMass",umassSDMW,71,1000,859,141,1.08225108225108,2.16923076923077,0.0765847242108909
2010,"Center of Intelligent Info Retrieval, UMass",umassSDMW,72,1000,933,67,1.0351966873706,2.03030303030303,0.287926997082757
2010,"Center of Intelligent Info Retrieval, UMass",umassSDMW,73,1000,919,81,1.04275286757039,2.025,0.00279594732462706
2010,"Center of Intelligent Info Retrieval, UMass",umassSDMW,74,1000,840,160,1.09769484083425,2.25352112676056,0.225662093775341
2010,"Center of Intelligent Info Retrieval, UMass",umassSDMW,75,1000,892,108,1.05820105820106,2.0377358490566,0.00317195095043265
2010,"Center of Intelligent Info Retrieval, UMass",umassSDMW,76,1000,930,70,1.03734439834025,2.05882352941176,2.27102266422026e-10
2010,"Center of Intelligent Info Retrieval, UMass",umassSDMW,77,1000,880,120,1.06723585912487,2.10526315789474,0.330440640187388
2010,"Center of Intelligent Info Retrieval, UMass",umassSDMW,78,1000,882,118,1.06496272630458,2.07017543859649,0.00259169925386681
2010,"Center of Intelligent Info Retrieval, UMass",umassSDMW,79,1000,865,135,1.07411385606874,2.04545454545455,0.00232234477314791
2010,"Center of Intelligent Info Retrieval, UMass",umassSDMW,80,1000,912,88,1.0482180293501,2.0952380952381,4.19281665673726e-05
2010,"Center of Intelligent Info Retrieval, UMass",umassSDMW,81,1000,829,171,1.10253583241455,2.19230769230769,0.0104266823898495
2010,"Center of Intelligent Info Retrieval, UMass",umassSDMW,82,1000,875,125,1.07066381156317,2.11864406779661,0.112027715080221
2010,"Center of Intelligent Info Retrieval, UMass",umassSDMW,83,1000,803,197,1.11607142857143,2.11827956989247,0.0113318880743404
2010,"Center of Intelligent Info Retrieval, UMass",umassSDMW,84,1000,878,122,1.07066381156317,2.17857142857143,0.246010794236075
2010,"Center of Intelligent Info Retrieval, UMass",umassSDMW,85,1000,938,62,1.03305785123967,2.06666666666667,0.0296061214278984
2010,"Center of Intelligent Info Retrieval, UMass",umassSDMW,86,1000,926,74,1.03950103950104,2.05555555555556,0.0187191514834665
2010,"Center of Intelligent Info Retrieval, UMass",umassSDMW,87,1000,796,204,1.12107623318386,2.125,0.172752193353306
2010,"Center of Intelligent Info Retrieval, UMass",umassSDMW,88,1000,934,66,1.03626943005181,2.12903225806452,1.15451899654156e-06
2010,"Center of Intelligent Info Retrieval, UMass",umassSDMW,89,1000,892,108,1.06837606837607,2.45454545454545,0.150500424435895
2010,"Center of Intelligent Info Retrieval, UMass",umassSDMW,90,1000,866,134,1.07758620689655,2.16129032258065,0.193486708317237
2010,"Center of Intelligent Info Retrieval, UMass",umassSDMW,91,1000,852,148,1.08225108225108,2.05555555555556,0.171010611312107
2010,"Center of Intelligent Info Retrieval, UMass",umassSDMW,92,1000,881,119,1.06496272630458,2.05172413793103,0.125858997443588
2010,"Center of Intelligent Info Retrieval, UMass",umassSDMW,93,1000,900,100,1.05596620908131,2.12765957446809,0.0536657210387778
2010,"Center of Intelligent Info Retrieval, UMass",umassSDMW,94,1000,904,96,1.05485232067511,2.18181818181818,0.108242160235779
2010,"Center of Intelligent Info Retrieval, UMass",umassSDMW,95,1000,751,249,1.18203309692671,2.62105263157895,0.00874065478011239
2010,"Center of Intelligent Info Retrieval, UMass",umassSDMW,96,1000,905,95,1.0515247108307,2.06521739130435,0.0144309705046492
2010,"Center of Intelligent Info Retrieval, UMass",umassSDMW,97,1000,807,193,1.12107623318386,2.27058823529412,0.0392745326779935
2010,"Center of Intelligent Info Retrieval, UMass",umassSDMW,98,1000,851,149,1.08813928182807,2.19117647058824,0.0396001301282534
2010,"Center of Intelligent Info Retrieval, UMass",umassSDMW,99,1000,834,166,1.1001100110011,2.21333333333333,0.205676521813763
2010,"Center of Intelligent Info Retrieval, UMass",umassSDMW,100,1000,928,72,1.03734439834025,2,0.0323972679738004
2010,"Center of Intelligent Info Retrieval, UMass",umasswfb520,51,1000,967,33,1.01729399796541,2.0625,2.68200511338151e-06
2010,"Center of Intelligent Info Retrieval, UMass",umasswfb520,52,1000,947,53,1.02774922918808,2.03846153846154,5.77574146345312e-12
2010,"Center of Intelligent Info Retrieval, UMass",umasswfb520,53,1000,892,108,1.05820105820106,2.0377358490566,0.0292672375232855
2010,"Center of Intelligent Info Retrieval, UMass",umasswfb520,54,1000,886,114,1.06157112526539,2.03571428571429,0.0921684795079557
2010,"Center of Intelligent Info Retrieval, UMass",umasswfb520,55,1000,887,113,1.06723585912487,2.26,0.214040970307419
2010,"Center of Intelligent Info Retrieval, UMass",umasswfb520,56,1000,923,77,1.04058272632674,2.02631578947368,0.000527474743013175
2010,"Center of Intelligent Info Retrieval, UMass",umasswfb520,57,1000,602,398,1.3531799729364,2.90510948905109,0.218517987321652
2010,"Center of Intelligent Info Retrieval, UMass",umasswfb520,58,1000,909,91,1.04931794333683,2.06818181818182,0.190003053843518
2010,"Center of Intelligent Info Retrieval, UMass",umasswfb520,59,1000,904,96,1.0515247108307,2.04255319148936,8.76025237274554e-06
2010,"Center of Intelligent Info Retrieval, UMass",umasswfb520,60,1000,895,105,1.05820105820106,2.1,0.00401840696387954
2010,"Center of Intelligent Info Retrieval, UMass",umasswfb520,61,1000,941,59,1.03092783505155,2.03448275862069,0.0679226572124966
2010,"Center of Intelligent Info Retrieval, UMass",umasswfb520,62,1000,950,50,1.02564102564103,2,0.114834183472278
2010,"Center of Intelligent Info Retrieval, UMass",umasswfb520,63,1000,921,79,1.0515247108307,2.63333333333333,0.0736099012432234
2010,"Center of Intelligent Info Retrieval, UMass",umasswfb520,64,1000,902,98,1.0515247108307,2,0.309524809504716
2010,"Center of Intelligent Info Retrieval, UMass",umasswfb520,65,1000,899,101,1.05596620908131,2.10416666666667,0.00727991782184818
2010,"Center of Intelligent Info Retrieval, UMass",umasswfb520,66,1000,905,95,1.05042016806723,2.02127659574468,0.0146387860000465
2010,"Center of Intelligent Info Retrieval, UMass",umasswfb520,67,1000,912,88,1.05042016806723,2.2,0.0805348920118065
2010,"Center of Intelligent Info Retrieval, UMass",umasswfb520,68,1000,960,40,1.02145045965271,2.10526315789474,0.0239808599372841
2010,"Center of Intelligent Info Retrieval, UMass",umasswfb520,69,1000,960,40,1.02145045965271,2.10526315789474,5.35543133347218e-09
2010,"Center of Intelligent Info Retrieval, UMass",umasswfb520,70,1000,900,100,1.05485232067511,2.08333333333333,0.158237404560707
2010,"Center of Intelligent Info Retrieval, UMass",umasswfb520,71,1000,892,108,1.05932203389831,2.07692307692308,0.00236662206251746
2010,"Center of Intelligent Info Retrieval, UMass",umasswfb520,72,1000,912,88,1.04602510460251,2,0.000201613429217145
2010,"Center of Intelligent Info Retrieval, UMass",umasswfb520,73,1000,939,61,1.03199174406605,2.03333333333333,0.0046091652169476
2010,"Center of Intelligent Info Retrieval, UMass",umasswfb520,74,1000,933,67,1.0351966873706,2.03030303030303,3.53012784504464e-06
2010,"Center of Intelligent Info Retrieval, UMass",umasswfb520,75,1000,915,85,1.04493207941484,2.02380952380952,0.115474186340097
2010,"Center of Intelligent Info Retrieval, UMass",umasswfb520,76,1000,948,52,1.02669404517454,2,7.74305829047008e-13
2010,"Center of Intelligent Info Retrieval, UMass",umasswfb520,77,1000,945,55,1.03305785123967,2.39130434782609,0.343959206590498
2010,"Center of Intelligent Info Retrieval, UMass",umasswfb520,78,1000,954,46,1.02354145342886,2,0.0208504665224786
2010,"Center of Intelligent Info Retrieval, UMass",umasswfb520,79,1000,900,100,1.05263157894737,2,0.0075719885287831
2010,"Center of Intelligent Info Retrieval, UMass",umasswfb520,80,1000,936,64,1.0351966873706,2.13333333333333,1.35976390051821e-09
2010,"Center of Intelligent Info Retrieval, UMass",umasswfb520,81,1000,891,109,1.06496272630458,2.27083333333333,0.0176642687049465
2010,"Center of Intelligent Info Retrieval, UMass",umasswfb520,82,1000,880,120,1.06496272630458,2.03389830508475,0.0633296265110366
2010,"Center of Intelligent Info Retrieval, UMass",umasswfb520,83,1000,892,108,1.07296137339056,2.7,0.000714063493237742
2010,"Center of Intelligent Info Retrieval, UMass",umasswfb520,84,1000,931,69,1.03842159916926,2.15625,0.187423748767417
2010,"Center of Intelligent Info Retrieval, UMass",umasswfb520,85,1000,949,51,1.02669404517454,2.04,0.0317667836874841
2010,"Center of Intelligent Info Retrieval, UMass",umasswfb520,86,1000,923,77,1.04166666666667,2.08108108108108,0.0103334902907215
2010,"Center of Intelligent Info Retrieval, UMass",umasswfb520,87,1000,925,75,1.04166666666667,2.14285714285714,0.192841908358143
2010,"Center of Intelligent Info Retrieval, UMass",umasswfb520,88,1000,966,34,1.01729399796541,2,9.22628994324843e-07
2010,"Center of Intelligent Info Retrieval, UMass",umasswfb520,89,1000,955,45,1.02459016393443,2.14285714285714,5.06773376747227e-06
2010,"Center of Intelligent Info Retrieval, UMass",umasswfb520,90,1000,907,93,1.05263157894737,2.16279069767442,0.155248416976272
2010,"Center of Intelligent Info Retrieval, UMass",umasswfb520,91,1000,874,126,1.08695652173913,2.73913043478261,0.171775359550404
2010,"Center of Intelligent Info Retrieval, UMass",umasswfb520,92,1000,924,76,1.04058272632674,2.05405405405405,0.000107599405787196
2010,"Center of Intelligent Info Retrieval, UMass",umasswfb520,93,1000,910,90,1.0515247108307,2.19512195121951,2.17708967949664e-09
2010,"Center of Intelligent Info Retrieval, UMass",umasswfb520,94,1000,937,63,1.03305785123967,2.03225806451613,1.82311055762888e-05
2010,"Center of Intelligent Info Retrieval, UMass",umasswfb520,95,1000,821,179,1.12994350282486,2.796875,2.42680797230451e-06
2010,"Center of Intelligent Info Retrieval, UMass",umasswfb520,96,1000,950,50,1.02564102564103,2,7.61069131101085e-07
2010,"Center of Intelligent Info Retrieval, UMass",umasswfb520,97,1000,928,72,1.03734439834025,2,7.30586818514136e-07
2010,"Center of Intelligent Info Retrieval, UMass",umasswfb520,98,1000,816,184,1.12739571589628,2.59154929577465,0.0216736475582531
2010,"Center of Intelligent Info Retrieval, UMass",umasswfb520,99,1000,902,98,1.05263157894737,2.04166666666667,0.0612974338110804
2010,"Center of Intelligent Info Retrieval, UMass",umasswfb520,100,1000,942,58,1.02986611740474,2,0.1438562070276
2010,University of Glasgow (Terrier Team),uogTrA40n,51,1000,1000,0,1,,0
2010,University of Glasgow (Terrier Team),uogTrA40n,52,1000,1000,0,1,,0
2010,University of Glasgow (Terrier Team),uogTrA40n,53,1000,1000,0,1,,0
2010,University of Glasgow (Terrier Team),uogTrA40n,54,1000,1000,0,1,,0
2010,University of Glasgow (Terrier Team),uogTrA40n,55,1000,998,2,1.001001001001,2,5.88904496170503e-44
2010,University of Glasgow (Terrier Team),uogTrA40n,56,1000,1000,0,1,,0
2010,University of Glasgow (Terrier Team),uogTrA40n,57,1000,998,2,1.001001001001,2,8.70452842158072e-46
2010,University of Glasgow (Terrier Team),uogTrA40n,58,1000,1000,0,1,,0
2010,University of Glasgow (Terrier Team),uogTrA40n,59,1000,998,2,1.001001001001,2,1.44438641379765e-12
2010,University of Glasgow (Terrier Team),uogTrA40n,60,1000,1000,0,1,,0
2010,University of Glasgow (Terrier Team),uogTrA40n,61,1000,1000,0,1,,0
2010,University of Glasgow (Terrier Team),uogTrA40n,62,1000,1000,0,1,,0
2010,University of Glasgow (Terrier Team),uogTrA40n,63,1000,1000,0,1,,0
2010,University of Glasgow (Terrier Team),uogTrA40n,64,1000,1000,0,1,,0
2010,University of Glasgow (Terrier Team),uogTrA40n,65,1000,1000,0,1,,0
2010,University of Glasgow (Terrier Team),uogTrA40n,66,1000,996,4,1.00200400801603,2,1.80703728702928e-18
2010,University of Glasgow (Terrier Team),uogTrA40n,67,1000,970,30,1.01729399796541,2.30769230769231,5.04700966515039e-21
2010,University of Glasgow (Terrier Team),uogTrA40n,68,1000,998,2,1.001001001001,2,1.41069906741794e-41
2010,University of Glasgow (Terrier Team),uogTrA40n,69,1000,993,7,1.00401606425703,2.33333333333333,0.0151608716426758
2010,University of Glasgow (Terrier Team),uogTrA40n,70,1000,1000,0,1,,0
2010,University of Glasgow (Terrier Team),uogTrA40n,71,1000,1000,0,1,,0
2010,University of Glasgow (Terrier Team),uogTrA40n,72,1000,1000,0,1,,0
2010,University of Glasgow (Terrier Team),uogTrA40n,73,1000,1000,0,1,,0
2010,University of Glasgow (Terrier Team),uogTrA40n,74,1000,1000,0,1,,0
2010,University of Glasgow (Terrier Team),uogTrA40n,75,1000,1000,0,1,,0
2010,University of Glasgow (Terrier Team),uogTrA40n,76,1000,1000,0,1,,0
2010,University of Glasgow (Terrier Team),uogTrA40n,77,1000,1000,0,1,,0
2010,University of Glasgow (Terrier Team),uogTrA40n,78,1000,1000,0,1,,0
2010,University of Glasgow (Terrier Team),uogTrA40n,79,1000,1000,0,1,,0
2010,University of Glasgow (Terrier Team),uogTrA40n,80,1000,979,21,1.01419878296146,3,0.0706381924487577
2010,University of Glasgow (Terrier Team),uogTrA40n,81,1000,986,14,1.00704934541793,2,1.01903347934263e-10
2010,University of Glasgow (Terrier Team),uogTrA40n,82,1000,1000,0,1,,0
2010,University of Glasgow (Terrier Team),uogTrA40n,83,1000,998,2,1.001001001001,2,9.114642195643e-43
2010,University of Glasgow (Terrier Team),uogTrA40n,84,1000,1000,0,1,,0
2010,University of Glasgow (Terrier Team),uogTrA40n,85,1000,1000,0,1,,0
2010,University of Glasgow (Terrier Team),uogTrA40n,86,1000,1000,0,1,,0
2010,University of Glasgow (Terrier Team),uogTrA40n,87,1000,1000,0,1,,0
2010,University of Glasgow (Terrier Team),uogTrA40n,88,1000,1000,0,1,,0
2010,University of Glasgow (Terrier Team),uogTrA40n,89,1000,1000,0,1,,0
2010,University of Glasgow (Terrier Team),uogTrA40n,90,1000,998,2,1.001001001001,2,1.11041640480141e-36
2010,University of Glasgow (Terrier Team),uogTrA40n,91,1000,1000,0,1,,0
2010,University of Glasgow (Terrier Team),uogTrA40n,92,1000,994,6,1.00300902708124,2,0.00894925525239024
2010,University of Glasgow (Terrier Team),uogTrA40n,93,1000,998,2,1.001001001001,2,4.51397227166437e-27
2010,University of Glasgow (Terrier Team),uogTrA40n,94,1000,972,28,1.01522842639594,2.15384615384615,8.53084871476942e-13
2010,University of Glasgow (Terrier Team),uogTrA40n,95,1000,1000,0,1,,0
2010,University of Glasgow (Terrier Team),uogTrA40n,96,1000,1000,0,1,,0
2010,University of Glasgow (Terrier Team),uogTrA40n,97,1000,1000,0,1,,0
2010,University of Glasgow (Terrier Team),uogTrA40n,98,1000,971,29,1.01522842639594,2.07142857142857,4.03104295386502e-29
2010,University of Glasgow (Terrier Team),uogTrA40n,99,1000,961,39,1.02354145342886,2.4375,0.139380420844669
2010,University of Glasgow (Terrier Team),uogTrA40n,100,1000,1000,0,1,,0
2010,University of Glasgow (Terrier Team),uogTrA42,51,1000,1000,0,1,,0
2010,University of Glasgow (Terrier Team),uogTrA42,52,1000,1000,0,1,,0
2010,University of Glasgow (Terrier Team),uogTrA42,53,1000,1000,0,1,,0
2010,University of Glasgow (Terrier Team),uogTrA42,54,1000,1000,0,1,,0
2010,University of Glasgow (Terrier Team),uogTrA42,55,1000,1000,0,1,,0
2010,University of Glasgow (Terrier Team),uogTrA42,56,1000,1000,0,1,,0
2010,University of Glasgow (Terrier Team),uogTrA42,57,1000,1000,0,1,,0
2010,University of Glasgow (Terrier Team),uogTrA42,58,1000,1000,0,1,,0
2010,University of Glasgow (Terrier Team),uogTrA42,59,1000,1000,0,1,,0
2010,University of Glasgow (Terrier Team),uogTrA42,60,1000,1000,0,1,,0
2010,University of Glasgow (Terrier Team),uogTrA42,61,1000,1000,0,1,,0
2010,University of Glasgow (Terrier Team),uogTrA42,62,1000,1000,0,1,,0
2010,University of Glasgow (Terrier Team),uogTrA42,63,1000,1000,0,1,,0
2010,University of Glasgow (Terrier Team),uogTrA42,64,1000,1000,0,1,,0
2010,University of Glasgow (Terrier Team),uogTrA42,65,1000,1000,0,1,,0
2010,University of Glasgow (Terrier Team),uogTrA42,66,1000,1000,0,1,,0
2010,University of Glasgow (Terrier Team),uogTrA42,67,1000,1000,0,1,,0
2010,University of Glasgow (Terrier Team),uogTrA42,68,1000,1000,0,1,,0
2010,University of Glasgow (Terrier Team),uogTrA42,69,1000,1000,0,1,,0
2010,University of Glasgow (Terrier Team),uogTrA42,70,1000,1000,0,1,,0
2010,University of Glasgow (Terrier Team),uogTrA42,71,1000,1000,0,1,,0
2010,University of Glasgow (Terrier Team),uogTrA42,72,1000,1000,0,1,,0
2010,University of Glasgow (Terrier Team),uogTrA42,73,1000,1000,0,1,,0
2010,University of Glasgow (Terrier Team),uogTrA42,74,1000,1000,0,1,,0
2010,University of Glasgow (Terrier Team),uogTrA42,75,1000,1000,0,1,,0
2010,University of Glasgow (Terrier Team),uogTrA42,76,1000,1000,0,1,,0
2010,University of Glasgow (Terrier Team),uogTrA42,77,1000,1000,0,1,,0
2010,University of Glasgow (Terrier Team),uogTrA42,78,1000,1000,0,1,,0
2010,University of Glasgow (Terrier Team),uogTrA42,79,1000,998,2,1.001001001001,2,1.74160378693573e-41
2010,University of Glasgow (Terrier Team),uogTrA42,80,1000,998,2,1.001001001001,2,3.5384923856521e-36
2010,University of Glasgow (Terrier Team),uogTrA42,81,1000,1000,0,1,,0
2010,University of Glasgow (Terrier Team),uogTrA42,82,1000,1000,0,1,,0
2010,University of Glasgow (Terrier Team),uogTrA42,83,1000,996,4,1.00200400801603,2,9.06037770491436e-44
2010,University of Glasgow (Terrier Team),uogTrA42,84,1000,1000,0,1,,0
2010,University of Glasgow (Terrier Team),uogTrA42,85,1000,1000,0,1,,0
2010,University of Glasgow (Terrier Team),uogTrA42,86,1000,1000,0,1,,0
2010,University of Glasgow (Terrier Team),uogTrA42,87,1000,1000,0,1,,0
2010,University of Glasgow (Terrier Team),uogTrA42,88,1000,1000,0,1,,0
2010,University of Glasgow (Terrier Team),uogTrA42,89,1000,1000,0,1,,0
2010,University of Glasgow (Terrier Team),uogTrA42,90,1000,1000,0,1,,0
2010,University of Glasgow (Terrier Team),uogTrA42,91,1000,1000,0,1,,0
2010,University of Glasgow (Terrier Team),uogTrA42,92,1000,1000,0,1,,0
2010,University of Glasgow (Terrier Team),uogTrA42,93,1000,998,2,1.001001001001,2,1.40362102785549e-07
2010,University of Glasgow (Terrier Team),uogTrA42,94,1000,1000,0,1,,0
2010,University of Glasgow (Terrier Team),uogTrA42,95,1000,1000,0,1,,0
2010,University of Glasgow (Terrier Team),uogTrA42,96,1000,1000,0,1,,0
2010,University of Glasgow (Terrier Team),uogTrA42,97,1000,1000,0,1,,0
2010,University of Glasgow (Terrier Team),uogTrA42,98,1000,1000,0,1,,0
2010,University of Glasgow (Terrier Team),uogTrA42,99,1000,1000,0,1,,0
2010,University of Glasgow (Terrier Team),uogTrA42,100,1000,1000,0,1,,0
2010,University of Glasgow (Terrier Team),uogTrB67,51,1000,998,2,1.001001001001,2,2.1924073299035e-26
2010,University of Glasgow (Terrier Team),uogTrB67,52,1000,1000,0,1,,0
2010,University of Glasgow (Terrier Team),uogTrB67,53,1000,1000,0,1,,0
2010,University of Glasgow (Terrier Team),uogTrB67,54,1000,1000,0,1,,0
2010,University of Glasgow (Terrier Team),uogTrB67,55,1000,1000,0,1,,0
2010,University of Glasgow (Terrier Team),uogTrB67,56,1000,1000,0,1,,0
2010,University of Glasgow (Terrier Team),uogTrB67,57,1000,1000,0,1,,0
2010,University of Glasgow (Terrier Team),uogTrB67,58,1000,1000,0,1,,0
2010,University of Glasgow (Terrier Team),uogTrB67,59,1000,1000,0,1,,0
2010,University of Glasgow (Terrier Team),uogTrB67,60,1000,1000,0,1,,0
2010,University of Glasgow (Terrier Team),uogTrB67,61,1000,1000,0,1,,0
2010,University of Glasgow (Terrier Team),uogTrB67,62,1000,1000,0,1,,0
2010,University of Glasgow (Terrier Team),uogTrB67,63,1000,1000,0,1,,0
2010,University of Glasgow (Terrier Team),uogTrB67,64,1000,1000,0,1,,0
2010,University of Glasgow (Terrier Team),uogTrB67,65,1000,1000,0,1,,0
2010,University of Glasgow (Terrier Team),uogTrB67,66,1000,998,2,1.001001001001,2,1.0551324477833e-05
2010,University of Glasgow (Terrier Team),uogTrB67,67,1000,1000,0,1,,0
2010,University of Glasgow (Terrier Team),uogTrB67,68,1000,1000,0,1,,0
2010,University of Glasgow (Terrier Team),uogTrB67,69,1000,1000,0,1,,0
2010,University of Glasgow (Terrier Team),uogTrB67,70,1000,1000,0,1,,0
2010,University of Glasgow (Terrier Team),uogTrB67,71,1000,1000,0,1,,0
2010,University of Glasgow (Terrier Team),uogTrB67,72,1000,1000,0,1,,0
2010,University of Glasgow (Terrier Team),uogTrB67,73,1000,1000,0,1,,0
2010,University of Glasgow (Terrier Team),uogTrB67,74,1000,1000,0,1,,0
2010,University of Glasgow (Terrier Team),uogTrB67,75,1000,1000,0,1,,0
2010,University of Glasgow (Terrier Team),uogTrB67,76,1000,1000,0,1,,0
2010,University of Glasgow (Terrier Team),uogTrB67,77,1000,1000,0,1,,0
2010,University of Glasgow (Terrier Team),uogTrB67,78,1000,1000,0,1,,0
2010,University of Glasgow (Terrier Team),uogTrB67,79,1000,1000,0,1,,0
2010,University of Glasgow (Terrier Team),uogTrB67,80,1000,1000,0,1,,0
2010,University of Glasgow (Terrier Team),uogTrB67,81,1000,998,2,1.001001001001,2,9.1334673465143e-36
2010,University of Glasgow (Terrier Team),uogTrB67,82,1000,1000,0,1,,0
2010,University of Glasgow (Terrier Team),uogTrB67,83,1000,1000,0,1,,0
2010,University of Glasgow (Terrier Team),uogTrB67,84,1000,998,2,1.001001001001,2,5.6473226960167e-33
2010,University of Glasgow (Terrier Team),uogTrB67,85,1000,1000,0,1,,0
2010,University of Glasgow (Terrier Team),uogTrB67,86,1000,1000,0,1,,0
2010,University of Glasgow (Terrier Team),uogTrB67,87,1000,1000,0,1,,0
2010,University of Glasgow (Terrier Team),uogTrB67,88,1000,1000,0,1,,0
2010,University of Glasgow (Terrier Team),uogTrB67,89,1000,1000,0,1,,0
2010,University of Glasgow (Terrier Team),uogTrB67,90,1000,1000,0,1,,0
2010,University of Glasgow (Terrier Team),uogTrB67,91,1000,1000,0,1,,0
2010,University of Glasgow (Terrier Team),uogTrB67,92,1000,1000,0,1,,0
2010,University of Glasgow (Terrier Team),uogTrB67,93,1000,1000,0,1,,0
2010,University of Glasgow (Terrier Team),uogTrB67,94,1000,998,2,1.001001001001,2,2.961617207439e-27
2010,University of Glasgow (Terrier Team),uogTrB67,95,1000,991,9,1.00502512562814,2.25,1.46435797064374e-35
2010,University of Glasgow (Terrier Team),uogTrB67,96,1000,998,2,1.001001001001,2,9.49619203004968e-06
2010,University of Glasgow (Terrier Team),uogTrB67,97,1000,1000,0,1,,0
2010,University of Glasgow (Terrier Team),uogTrB67,98,1000,1000,0,1,,0
2010,University of Glasgow (Terrier Team),uogTrB67,99,1000,1000,0,1,,0
2010,University of Glasgow (Terrier Team),uogTrB67,100,1000,1000,0,1,,0
2010,University of Glasgow (Terrier Team),uogTrB67LTS,51,1000,998,2,1.001001001001,2,2.1924073299035e-26
2010,University of Glasgow (Terrier Team),uogTrB67LTS,52,1000,1000,0,1,,0
2010,University of Glasgow (Terrier Team),uogTrB67LTS,53,1000,1000,0,1,,0
2010,University of Glasgow (Terrier Team),uogTrB67LTS,54,1000,1000,0,1,,0
2010,University of Glasgow (Terrier Team),uogTrB67LTS,55,1000,1000,0,1,,0
2010,University of Glasgow (Terrier Team),uogTrB67LTS,56,1000,1000,0,1,,0
2010,University of Glasgow (Terrier Team),uogTrB67LTS,57,1000,1000,0,1,,0
2010,University of Glasgow (Terrier Team),uogTrB67LTS,58,1000,1000,0,1,,0
2010,University of Glasgow (Terrier Team),uogTrB67LTS,59,1000,1000,0,1,,0
2010,University of Glasgow (Terrier Team),uogTrB67LTS,60,1000,1000,0,1,,0
2010,University of Glasgow (Terrier Team),uogTrB67LTS,61,1000,1000,0,1,,0
2010,University of Glasgow (Terrier Team),uogTrB67LTS,62,1000,1000,0,1,,0
2010,University of Glasgow (Terrier Team),uogTrB67LTS,63,1000,1000,0,1,,0
2010,University of Glasgow (Terrier Team),uogTrB67LTS,64,1000,1000,0,1,,0
2010,University of Glasgow (Terrier Team),uogTrB67LTS,65,1000,1000,0,1,,0
2010,University of Glasgow (Terrier Team),uogTrB67LTS,66,1000,1000,0,1,,0
2010,University of Glasgow (Terrier Team),uogTrB67LTS,67,1000,1000,0,1,,0
2010,University of Glasgow (Terrier Team),uogTrB67LTS,68,1000,1000,0,1,,0
2010,University of Glasgow (Terrier Team),uogTrB67LTS,69,1000,1000,0,1,,0
2010,University of Glasgow (Terrier Team),uogTrB67LTS,70,1000,1000,0,1,,0
2010,University of Glasgow (Terrier Team),uogTrB67LTS,71,1000,1000,0,1,,0
2010,University of Glasgow (Terrier Team),uogTrB67LTS,72,1000,1000,0,1,,0
2010,University of Glasgow (Terrier Team),uogTrB67LTS,73,1000,1000,0,1,,0
2010,University of Glasgow (Terrier Team),uogTrB67LTS,74,1000,1000,0,1,,0
2010,University of Glasgow (Terrier Team),uogTrB67LTS,75,1000,1000,0,1,,0
2010,University of Glasgow (Terrier Team),uogTrB67LTS,76,1000,1000,0,1,,0
2010,University of Glasgow (Terrier Team),uogTrB67LTS,77,1000,1000,0,1,,0
2010,University of Glasgow (Terrier Team),uogTrB67LTS,78,1000,1000,0,1,,0
2010,University of Glasgow (Terrier Team),uogTrB67LTS,79,1000,1000,0,1,,0
2010,University of Glasgow (Terrier Team),uogTrB67LTS,80,1000,1000,0,1,,0
2010,University of Glasgow (Terrier Team),uogTrB67LTS,81,1000,998,2,1.001001001001,2,9.1334673465143e-36
2010,University of Glasgow (Terrier Team),uogTrB67LTS,82,1000,1000,0,1,,0
2010,University of Glasgow (Terrier Team),uogTrB67LTS,83,1000,1000,0,1,,0
2010,University of Glasgow (Terrier Team),uogTrB67LTS,84,1000,998,2,1.001001001001,2,5.6473226960167e-33
2010,University of Glasgow (Terrier Team),uogTrB67LTS,85,1000,1000,0,1,,0
2010,University of Glasgow (Terrier Team),uogTrB67LTS,86,1000,1000,0,1,,0
2010,University of Glasgow (Terrier Team),uogTrB67LTS,87,1000,1000,0,1,,0
2010,University of Glasgow (Terrier Team),uogTrB67LTS,88,1000,1000,0,1,,0
2010,University of Glasgow (Terrier Team),uogTrB67LTS,89,1000,1000,0,1,,0
2010,University of Glasgow (Terrier Team),uogTrB67LTS,90,1000,1000,0,1,,0
2010,University of Glasgow (Terrier Team),uogTrB67LTS,91,1000,1000,0,1,,0
2010,University of Glasgow (Terrier Team),uogTrB67LTS,92,1000,1000,0,1,,0
2010,University of Glasgow (Terrier Team),uogTrB67LTS,93,1000,1000,0,1,,0
2010,University of Glasgow (Terrier Team),uogTrB67LTS,94,1000,998,2,1.001001001001,2,3.51348170280073e-09
2010,University of Glasgow (Terrier Team),uogTrB67LTS,95,1000,991,9,1.00502512562814,2.25,1.46435797064374e-35
2010,University of Glasgow (Terrier Team),uogTrB67LTS,96,1000,998,2,1.001001001001,2,9.49619203004968e-06
2010,University of Glasgow (Terrier Team),uogTrB67LTS,97,1000,1000,0,1,,0
2010,University of Glasgow (Terrier Team),uogTrB67LTS,98,1000,1000,0,1,,0
2010,University of Glasgow (Terrier Team),uogTrB67LTS,99,1000,1000,0,1,,0
2010,University of Glasgow (Terrier Team),uogTrB67LTS,100,1000,1000,0,1,,0
2010,University of Twente,utwente3,51,1000,827,173,1.11982082866741,2.62121212121212,0.00145749447768407
2010,University of Twente,utwente3,52,1000,712,288,1.21506682867558,2.59459459459459,1.25715566456116e-11
2010,University of Twente,utwente3,53,1000,772,228,1.17785630153121,2.96103896103896,0.0128698920721652
2010,University of Twente,utwente3,54,1000,872,128,1.09170305676856,2.90909090909091,3.4484097161536e-05
2010,University of Twente,utwente3,55,1000,972,28,1.01419878296146,2,0.000642470413681435
2010,University of Twente,utwente3,56,1000,670,330,1.33868808567604,4.28571428571429,0.0664094088964193
2010,University of Twente,utwente3,57,1000,462,538,1.68067226890756,4.04511278195489,0.310211798550231
2010,University of Twente,utwente3,58,1000,914,86,1.05485232067511,2.52941176470588,2.12252377396634e-10
2010,University of Twente,utwente3,59,1000,758,242,1.20918984280532,3.50724637681159,0.0830072004644261
2010,University of Twente,utwente3,60,1000,809,191,1.12866817155756,2.48051948051948,0.000421521320245814
2010,University of Twente,utwente3,61,1000,868,132,1.10619469026549,3.66666666666667,0.0016621589211503
2010,University of Twente,utwente3,62,1000,701,299,1.24069478908189,2.84761904761905,0.0130620990174407
2010,University of Twente,utwente3,63,1000,889,111,1.06157112526539,2.09433962264151,3.21235493724679e-08
2010,University of Twente,utwente3,64,1000,740,260,1.19331742243437,2.6530612244898,0.0737966449248376
2010,University of Twente,utwente3,65,1000,629,371,1.29032258064516,2.54109589041096,3.76530407085106e-06
2010,University of Twente,utwente3,66,1000,433,567,1.78571428571429,4.46456692913386,1.85543975048364e-05
2010,University of Twente,utwente3,67,1000,888,112,1.085776330076,3.39393939393939,0.00204905834172602
2010,University of Twente,utwente3,68,1000,866,134,1.09289617486339,2.73469387755102,5.92432100975311e-07
2010,University of Twente,utwente3,69,1000,645,355,1.3869625520111,4.67105263157895,0.0053493775654573
2010,University of Twente,utwente3,70,1000,780,220,1.16686114352392,2.85714285714286,0.00796125931660205
2010,University of Twente,utwente3,71,1000,917,83,1.05596620908131,2.76666666666667,0.00652408552980546
2010,University of Twente,utwente3,72,1000,979,21,1.01112234580384,2.1,0.0136400617661452
2010,University of Twente,utwente3,73,1000,730,270,1.22100122100122,3.03370786516854,7.55790553668282e-08
2010,University of Twente,utwente3,74,1000,859,141,1.08695652173913,2.31147540983607,3.77214388156862e-05
2010,University of Twente,utwente3,75,1000,804,196,1.12739571589628,2.36144578313253,1.0146368107581e-12
2010,University of Twente,utwente3,76,1000,948,52,1.03305785123967,2.6,0.000266936913442616
2010,University of Twente,utwente3,77,1000,756,244,1.17233294255569,2.51546391752577,0.00120957897673353
2010,University of Twente,utwente3,78,1000,823,177,1.13378684807256,3,3.22647871705406e-08
2010,University of Twente,utwente3,79,1000,897,103,1.06382978723404,2.3953488372093,8.14525618302681e-05
2010,University of Twente,utwente3,80,1000,496,504,1.6025641025641,3.9375,0.288305643437013
2010,University of Twente,utwente3,81,1000,946,54,1.02986611740474,2.16,1.48941564541487e-10
2010,University of Twente,utwente3,82,1000,850,150,1.09529025191676,2.38095238095238,2.55284464368149e-10
2010,University of Twente,utwente3,83,1000,927,73,1.0515247108307,3.04166666666667,0.00551289683764128
2010,University of Twente,utwente3,84,1000,950,50,1.02880658436214,2.27272727272727,0.00183522379442022
2010,University of Twente,utwente3,85,1000,435,565,1.81159420289855,4.82905982905983,0.137345613152305
2010,University of Twente,utwente3,86,1000,968,32,1.0183299389002,2.28571428571429,0.015865817179291
2010,University of Twente,utwente3,87,1000,444,556,1.84162062615101,5.61616161616162,0.141754576249923
2010,University of Twente,utwente3,88,1000,865,135,1.09051254089422,2.59615384615385,0.028367619659961
2010,University of Twente,utwente3,89,1000,822,178,1.12612612612613,2.6969696969697,0.000111630655601201
2010,University of Twente,utwente3,90,1000,517,483,1.53139356814701,3.55147058823529,0.00157996164250592
2010,University of Twente,utwente3,91,1000,905,95,1.05932203389831,2.43589743589744,0.00068029744099024
2010,University of Twente,utwente3,92,1000,968,32,1.0183299389002,2.28571428571429,1.38317526537151e-15
2010,University of Twente,utwente3,93,1000,727,273,1.19760479041916,2.52777777777778,0.0142161478267677
2010,University of Twente,utwente3,94,1000,927,73,1.04058272632674,2.14705882352941,1.29994777243065e-12
2010,University of Twente,utwente3,95,1000,806,194,1.14810562571757,2.98461538461538,0.000298307721443135
2010,University of Twente,utwente3,96,1000,962,38,1.02249488752556,2.375,1.30304703524638e-08
2010,University of Twente,utwente3,97,1000,959,41,1.02249488752556,2.15789473684211,1.63704913460959e-18
2010,University of Twente,utwente3,98,1000,897,103,1.07066381156317,2.78378378378378,0.0736100066034455
2010,University of Twente,utwente3,99,1000,888,112,1.07296137339056,2.54545454545455,0.00448854367678417
2010,University of Twente,utwente3,100,1000,540,460,1.53374233128834,4.10714285714286,0.00013200107528018
2010,University of Twente,utwente4,51,1000,755,245,1.18906064209275,2.84883720930233,0.0017825882892587
2010,University of Twente,utwente4,52,1000,725,275,1.18764845605701,2.35042735042735,1.06543167923276e-11
2010,University of Twente,utwente4,53,1000,496,504,1.6750418760469,4.99009900990099,0.0125425796415691
2010,University of Twente,utwente4,54,1000,900,100,1.06723585912487,2.7027027027027,1.04191182165891e-07
2010,University of Twente,utwente4,55,1000,976,24,1.01214574898785,2,0.00057822337231329
2010,University of Twente,utwente4,56,1000,654,346,1.3550135501355,4.11904761904762,0.0301032379112205
2010,University of Twente,utwente4,57,1000,496,504,1.60513643659711,3.96850393700787,0.305919556999722
2010,University of Twente,utwente4,58,1000,928,72,1.04602510460251,2.57142857142857,3.81912417860417e-11
2010,University of Twente,utwente4,59,1000,744,256,1.25628140703518,4.92307692307692,0.0842592046220185
2010,University of Twente,utwente4,60,1000,833,167,1.10253583241455,2.25675675675676,0.000421520935623038
2010,University of Twente,utwente4,61,1000,884,116,1.09409190371991,3.86666666666667,0.00166215916529689
2010,University of Twente,utwente4,62,1000,734,266,1.20772946859903,2.82978723404255,0.00103473831543208
2010,University of Twente,utwente4,63,1000,879,121,1.06723585912487,2.08620689655172,3.78659509882814e-11
2010,University of Twente,utwente4,64,1000,765,235,1.16414435389988,2.5,3.21555386474444e-05
2010,University of Twente,utwente4,65,1000,665,335,1.25628140703518,2.55725190839695,0.0136437954113828
2010,University of Twente,utwente4,66,1000,530,470,1.57977883096367,4.56310679611651,4.32659115068004e-06
2010,University of Twente,utwente4,67,1000,808,192,1.16144018583043,3.62264150943396,9.56025208674271e-05
2010,University of Twente,utwente4,68,1000,881,119,1.07874865156419,2.58695652173913,5.92207436952473e-07
2010,University of Twente,utwente4,69,1000,434,566,1.84162062615101,5.19266055045872,0.00917905304040636
2010,University of Twente,utwente4,70,1000,836,164,1.10864745011086,2.48484848484849,0.005649014749734
2010,University of Twente,utwente4,71,1000,840,160,1.11731843575419,2.90909090909091,0.00819449975037041
2010,University of Twente,utwente4,72,1000,988,12,1.00603621730382,2,7.40775486693666e-36
2010,University of Twente,utwente4,73,1000,766,234,1.16959064327485,2.62921348314607,1.64488346362693e-09
2010,University of Twente,utwente4,74,1000,892,108,1.06496272630458,2.29787234042553,3.77214388542371e-05
2010,University of Twente,utwente4,75,1000,824,176,1.10864745011086,2.25641025641026,8.99128457937463e-12
2010,University of Twente,utwente4,76,1000,907,93,1.06609808102345,3,0.00208288010045107
2010,University of Twente,utwente4,77,1000,794,206,1.13765642775882,2.42352941176471,4.51863054270527e-08
2010,University of Twente,utwente4,78,1000,878,122,1.09289617486339,3.2972972972973,7.07404529164277e-12
2010,University of Twente,utwente4,79,1000,900,100,1.06157112526539,2.38095238095238,1.44765434387235e-05
2010,University of Twente,utwente4,80,1000,501,499,1.66112956810631,4.94059405940594,0.248492143063868
2010,University of Twente,utwente4,81,1000,975,25,1.01317122593718,2.08333333333333,1.0683565459832e-22
2010,University of Twente,utwente4,82,1000,880,120,1.07066381156317,2.22222222222222,1.25825212479436e-08
2010,University of Twente,utwente4,83,1000,943,57,1.03734439834025,2.71428571428571,0.00164221062256483
2010,University of Twente,utwente4,84,1000,941,59,1.03199174406605,2.10714285714286,0.0176214393407258
2010,University of Twente,utwente4,85,1000,463,537,1.70357751277683,4.33064516129032,0.152503124199863
2010,University of Twente,utwente4,86,1000,977,23,1.01317122593718,2.3,0.0171519474349537
2010,University of Twente,utwente4,87,1000,497,503,1.70357751277683,5.58888888888889,0.179054492467564
2010,University of Twente,utwente4,88,1000,874,126,1.08342361863489,2.57142857142857,0.00412494462663123
2010,University of Twente,utwente4,89,1000,833,167,1.11234705228031,2.53030303030303,0.000124000211492477
2010,University of Twente,utwente4,90,1000,536,464,1.4792899408284,3.31428571428571,0.00147891168372956
2010,University of Twente,utwente4,91,1000,888,112,1.08108108108108,3.02702702702703,0.0832181246876861
2010,University of Twente,utwente4,92,1000,975,25,1.01419878296146,2.27272727272727,8.19189785995363e-16
2010,University of Twente,utwente4,93,1000,761,239,1.16550116550117,2.4639175257732,0.0142327708895695
2010,University of Twente,utwente4,94,1000,935,65,1.03626943005181,2.16666666666667,3.66514846863337e-22
2010,University of Twente,utwente4,95,1000,812,188,1.13250283125708,2.64788732394366,1.23983433212129e-05
2010,University of Twente,utwente4,96,1000,975,25,1.01419878296146,2.27272727272727,1.1701172795156e-08
2010,University of Twente,utwente4,97,1000,967,33,1.0183299389002,2.2,1.81344418199513e-18
2010,University of Twente,utwente4,98,1000,904,96,1.06496272630458,2.74285714285714,0.0662490059430882
2010,University of Twente,utwente4,99,1000,896,104,1.06723585912487,2.53658536585366,0.00480942493516817
2010,University of Twente,utwente4,100,1000,420,580,1.7825311942959,4.11347517730496,0.00197075030914693
2010,University of Twente,utwente4SF,51,1000,746,254,1.21951219512195,3.43243243243243,0.0483095140730968
2010,University of Twente,utwente4SF,52,1000,520,480,1.53374233128834,3.63636363636364,0.000132627649032671
2010,University of Twente,utwente4SF,53,1000,728,272,1.21359223300971,2.83333333333333,0.196201358379788
2010,University of Twente,utwente4SF,54,1000,813,187,1.13895216400911,2.87692307692308,1.3214310562158e-09
2010,University of Twente,utwente4SF,55,1000,978,22,1.01112234580384,2,0.0122760576642065
2010,University of Twente,utwente4SF,56,1000,783,217,1.15740740740741,2.67901234567901,0.000107283530822403
2010,University of Twente,utwente4SF,57,1000,356,644,2.1505376344086,5.90825688073395,0.449191395682058
2010,University of Twente,utwente4SF,58,1000,846,154,1.08932461873638,2.13888888888889,2.13934024117159e-07
2010,University of Twente,utwente4SF,59,1000,712,288,1.28369704749679,4.29850746268657,0.0947683126480913
2010,University of Twente,utwente4SF,60,1000,780,220,1.14025085518814,2.2680412371134,3.21103828376517e-08
2010,University of Twente,utwente4SF,61,1000,910,90,1.0515247108307,2.19512195121951,0.0229156168037032
2010,University of Twente,utwente4SF,62,1000,548,452,1.49476831091181,3.73553719008264,1.12260704645808e-06
2010,University of Twente,utwente4SF,63,1000,801,199,1.11982082866741,2.16304347826087,1.01138467627663e-07
2010,University of Twente,utwente4SF,64,1000,583,417,1.39664804469274,3.13533834586466,0.00173051323311546
2010,University of Twente,utwente4SF,65,1000,715,285,1.20192307692308,2.43589743589744,0.00086795535793334
2010,University of Twente,utwente4SF,66,1000,754,246,1.22549019607843,3.96774193548387,0.0317504433167321
2010,University of Twente,utwente4SF,67,1000,879,121,1.09289617486339,3.36111111111111,0.00165926958694163
2010,University of Twente,utwente4SF,68,1000,869,131,1.08459869848156,2.47169811320755,4.1037055498804e-06
2010,University of Twente,utwente4SF,69,1000,939,61,1.0351966873706,2.25925925925926,0.0170089417541164
2010,University of Twente,utwente4SF,70,1000,876,124,1.08813928182807,2.88372093023256,0.00528444096264291
2010,University of Twente,utwente4SF,71,1000,931,69,1.04275286757039,2.46428571428571,0.016841694616945
2010,University of Twente,utwente4SF,72,1000,988,12,1.00603621730382,2,5.0312167617675e-20
2010,University of Twente,utwente4SF,73,1000,488,512,1.6260162601626,4.03149606299213,4.96780403417334e-07
2010,University of Twente,utwente4SF,74,1000,813,187,1.11982082866741,2.3375,1.35309825851818e-10
2010,University of Twente,utwente4SF,75,1000,625,375,1.30718954248366,2.67857142857143,6.1446603261486e-08
2010,University of Twente,utwente4SF,76,1000,969,31,1.0183299389002,2.38461538461538,0.00181033855811138
2010,University of Twente,utwente4SF,77,1000,556,444,1.47058823529412,3.58064516129032,0.000805664932249467
2010,University of Twente,utwente4SF,78,1000,649,351,1.29533678756477,2.85365853658537,3.62106445684064e-07
2010,University of Twente,utwente4SF,79,1000,876,124,1.07296137339056,2.21428571428571,2.56450319210443e-08
2010,University of Twente,utwente4SF,80,1000,602,398,1.41643059490085,3.82692307692308,0.0381950864387583
2010,University of Twente,utwente4SF,81,1000,978,22,1.01112234580384,2,4.68971709002968e-11
2010,University of Twente,utwente4SF,82,1000,784,216,1.13636363636364,2.25,4.55599652079253e-06
2010,University of Twente,utwente4SF,83,1000,961,39,1.02249488752556,2.29411764705882,0.0122760555928825
2010,University of Twente,utwente4SF,84,1000,961,39,1.02564102564103,2.78571428571429,0.00677290315519699
2010,University of Twente,utwente4SF,85,1000,597,403,1.4367816091954,4.07070707070707,7.09047404187942e-06
2010,University of Twente,utwente4SF,86,1000,974,26,1.01522842639594,2.36363636363636,0.156764142608202
2010,University of Twente,utwente4SF,87,1000,651,349,1.31233595800525,3.14414414414414,0.0158906292639685
2010,University of Twente,utwente4SF,88,1000,765,235,1.17647058823529,2.76470588235294,0.0748871181864783
2010,University of Twente,utwente4SF,89,1000,754,246,1.17096018735363,2.46,0.00494604648433512
2010,University of Twente,utwente4SF,90,987,293,694,2.37259615384615,5.64227642276423,0.0565132531929297
2010,University of Twente,utwente4SF,91,1000,912,88,1.05374077976818,2.37837837837838,0.0434659056645089
2010,University of Twente,utwente4SF,92,1000,980,20,1.01010101010101,2,4.17170795389344e-08
2010,University of Twente,utwente4SF,93,1000,562,438,1.4265335235378,3.15107913669065,0.0479062205606075
2010,University of Twente,utwente4SF,94,1000,872,128,1.07642626480086,2.24561403508772,3.17635600419588e-08
2010,University of Twente,utwente4SF,95,650,548,102,1.11683848797251,3,0.0372505538715941
2010,University of Twente,utwente4SF,96,1000,961,39,1.02249488752556,2.29411764705882,3.72821380455172e-12
2010,University of Twente,utwente4SF,97,1000,965,35,1.01936799184506,2.1875,5.22655933908769e-09
2010,University of Twente,utwente4SF,98,1000,929,71,1.03950103950104,2.15151515151515,0.112256435167844
2010,University of Twente,utwente4SF,99,1000,952,48,1.02880658436214,2.4,7.1237812621585e-11
2010,University of Twente,utwente4SF,100,1000,679,321,1.31061598951507,3.82142857142857,0.000908364137984222
2010,York University,york10wA1,51,1000,838,162,1.09529025191676,2.16,0.0506579536457648
2010,York University,york10wA1,52,1000,744,256,1.16550116550117,2.24561403508772,0.318235745785925
2010,York University,york10wA1,53,1000,812,188,1.11856823266219,2.29268292682927,0.0304882472452669
2010,York University,york10wA1,54,1000,785,215,1.14942528735632,2.52941176470588,0.0261777007206509
2010,York University,york10wA1,55,1000,729,271,1.20627261761158,2.71,0.255891397402673
2010,York University,york10wA1,56,1000,783,217,1.1441647597254,2.38461538461538,0.0671723246705088
2010,York University,york10wA1,57,1000,828,172,1.11111111111111,2.38888888888889,0.000363396349616488
2010,York University,york10wA1,58,1000,789,211,1.13895216400911,2.37078651685393,0.000125085769750582
2010,York University,york10wA1,59,1000,859,141,1.09170305676856,2.47368421052632,0.293017647923272
2010,York University,york10wA1,60,1000,770,230,1.13765642775882,2.11009174311927,0.0672199670893469
2010,York University,york10wA1,61,1000,742,258,1.18483412322275,2.52941176470588,0.0609400384062692
2010,York University,york10wA1,62,1000,838,162,1.10741971207087,2.49230769230769,0.0580198600589555
2010,York University,york10wA1,63,1000,817,183,1.11856823266219,2.37662337662338,0.000193994842889759
2010,York University,york10wA1,64,1000,748,252,1.17233294255569,2.4,0.0011218688511309
2010,York University,york10wA1,65,1000,774,226,1.15074798619102,2.37894736842105,0.0590565101979776
2010,York University,york10wA1,66,1000,854,146,1.09289617486339,2.39344262295082,0.184429120594622
2010,York University,york10wA1,67,1000,787,213,1.15874855156431,2.80263157894737,0.305999728011136
2010,York University,york10wA1,68,1000,839,161,1.09649122807018,2.20547945205479,0.0159257017906342
2010,York University,york10wA1,69,1000,897,103,1.05708245243129,2.10204081632653,0.076568350427547
2010,York University,york10wA1,70,1000,888,112,1.06723585912487,2.28571428571429,0.0732864745878151
2010,York University,york10wA1,71,1000,716,284,1.25786163522013,3.59493670886076,0.0908916449525676
2010,York University,york10wA1,72,1000,711,289,1.31406044678055,5.78,0.0130777555678119
2010,York University,york10wA1,73,1000,874,126,1.07411385606874,2.21052631578947,0.000393360073511584
2010,York University,york10wA1,74,1000,795,205,1.12739571589628,2.22826086956522,0.226930049191369
2010,York University,york10wA1,75,1000,743,257,1.17096018735363,2.31531531531532,0.110849999761736
2010,York University,york10wA1,76,1000,876,124,1.07181136120043,2.17543859649123,0.171263398673506
2010,York University,york10wA1,77,1000,827,173,1.10619469026549,2.24675324675325,0.0338383279190955
2010,York University,york10wA1,78,1000,945,55,1.02986611740474,2.11538461538462,0.00404533870717905
2010,York University,york10wA1,79,1000,821,179,1.11111111111111,2.26582278481013,0.00483416428326349
2010,York University,york10wA1,80,1000,972,28,1.01522842639594,2.15384615384615,0.000107144965951532
2010,York University,york10wA1,81,1000,783,217,1.15207373271889,2.55294117647059,0.115139231118798
2010,York University,york10wA1,82,1000,821,179,1.11982082866741,2.48611111111111,0.00263834700225328
2010,York University,york10wA1,83,1000,746,254,1.23304562268804,3.90769230769231,0.0355873354177064
2010,York University,york10wA1,84,1000,808,192,1.12485939257593,2.37037037037037,0.333502232162411
2010,York University,york10wA1,85,1000,806,194,1.12612612612613,2.36585365853659,0.324499252085093
2010,York University,york10wA1,86,1000,857,143,1.085776330076,2.234375,0.344303800836302
2010,York University,york10wA1,87,1000,867,133,1.085776330076,2.46296296296296,0.0112320166783938
2010,York University,york10wA1,88,1000,825,175,1.11482720178372,2.43055555555556,0.23929075688024
2010,York University,york10wA1,89,1000,828,172,1.10132158590308,2.15,0.0783627764821215
2010,York University,york10wA1,90,1000,700,300,1.20918984280532,2.36220472440945,0.0607830843890836
2010,York University,york10wA1,91,1000,911,89,1.06269925611052,2.96666666666667,5.20126814773492e-05
2010,York University,york10wA1,92,1000,852,148,1.08932461873638,2.24242424242424,0.000815108228495491
2010,York University,york10wA1,93,1000,771,229,1.1441647597254,2.22330097087379,0.163142365454397
2010,York University,york10wA1,94,1000,795,205,1.13507377979569,2.38372093023256,0.00204885327811418
2010,York University,york10wA1,95,1000,923,77,1.04384133611691,2.2,0.260862835380105
2010,York University,york10wA1,96,1000,808,192,1.11731843575419,2.20689655172414,0.113871668853928
2010,York University,york10wA1,97,1000,927,73,1.03950103950104,2.08571428571429,0.00407726389955221
2010,York University,york10wA1,98,1000,722,278,1.30039011703511,5.91489361702128,0.00376052879463242
2010,York University,york10wA1,99,1000,861,139,1.10253583241455,3.02173913043478,0.100196788368669
2010,York University,york10wA1,100,1000,831,169,1.11982082866741,2.7258064516129,0.349650840411981
2010,York University,york10wA2,51,1000,820,180,1.11234705228031,2.27848101265823,0.0581550224427145
2010,York University,york10wA2,52,1000,761,239,1.16144018583043,2.39,0.0280821103763388
2010,York University,york10wA2,53,1000,827,173,1.11358574610245,2.43661971830986,0.29765482419232
2010,York University,york10wA2,54,1000,726,274,1.20048019207683,2.5607476635514,0.000109429586927032
2010,York University,york10wA2,55,1000,702,298,1.23304562268804,2.73394495412844,0.00937684047846768
2010,York University,york10wA2,56,1000,742,258,1.19760479041916,2.7741935483871,0.0197827785432379
2010,York University,york10wA2,57,1000,931,69,1.03734439834025,2.09090909090909,0.00994578992972747
2010,York University,york10wA2,58,1000,785,215,1.14155251141553,2.36263736263736,0.0577876265517557
2010,York University,york10wA2,59,1000,865,135,1.09289617486339,2.7,0.151756099243932
2010,York University,york10wA2,60,1000,810,190,1.11358574610245,2.15909090909091,0.000916843160241064
2010,York University,york10wA2,61,1000,781,219,1.15340253748558,2.54651162790698,0.022317065080221
2010,York University,york10wA2,62,1000,810,190,1.13378684807256,2.63888888888889,0.383172036231765
2010,York University,york10wA2,63,1000,823,177,1.12107623318386,2.56521739130435,0.0711413859715762
2010,York University,york10wA2,64,1000,796,204,1.13250283125708,2.3448275862069,0.0626878310412438
2010,York University,york10wA2,65,1000,794,206,1.13507377979569,2.36781609195402,0.29774517225859
2010,York University,york10wA2,66,1000,852,148,1.10497237569061,2.79245283018868,0.138522200005008
2010,York University,york10wA2,67,1000,804,196,1.14810562571757,2.92537313432836,0.0279857555506399
2010,York University,york10wA2,68,1000,881,119,1.06951871657754,2.2037037037037,2.32598902731282e-05
2010,York University,york10wA2,69,1000,934,66,1.0351966873706,2.0625,0.0442404007373799
2010,York University,york10wA2,70,1000,904,96,1.05708245243129,2.28571428571429,0.11456033546649
2010,York University,york10wA2,71,1000,888,112,1.06496272630458,2.19607843137255,0.000452408750078608
2010,York University,york10wA2,72,1000,807,193,1.14810562571757,3.015625,0.000882448919763448
2010,York University,york10wA2,73,1000,843,157,1.1037527593819,2.49206349206349,0.00914093815009645
2010,York University,york10wA2,74,1000,866,134,1.08225108225108,2.31034482758621,0.153066502863403
2010,York University,york10wA2,75,1000,708,292,1.20627261761158,2.41322314049587,0.13481696122751
2010,York University,york10wA2,76,1000,912,88,1.04931794333683,2.14634146341463,0.000885941006035845
2010,York University,york10wA2,77,1000,825,175,1.10619469026549,2.21518987341772,0.177065732164837
2010,York University,york10wA2,78,1000,948,52,1.03092783505155,2.36363636363636,7.68032469242456e-06
2010,York University,york10wA2,79,1000,803,197,1.12739571589628,2.3452380952381,0.0123478242414695
2010,York University,york10wA2,80,1000,956,44,1.02459016393443,2.2,0.016864094751136
2010,York University,york10wA2,81,1000,744,256,1.21359223300971,3.2,0.136778538614344
2010,York University,york10wA2,82,1000,819,181,1.12612612612613,2.6231884057971,0.00408824206991315
2010,York University,york10wA2,83,1000,761,239,1.22100122100122,4.12068965517241,0.0244284393723852
2010,York University,york10wA2,84,1000,764,236,1.16959064327485,2.59340659340659,0.364009868222433
2010,York University,york10wA2,85,1000,822,178,1.10987791342952,2.25316455696203,0.245534731517258
2010,York University,york10wA2,86,1000,888,112,1.06723585912487,2.28571428571429,0.249064318369254
2010,York University,york10wA2,87,1000,863,137,1.09170305676856,2.58490566037736,1.68075177229974e-16
2010,York University,york10wA2,88,1000,887,113,1.06382978723404,2.13207547169811,0.129116387632078
2010,York University,york10wA2,89,1000,859,141,1.08108108108108,2.13636363636364,0.135019913955451
2010,York University,york10wA2,90,1000,767,233,1.15606936416185,2.37755102040816,0.147470006246267
2010,York University,york10wA2,91,1000,898,102,1.06269925611052,2.37209302325581,0.0142146834894852
2010,York University,york10wA2,92,1000,866,134,1.085776330076,2.43636363636364,8.03964515800765e-05
2010,York University,york10wA2,93,1000,822,178,1.10741971207087,2.19753086419753,0.191705442863258
2010,York University,york10wA2,94,1000,760,240,1.17508813160987,2.63736263736264,0.0508450509870672
2010,York University,york10wA2,95,1000,906,94,1.07296137339056,3.61538461538462,0.20986550392342
2010,York University,york10wA2,96,1000,808,192,1.13122171945701,2.52631578947368,0.18058326676149
2010,York University,york10wA2,97,1000,892,108,1.06609808102345,2.34782608695652,0.00848866202695762
2010,York University,york10wA2,98,1000,679,321,1.23609394313968,2.46923076923077,0.000136475423366768
2010,York University,york10wA2,99,1000,842,158,1.11731843575419,2.9811320754717,0.00091713478018833
2010,York University,york10wA2,100,1000,917,83,1.04602510460251,2.12820512820513,0.141243565788086
2010,York University,york10wA3,51,1000,838,162,1.09529025191676,2.16,0.0344028377305661
2010,York University,york10wA3,52,1000,744,256,1.16550116550117,2.24561403508772,0.318235745785925
2010,York University,york10wA3,53,1000,807,193,1.12359550561798,2.32530120481928,0.0387101949452235
2010,York University,york10wA3,54,1000,769,231,1.16144018583043,2.51086956521739,0.0363338085246036
2010,York University,york10wA3,55,1000,729,271,1.20627261761158,2.71,0.255891397402673
2010,York University,york10wA3,56,1000,785,215,1.1454753722795,2.44318181818182,0.0356550757473451
2010,York University,york10wA3,57,1000,815,185,1.11856823266219,2.34177215189873,0.000162549406337125
2010,York University,york10wA3,58,1000,789,211,1.13895216400911,2.37078651685393,0.000125085769750582
2010,York University,york10wA3,59,1000,850,150,1.09170305676856,2.27272727272727,0.367052812470045
2010,York University,york10wA3,60,1000,770,230,1.13765642775882,2.11009174311927,0.0672199670893469
2010,York University,york10wA3,61,1000,742,258,1.18483412322275,2.52941176470588,0.0609400384062692
2010,York University,york10wA3,62,1000,845,155,1.1037527593819,2.54098360655738,0.122923419734493
2010,York University,york10wA3,63,1000,817,183,1.11856823266219,2.37662337662338,0.000193994842889759
2010,York University,york10wA3,64,1000,748,252,1.17233294255569,2.4,0.0011218688511309
2010,York University,york10wA3,65,1000,787,213,1.14025085518814,2.36666666666667,0.0599755497598356
2010,York University,york10wA3,66,1000,867,133,1.085776330076,2.46296296296296,0.141834082089227
2010,York University,york10wA3,67,1000,777,223,1.16550116550117,2.75308641975309,0.403226470409462
2010,York University,york10wA3,68,1000,839,161,1.09649122807018,2.20547945205479,0.0159257017906342
2010,York University,york10wA3,69,1000,885,115,1.06382978723404,2.09090909090909,0.0214169335326484
2010,York University,york10wA3,70,1000,888,112,1.06723585912487,2.28571428571429,0.0732864745878151
2010,York University,york10wA3,71,1000,850,150,1.09529025191676,2.38095238095238,0.0676491727839113
2010,York University,york10wA3,72,1000,711,289,1.31406044678055,5.78,0.0130777555678119
2010,York University,york10wA3,73,1000,881,119,1.06951871657754,2.2037037037037,0.000357609068792484
2010,York University,york10wA3,74,1000,795,205,1.12739571589628,2.22826086956522,0.226930049191369
2010,York University,york10wA3,75,1000,743,257,1.17096018735363,2.31531531531532,0.110849999761736
2010,York University,york10wA3,76,1000,873,127,1.07296137339056,2.15254237288136,0.171259471496552
2010,York University,york10wA3,77,1000,827,173,1.10619469026549,2.24675324675325,0.0338383279190955
2010,York University,york10wA3,78,1000,945,55,1.02986611740474,2.11538461538462,0.00404533870717905
2010,York University,york10wA3,79,1000,821,179,1.11111111111111,2.26582278481013,0.00483416428326349
2010,York University,york10wA3,80,1000,974,26,1.01419878296146,2.16666666666667,4.61223948236417e-05
2010,York University,york10wA3,81,1000,783,217,1.15207373271889,2.55294117647059,0.115139231118798
2010,York University,york10wA3,82,1000,821,179,1.11982082866741,2.48611111111111,0.00263834700225328
2010,York University,york10wA3,83,1000,746,254,1.23304562268804,3.90769230769231,0.0355873354177064
2010,York University,york10wA3,84,1000,805,195,1.12739571589628,2.37804878048781,0.327253392194217
2010,York University,york10wA3,85,1000,802,198,1.12866817155756,2.35714285714286,0.292500161602542
2010,York University,york10wA3,86,1000,861,139,1.08342361863489,2.24193548387097,0.341155316066308
2010,York University,york10wA3,87,1000,850,150,1.10253583241455,2.63157894736842,0.0560890849838344
2010,York University,york10wA3,88,1000,804,196,1.13507377979569,2.54545454545455,0.18436879157749
2010,York University,york10wA3,89,1000,828,172,1.10132158590308,2.15,0.0783627764821215
2010,York University,york10wA3,90,1000,700,300,1.20918984280532,2.36220472440945,0.0607830843890836
2010,York University,york10wA3,91,1000,916,84,1.06044538706257,3.11111111111111,4.16064490959882e-05
2010,York University,york10wA3,92,1000,852,148,1.08932461873638,2.24242424242424,0.000815108228495491
2010,York University,york10wA3,93,1000,771,229,1.1441647597254,2.22330097087379,0.163142365454397
2010,York University,york10wA3,94,1000,795,205,1.13507377979569,2.38372093023256,0.00204885327811418
2010,York University,york10wA3,95,1000,921,79,1.04493207941484,2.19444444444444,0.260865720664316
2010,York University,york10wA3,96,1000,808,192,1.11731843575419,2.20689655172414,0.113871668853928
2010,York University,york10wA3,97,1000,927,73,1.03950103950104,2.08571428571429,0.00455649999812061
2010,York University,york10wA3,98,1000,722,278,1.30039011703511,5.91489361702128,0.00376052879463242
2010,York University,york10wA3,99,1000,861,139,1.10253583241455,3.02173913043478,0.100196788368669
2010,York University,york10wA3,100,1000,822,178,1.12739571589628,2.73846153846154,0.376665592416596
