year,group,sys,topic,n,n_u,n_t,avg,avg_t
2009,"ICT, Chinese Academy of Sciences",ICTNETADRun3,1,995,903,92,1.05514316012725,2.3
2009,"ICT, Chinese Academy of Sciences",ICTNETADRun3,2,999,973,26,1.01421319796954,2.16666666666667
2009,"ICT, Chinese Academy of Sciences",ICTNETADRun3,3,999,950,49,1.02777777777778,2.22727272727273
2009,"ICT, Chinese Academy of Sciences",ICTNETADRun3,4,996,895,101,1.05844845908608,2.19565217391304
2009,"ICT, Chinese Academy of Sciences",ICTNETADRun3,5,999,923,76,1.04279749478079,2.17142857142857
2009,"ICT, Chinese Academy of Sciences",ICTNETADRun3,6,1000,883,117,1.0752688172043,2.48936170212766
2009,"ICT, Chinese Academy of Sciences",ICTNETADRun3,7,1000,967,33,1.01936799184506,2.35714285714286
2009,"ICT, Chinese Academy of Sciences",ICTNETADRun3,8,998,816,182,1.11259754738016,2.24691358024691
2009,"ICT, Chinese Academy of Sciences",ICTNETADRun3,9,1000,940,60,1.03842159916926,2.60869565217391
2009,"ICT, Chinese Academy of Sciences",ICTNETADRun3,10,1000,953,47,1.02459016393443,2.04347826086957
2009,"ICT, Chinese Academy of Sciences",ICTNETADRun3,11,1000,935,65,1.0351966873706,2.09677419354839
2009,"ICT, Chinese Academy of Sciences",ICTNETADRun3,12,1000,910,90,1.05932203389831,2.64705882352941
2009,"ICT, Chinese Academy of Sciences",ICTNETADRun3,13,1000,726,274,1.20481927710843,2.63461538461538
2009,"ICT, Chinese Academy of Sciences",ICTNETADRun3,14,998,917,81,1.04284221525601,2.025
2009,"ICT, Chinese Academy of Sciences",ICTNETADRun3,15,998,915,83,1.0461215932914,2.12820512820513
2009,"ICT, Chinese Academy of Sciences",ICTNETADRun3,16,999,941,58,1.03095975232198,2.07142857142857
2009,"ICT, Chinese Academy of Sciences",ICTNETADRun3,17,998,955,43,1.02254098360656,2.04761904761905
2009,"ICT, Chinese Academy of Sciences",ICTNETADRun3,18,1000,958,42,1.02145045965271,2
2009,"ICT, Chinese Academy of Sciences",ICTNETADRun3,19,996,903,93,1.05063291139241,2.06666666666667
2009,"ICT, Chinese Academy of Sciences",ICTNETADRun3,20,1000,921,79,1.04275286757039,2.07894736842105
2009,"ICT, Chinese Academy of Sciences",ICTNETADRun3,21,999,928,71,1.04388714733542,2.44827586206897
2009,"ICT, Chinese Academy of Sciences",ICTNETADRun3,22,1000,956,44,1.03199174406605,3.38461538461538
2009,"ICT, Chinese Academy of Sciences",ICTNETADRun3,23,1000,828,172,1.12233445566779,2.73015873015873
2009,"ICT, Chinese Academy of Sciences",ICTNETADRun3,24,998,897,101,1.05832449628844,2.19565217391304
2009,"ICT, Chinese Academy of Sciences",ICTNETADRun3,25,999,830,169,1.10876803551609,2.38028169014085
2009,"ICT, Chinese Academy of Sciences",ICTNETADRun3,26,999,920,79,1.04497907949791,2.19444444444444
2009,"ICT, Chinese Academy of Sciences",ICTNETADRun3,27,998,949,49,1.02780638516993,2.22727272727273
2009,"ICT, Chinese Academy of Sciences",ICTNETADRun3,28,1000,850,150,1.09409190371991,2.34375
2009,"ICT, Chinese Academy of Sciences",ICTNETADRun3,29,1000,950,50,1.03305785123967,2.77777777777778
2009,"ICT, Chinese Academy of Sciences",ICTNETADRun3,30,1000,913,87,1.0482180293501,2.1219512195122
2009,"ICT, Chinese Academy of Sciences",ICTNETADRun3,31,999,866,133,1.09539473684211,2.89130434782609
2009,"ICT, Chinese Academy of Sciences",ICTNETADRun3,32,1000,885,115,1.06837606837607,2.25490196078431
2009,"ICT, Chinese Academy of Sciences",ICTNETADRun3,33,997,951,46,1.02466598150051,2.09090909090909
2009,"ICT, Chinese Academy of Sciences",ICTNETADRun3,34,999,962,37,1.02251791197544,2.46666666666667
2009,"ICT, Chinese Academy of Sciences",ICTNETADRun3,35,1000,902,98,1.05820105820106,2.27906976744186
2009,"ICT, Chinese Academy of Sciences",ICTNETADRun3,36,1000,938,62,1.0351966873706,2.21428571428571
2009,"ICT, Chinese Academy of Sciences",ICTNETADRun3,37,999,945,54,1.02989690721649,2.16
2009,"ICT, Chinese Academy of Sciences",ICTNETADRun3,38,997,962,35,1.01838610827375,2.05882352941176
2009,"ICT, Chinese Academy of Sciences",ICTNETADRun3,39,998,928,70,1.04175365344468,2.33333333333333
2009,"ICT, Chinese Academy of Sciences",ICTNETADRun3,40,124,118,6,1.02479338842975,2
2009,"ICT, Chinese Academy of Sciences",ICTNETADRun3,41,999,930,69,1.03630705394191,2.02941176470588
2009,"ICT, Chinese Academy of Sciences",ICTNETADRun3,42,1000,971,29,1.01522842639594,2.07142857142857
2009,"ICT, Chinese Academy of Sciences",ICTNETADRun3,43,999,935,64,1.03309203722854,2
2009,"ICT, Chinese Academy of Sciences",ICTNETADRun3,44,999,913,86,1.05379746835443,2.45714285714286
2009,"ICT, Chinese Academy of Sciences",ICTNETADRun3,45,995,947,48,1.02789256198347,2.28571428571429
2009,"ICT, Chinese Academy of Sciences",ICTNETADRun3,46,392,371,21,1.02887139107612,2.1
2009,"ICT, Chinese Academy of Sciences",ICTNETADRun3,47,998,920,78,1.04284221525601,2.10810810810811
2009,"ICT, Chinese Academy of Sciences",ICTNETADRun3,48,1000,932,68,1.04058272632674,2.3448275862069
2009,"ICT, Chinese Academy of Sciences",ICTNETADRun3,49,999,918,81,1.04716981132075,2.25
2009,"ICT, Chinese Academy of Sciences",ICTNETADRun3,50,998,953,45,1.02358974358974,2.04545454545455
2009,"ICT, Chinese Academy of Sciences",ICTNETADRun4,1,1000,898,102,1.06951871657754,2.75675675675676
2009,"ICT, Chinese Academy of Sciences",ICTNETADRun4,2,1000,967,33,1.0183299389002,2.2
2009,"ICT, Chinese Academy of Sciences",ICTNETADRun4,3,1000,967,33,1.01729399796541,2.0625
2009,"ICT, Chinese Academy of Sciences",ICTNETADRun4,4,1000,857,143,1.085776330076,2.234375
2009,"ICT, Chinese Academy of Sciences",ICTNETADRun4,5,1000,917,83,1.04602510460251,2.12820512820513
2009,"ICT, Chinese Academy of Sciences",ICTNETADRun4,6,1000,815,185,1.12107623318386,2.4025974025974
2009,"ICT, Chinese Academy of Sciences",ICTNETADRun4,7,1000,954,46,1.02459016393443,2.09090909090909
2009,"ICT, Chinese Academy of Sciences",ICTNETADRun4,8,1000,820,180,1.10619469026549,2.14285714285714
2009,"ICT, Chinese Academy of Sciences",ICTNETADRun4,9,1000,928,72,1.04275286757039,2.32258064516129
2009,"ICT, Chinese Academy of Sciences",ICTNETADRun4,10,1000,887,113,1.06382978723404,2.13207547169811
2009,"ICT, Chinese Academy of Sciences",ICTNETADRun4,11,1000,926,74,1.04058272632674,2.11428571428571
2009,"ICT, Chinese Academy of Sciences",ICTNETADRun4,12,1000,798,202,1.15207373271889,2.88571428571429
2009,"ICT, Chinese Academy of Sciences",ICTNETADRun4,13,1000,639,361,1.29533678756477,2.71428571428571
2009,"ICT, Chinese Academy of Sciences",ICTNETADRun4,14,1000,899,101,1.05374077976818,2.02
2009,"ICT, Chinese Academy of Sciences",ICTNETADRun4,15,1000,919,81,1.05263157894737,2.61290322580645
2009,"ICT, Chinese Academy of Sciences",ICTNETADRun4,16,1000,933,67,1.03626943005181,2.09375
2009,"ICT, Chinese Academy of Sciences",ICTNETADRun4,17,1000,952,48,1.02564102564103,2.08695652173913
2009,"ICT, Chinese Academy of Sciences",ICTNETADRun4,18,1000,924,76,1.04275286757039,2.17142857142857
2009,"ICT, Chinese Academy of Sciences",ICTNETADRun4,19,1000,923,77,1.04493207941484,2.26470588235294
2009,"ICT, Chinese Academy of Sciences",ICTNETADRun4,20,1000,902,98,1.05374077976818,2.08510638297872
2009,"ICT, Chinese Academy of Sciences",ICTNETADRun4,21,1000,919,81,1.04931794333683,2.38235294117647
2009,"ICT, Chinese Academy of Sciences",ICTNETADRun4,22,1000,976,24,1.01214574898785,2
2009,"ICT, Chinese Academy of Sciences",ICTNETADRun4,23,1000,810,190,1.13636363636364,2.71428571428571
2009,"ICT, Chinese Academy of Sciences",ICTNETADRun4,24,1000,887,113,1.06723585912487,2.26
2009,"ICT, Chinese Academy of Sciences",ICTNETADRun4,25,1000,822,178,1.11482720178372,2.37333333333333
2009,"ICT, Chinese Academy of Sciences",ICTNETADRun4,26,1000,895,105,1.06723585912487,2.5
2009,"ICT, Chinese Academy of Sciences",ICTNETADRun4,27,1000,930,70,1.04058272632674,2.25806451612903
2009,"ICT, Chinese Academy of Sciences",ICTNETADRun4,28,1000,760,240,1.16822429906542,2.5
2009,"ICT, Chinese Academy of Sciences",ICTNETADRun4,29,1000,945,55,1.03092783505155,2.2
2009,"ICT, Chinese Academy of Sciences",ICTNETADRun4,30,1000,909,91,1.0515247108307,2.16666666666667
2009,"ICT, Chinese Academy of Sciences",ICTNETADRun4,31,1000,854,146,1.10497237569061,2.86274509803922
2009,"ICT, Chinese Academy of Sciences",ICTNETADRun4,32,1000,885,115,1.06382978723404,2.09090909090909
2009,"ICT, Chinese Academy of Sciences",ICTNETADRun4,33,1000,956,44,1.02459016393443,2.2
2009,"ICT, Chinese Academy of Sciences",ICTNETADRun4,34,1000,980,20,1.01010101010101,2
2009,"ICT, Chinese Academy of Sciences",ICTNETADRun4,35,1000,873,127,1.07642626480086,2.26785714285714
2009,"ICT, Chinese Academy of Sciences",ICTNETADRun4,36,1000,928,72,1.04058272632674,2.18181818181818
2009,"ICT, Chinese Academy of Sciences",ICTNETADRun4,37,1000,927,73,1.04275286757039,2.28125
2009,"ICT, Chinese Academy of Sciences",ICTNETADRun4,38,1000,932,68,1.04602510460251,2.83333333333333
2009,"ICT, Chinese Academy of Sciences",ICTNETADRun4,39,1000,909,91,1.05485232067511,2.33333333333333
2009,"ICT, Chinese Academy of Sciences",ICTNETADRun4,40,124,116,8,1.03333333333333,2
2009,"ICT, Chinese Academy of Sciences",ICTNETADRun4,41,1000,908,92,1.0515247108307,2.13953488372093
2009,"ICT, Chinese Academy of Sciences",ICTNETADRun4,42,1000,898,102,1.06382978723404,2.42857142857143
2009,"ICT, Chinese Academy of Sciences",ICTNETADRun4,43,1000,936,64,1.03734439834025,2.28571428571429
2009,"ICT, Chinese Academy of Sciences",ICTNETADRun4,44,1000,755,245,1.17647058823529,2.57894736842105
2009,"ICT, Chinese Academy of Sciences",ICTNETADRun4,45,1000,910,90,1.05596620908131,2.43243243243243
2009,"ICT, Chinese Academy of Sciences",ICTNETADRun4,46,392,366,26,1.03703703703704,2.16666666666667
2009,"ICT, Chinese Academy of Sciences",ICTNETADRun4,47,1000,905,95,1.05374077976818,2.15909090909091
2009,"ICT, Chinese Academy of Sciences",ICTNETADRun4,48,1000,925,75,1.04493207941484,2.34375
2009,"ICT, Chinese Academy of Sciences",ICTNETADRun4,49,1000,910,90,1.05042016806723,2.14285714285714
2009,"ICT, Chinese Academy of Sciences",ICTNETADRun4,50,1000,944,56,1.03199174406605,2.24
2009,"ICT, Chinese Academy of Sciences",ICTNETADRun5,1,1000,939,61,1.03305785123967,2.10344827586207
2009,"ICT, Chinese Academy of Sciences",ICTNETADRun5,2,1000,978,22,1.01214574898785,2.2
2009,"ICT, Chinese Academy of Sciences",ICTNETADRun5,3,1000,943,57,1.03092783505155,2.11111111111111
2009,"ICT, Chinese Academy of Sciences",ICTNETADRun5,4,1000,872,128,1.0752688172043,2.20689655172414
2009,"ICT, Chinese Academy of Sciences",ICTNETADRun5,5,1000,923,77,1.04275286757039,2.13888888888889
2009,"ICT, Chinese Academy of Sciences",ICTNETADRun5,6,1000,854,146,1.09409190371991,2.43333333333333
2009,"ICT, Chinese Academy of Sciences",ICTNETADRun5,7,1000,949,51,1.02774922918808,2.125
2009,"ICT, Chinese Academy of Sciences",ICTNETADRun5,8,1000,847,153,1.08932461873638,2.15492957746479
2009,"ICT, Chinese Academy of Sciences",ICTNETADRun5,9,1000,950,50,1.02880658436214,2.27272727272727
2009,"ICT, Chinese Academy of Sciences",ICTNETADRun5,10,1000,920,80,1.04493207941484,2.16216216216216
2009,"ICT, Chinese Academy of Sciences",ICTNETADRun5,11,1000,931,69,1.03734439834025,2.09090909090909
2009,"ICT, Chinese Academy of Sciences",ICTNETADRun5,12,1000,798,202,1.15207373271889,2.88571428571429
2009,"ICT, Chinese Academy of Sciences",ICTNETADRun5,13,1000,662,338,1.27388535031847,2.7479674796748
2009,"ICT, Chinese Academy of Sciences",ICTNETADRun5,14,1000,951,49,1.02564102564103,2.04166666666667
2009,"ICT, Chinese Academy of Sciences",ICTNETADRun5,15,1000,949,51,1.02986611740474,2.31818181818182
2009,"ICT, Chinese Academy of Sciences",ICTNETADRun5,16,1000,948,52,1.02669404517454,2
2009,"ICT, Chinese Academy of Sciences",ICTNETADRun5,17,1000,967,33,1.01936799184506,2.35714285714286
2009,"ICT, Chinese Academy of Sciences",ICTNETADRun5,18,1000,825,175,1.11856823266219,2.53623188405797
2009,"ICT, Chinese Academy of Sciences",ICTNETADRun5,19,1000,963,37,1.02040816326531,2.17647058823529
2009,"ICT, Chinese Academy of Sciences",ICTNETADRun5,20,1000,915,85,1.04712041884817,2.125
2009,"ICT, Chinese Academy of Sciences",ICTNETADRun5,21,1000,929,71,1.04384133611691,2.44827586206897
2009,"ICT, Chinese Academy of Sciences",ICTNETADRun5,22,1000,980,20,1.01010101010101,2
2009,"ICT, Chinese Academy of Sciences",ICTNETADRun5,23,1000,830,170,1.12233445566779,2.78688524590164
2009,"ICT, Chinese Academy of Sciences",ICTNETADRun5,24,1000,904,96,1.05485232067511,2.18181818181818
2009,"ICT, Chinese Academy of Sciences",ICTNETADRun5,25,1000,844,156,1.09769484083425,2.32835820895522
2009,"ICT, Chinese Academy of Sciences",ICTNETADRun5,26,1000,931,69,1.03734439834025,2.09090909090909
2009,"ICT, Chinese Academy of Sciences",ICTNETADRun5,27,1000,939,61,1.0351966873706,2.25925925925926
2009,"ICT, Chinese Academy of Sciences",ICTNETADRun5,28,1000,789,211,1.1454753722795,2.51190476190476
2009,"ICT, Chinese Academy of Sciences",ICTNETADRun5,29,1000,919,81,1.04712041884817,2.25
2009,"ICT, Chinese Academy of Sciences",ICTNETADRun5,30,1000,908,92,1.05042016806723,2.09090909090909
2009,"ICT, Chinese Academy of Sciences",ICTNETADRun5,31,1000,873,127,1.08932461873638,2.82222222222222
2009,"ICT, Chinese Academy of Sciences",ICTNETADRun5,32,1000,907,93,1.0515247108307,2.11363636363636
2009,"ICT, Chinese Academy of Sciences",ICTNETADRun5,33,1000,963,37,1.02040816326531,2.17647058823529
2009,"ICT, Chinese Academy of Sciences",ICTNETADRun5,34,1000,988,12,1.00603621730382,2
2009,"ICT, Chinese Academy of Sciences",ICTNETADRun5,35,1000,885,115,1.06951871657754,2.3
2009,"ICT, Chinese Academy of Sciences",ICTNETADRun5,36,1000,934,66,1.03734439834025,2.2
2009,"ICT, Chinese Academy of Sciences",ICTNETADRun5,37,1000,924,76,1.04493207941484,2.3030303030303
2009,"ICT, Chinese Academy of Sciences",ICTNETADRun5,38,1000,940,60,1.04166666666667,3
2009,"ICT, Chinese Academy of Sciences",ICTNETADRun5,39,1000,915,85,1.0515247108307,2.36111111111111
2009,"ICT, Chinese Academy of Sciences",ICTNETADRun5,40,126,118,8,1.0327868852459,2
2009,"ICT, Chinese Academy of Sciences",ICTNETADRun5,41,1000,951,49,1.02669404517454,2.1304347826087
2009,"ICT, Chinese Academy of Sciences",ICTNETADRun5,42,1000,916,84,1.0515247108307,2.4
2009,"ICT, Chinese Academy of Sciences",ICTNETADRun5,43,1000,958,42,1.02354145342886,2.21052631578947
2009,"ICT, Chinese Academy of Sciences",ICTNETADRun5,44,1000,820,180,1.11111111111111,2.25
2009,"ICT, Chinese Academy of Sciences",ICTNETADRun5,45,1000,922,78,1.04602510460251,2.29411764705882
2009,"ICT, Chinese Academy of Sciences",ICTNETADRun5,46,392,366,26,1.03703703703704,2.16666666666667
2009,"ICT, Chinese Academy of Sciences",ICTNETADRun5,47,1000,923,77,1.04275286757039,2.13888888888889
2009,"ICT, Chinese Academy of Sciences",ICTNETADRun5,48,1000,935,65,1.03734439834025,2.24137931034483
2009,"ICT, Chinese Academy of Sciences",ICTNETADRun5,49,1000,931,69,1.03734439834025,2.09090909090909
2009,"ICT, Chinese Academy of Sciences",ICTNETADRun5,50,1000,939,61,1.03412616339193,2.17857142857143
2009,Information retrieval lab,IE09,1,1000,629,371,1.37741046831956,3.82474226804124
2009,Information retrieval lab,IE09,2,1000,933,67,1.03950103950104,2.31034482758621
2009,Information retrieval lab,IE09,3,1000,850,150,1.1001100110011,2.54237288135593
2009,Information retrieval lab,IE09,4,1000,816,184,1.14678899082569,3.28571428571429
2009,Information retrieval lab,IE09,5,1000,789,211,1.13378684807256,2.26881720430108
2009,Information retrieval lab,IE09,6,1000,342,658,2.23214285714286,6.20754716981132
2009,Information retrieval lab,IE09,7,1000,905,95,1.06496272630458,2.79411764705882
2009,Information retrieval lab,IE09,8,1000,756,244,1.18764845605701,2.83720930232558
2009,Information retrieval lab,IE09,9,1000,791,209,1.16279069767442,3.02898550724638
2009,Information retrieval lab,IE09,10,1000,820,180,1.15874855156431,4.18604651162791
2009,Information retrieval lab,IE09,11,1000,884,116,1.06837606837607,2.23076923076923
2009,Information retrieval lab,IE09,12,1000,667,333,1.27226463104326,2.79831932773109
2009,Information retrieval lab,IE09,13,1000,590,410,1.45985401459854,4.31578947368421
2009,Information retrieval lab,IE09,14,1000,793,207,1.14285714285714,2.52439024390244
2009,Information retrieval lab,IE09,15,1000,787,213,1.14678899082569,2.50588235294118
2009,Information retrieval lab,IE09,16,1000,784,216,1.15074798619102,2.54117647058824
2009,Information retrieval lab,IE09,17,1000,962,38,1.02040816326531,2.11111111111111
2009,Information retrieval lab,IE09,18,1000,879,121,1.08108108108108,2.6304347826087
2009,Information retrieval lab,IE09,19,1000,733,267,1.21951219512195,3.06896551724138
2009,Information retrieval lab,IE09,20,1000,834,166,1.12359550561798,2.96428571428571
2009,Information retrieval lab,IE09,21,1000,854,146,1.10619469026549,2.92
2009,Information retrieval lab,IE09,22,1000,889,111,1.07642626480086,2.775
2009,Information retrieval lab,IE09,23,1000,815,185,1.14025085518814,2.98387096774194
2009,Information retrieval lab,IE09,24,1000,812,188,1.13122171945701,2.61111111111111
2009,Information retrieval lab,IE09,25,1000,625,375,1.3262599469496,2.90697674418605
2009,Information retrieval lab,IE09,26,1000,887,113,1.07296137339056,2.51111111111111
2009,Information retrieval lab,IE09,27,1000,681,319,1.35869565217391,5.8
2009,Information retrieval lab,IE09,28,1000,593,407,1.45985401459854,4.42391304347826
2009,Information retrieval lab,IE09,29,1000,800,200,1.14155251141553,2.63157894736842
2009,Information retrieval lab,IE09,30,1000,880,120,1.07066381156317,2.22222222222222
2009,Information retrieval lab,IE09,31,1000,719,281,1.23609394313968,3.12222222222222
2009,Information retrieval lab,IE09,32,1000,859,141,1.07991360691145,2.1044776119403
2009,Information retrieval lab,IE09,33,1000,948,52,1.02986611740474,2.26086956521739
2009,Information retrieval lab,IE09,34,1000,850,150,1.10741971207087,2.83018867924528
2009,Information retrieval lab,IE09,35,1000,719,281,1.20772946859903,2.57798165137615
2009,Information retrieval lab,IE09,36,1000,902,98,1.07411385606874,3.37931034482759
2009,Information retrieval lab,IE09,37,1000,806,194,1.13895216400911,2.69444444444444
2009,Information retrieval lab,IE09,38,1000,837,163,1.11234705228031,2.62903225806452
2009,Information retrieval lab,IE09,39,1000,892,108,1.07066381156317,2.57142857142857
2009,Information retrieval lab,IE09,40,1000,718,282,1.20481927710843,2.51785714285714
2009,Information retrieval lab,IE09,41,1000,833,167,1.09769484083425,2.14102564102564
2009,Information retrieval lab,IE09,42,1000,900,100,1.06382978723404,2.5
2009,Information retrieval lab,IE09,43,1000,851,149,1.10987791342952,2.98
2009,Information retrieval lab,IE09,44,1000,588,412,1.53139356814701,6.33846153846154
2009,Information retrieval lab,IE09,45,1000,831,169,1.12233445566779,2.81666666666667
2009,Information retrieval lab,IE09,46,1000,711,289,1.26582278481013,3.65822784810127
2009,Information retrieval lab,IE09,47,1000,705,295,1.2987012987013,4.53846153846154
2009,Information retrieval lab,IE09,48,1000,875,125,1.07991360691145,2.45098039215686
2009,Information retrieval lab,IE09,49,1000,839,161,1.10132158590308,2.33333333333333
2009,Information retrieval lab,IE09,50,1000,912,88,1.05708245243129,2.58823529411765
2009,Microsoft Research Cambridge,MS1,1,1000,971,29,1.01936799184506,2.9
2009,Microsoft Research Cambridge,MS1,2,1000,987,13,1.00704934541793,2.16666666666667
2009,Microsoft Research Cambridge,MS1,3,1000,970,30,1.01729399796541,2.30769230769231
2009,Microsoft Research Cambridge,MS1,4,1000,996,4,1.00200400801603,2
2009,Microsoft Research Cambridge,MS1,5,1000,980,20,1.01010101010101,2
2009,Microsoft Research Cambridge,MS1,6,1000,979,21,1.01112234580384,2.1
2009,Microsoft Research Cambridge,MS1,7,1000,989,11,1.00603621730382,2.2
2009,Microsoft Research Cambridge,MS1,8,1000,984,16,1.00806451612903,2
2009,Microsoft Research Cambridge,MS1,9,1000,868,132,1.09170305676856,2.75
2009,Microsoft Research Cambridge,MS1,10,1000,994,6,1.00300902708124,2
2009,Microsoft Research Cambridge,MS1,11,1000,919,81,1.05374077976818,2.7
2009,Microsoft Research Cambridge,MS1,12,1000,991,9,1.00502512562814,2.25
2009,Microsoft Research Cambridge,MS1,13,1000,1000,0,1,
2009,Microsoft Research Cambridge,MS1,14,1000,994,6,1.00300902708124,2
2009,Microsoft Research Cambridge,MS1,15,1000,998,2,1.001001001001,2
2009,Microsoft Research Cambridge,MS1,16,1000,964,36,1.02040816326531,2.25
2009,Microsoft Research Cambridge,MS1,17,1000,994,6,1.00300902708124,2
2009,Microsoft Research Cambridge,MS1,18,1000,986,14,1.00704934541793,2
2009,Microsoft Research Cambridge,MS1,19,1000,996,4,1.00200400801603,2
2009,Microsoft Research Cambridge,MS1,20,1000,1000,0,1,
2009,Microsoft Research Cambridge,MS1,21,1000,991,9,1.00502512562814,2.25
2009,Microsoft Research Cambridge,MS1,22,1000,998,2,1.001001001001,2
2009,Microsoft Research Cambridge,MS1,23,1000,998,2,1.001001001001,2
2009,Microsoft Research Cambridge,MS1,24,1000,998,2,1.001001001001,2
2009,Microsoft Research Cambridge,MS1,25,1000,855,145,1.08342361863489,2.13235294117647
2009,Microsoft Research Cambridge,MS1,26,1000,992,8,1.00401606425703,2
2009,Microsoft Research Cambridge,MS1,27,1000,1000,0,1,
2009,Microsoft Research Cambridge,MS1,28,1000,936,64,1.05932203389831,8
2009,Microsoft Research Cambridge,MS1,29,1000,927,73,1.04166666666667,2.21212121212121
2009,Microsoft Research Cambridge,MS1,30,1000,990,10,1.00502512562814,2
2009,Microsoft Research Cambridge,MS1,31,1000,982,18,1.00908173562059,2
2009,Microsoft Research Cambridge,MS1,32,1000,1000,0,1,
2009,Microsoft Research Cambridge,MS1,33,1000,998,2,1.001001001001,2
2009,Microsoft Research Cambridge,MS1,34,1000,1000,0,1,
2009,Microsoft Research Cambridge,MS1,35,1000,986,14,1.00704934541793,2
2009,Microsoft Research Cambridge,MS1,36,1000,1000,0,1,
2009,Microsoft Research Cambridge,MS1,37,1000,998,2,1.001001001001,2
2009,Microsoft Research Cambridge,MS1,38,1000,988,12,1.00704934541793,2.4
2009,Microsoft Research Cambridge,MS1,39,1000,966,34,1.02774922918808,4.85714285714286
2009,Microsoft Research Cambridge,MS1,40,1000,679,321,1.26103404791929,2.81578947368421
2009,Microsoft Research Cambridge,MS1,41,1000,982,18,1.00908173562059,2
2009,Microsoft Research Cambridge,MS1,42,1000,962,38,1.02774922918808,3.45454545454545
2009,Microsoft Research Cambridge,MS1,43,1000,973,27,1.02145045965271,4.5
2009,Microsoft Research Cambridge,MS1,44,1000,940,60,1.05485232067511,7.5
2009,Microsoft Research Cambridge,MS1,45,1000,998,2,1.001001001001,2
2009,Microsoft Research Cambridge,MS1,46,1000,998,2,1.001001001001,2
2009,Microsoft Research Cambridge,MS1,47,1000,950,50,1.04493207941484,7.14285714285714
2009,Microsoft Research Cambridge,MS1,48,1000,917,83,1.05263157894737,2.51515151515152
2009,Microsoft Research Cambridge,MS1,49,1000,970,30,1.01626016260163,2.14285714285714
2009,Microsoft Research Cambridge,MS1,50,1000,941,59,1.03412616339193,2.26923076923077
2009,Microsoft Research Cambridge,MS2,1,1000,986,14,1.00908173562059,2.8
2009,Microsoft Research Cambridge,MS2,2,1000,989,11,1.00603621730382,2.2
2009,Microsoft Research Cambridge,MS2,3,1000,978,22,1.01317122593718,2.44444444444444
2009,Microsoft Research Cambridge,MS2,4,1000,1000,0,1,
2009,Microsoft Research Cambridge,MS2,5,1000,990,10,1.00502512562814,2
2009,Microsoft Research Cambridge,MS2,6,1000,988,12,1.00603621730382,2
2009,Microsoft Research Cambridge,MS2,7,1000,1000,0,1,
2009,Microsoft Research Cambridge,MS2,8,1000,996,4,1.00200400801603,2
2009,Microsoft Research Cambridge,MS2,9,1000,927,73,1.0515247108307,3.04166666666667
2009,Microsoft Research Cambridge,MS2,10,1000,1000,0,1,
2009,Microsoft Research Cambridge,MS2,11,1000,943,57,1.03412616339193,2.375
2009,Microsoft Research Cambridge,MS2,12,1000,998,2,1.001001001001,2
2009,Microsoft Research Cambridge,MS2,13,1000,1000,0,1,
2009,Microsoft Research Cambridge,MS2,14,1000,1000,0,1,
2009,Microsoft Research Cambridge,MS2,15,1000,1000,0,1,
2009,Microsoft Research Cambridge,MS2,16,1000,972,28,1.01626016260163,2.33333333333333
2009,Microsoft Research Cambridge,MS2,17,1000,998,2,1.001001001001,2
2009,Microsoft Research Cambridge,MS2,18,1000,990,10,1.00502512562814,2
2009,Microsoft Research Cambridge,MS2,19,1000,998,2,1.001001001001,2
2009,Microsoft Research Cambridge,MS2,20,1000,998,2,1.001001001001,2
2009,Microsoft Research Cambridge,MS2,21,1000,991,9,1.00502512562814,2.25
2009,Microsoft Research Cambridge,MS2,22,1000,998,2,1.001001001001,2
2009,Microsoft Research Cambridge,MS2,23,1000,996,4,1.00200400801603,2
2009,Microsoft Research Cambridge,MS2,24,1000,1000,0,1,
2009,Microsoft Research Cambridge,MS2,25,1000,978,22,1.01112234580384,2
2009,Microsoft Research Cambridge,MS2,26,1000,998,2,1.001001001001,2
2009,Microsoft Research Cambridge,MS2,27,1000,997,3,1.00200400801603,3
2009,Microsoft Research Cambridge,MS2,28,1000,980,20,1.01626016260163,5
2009,Microsoft Research Cambridge,MS2,29,1000,991,9,1.00502512562814,2.25
2009,Microsoft Research Cambridge,MS2,30,1000,996,4,1.00200400801603,2
2009,Microsoft Research Cambridge,MS2,31,1000,988,12,1.00603621730382,2
2009,Microsoft Research Cambridge,MS2,32,1000,1000,0,1,
2009,Microsoft Research Cambridge,MS2,33,1000,998,2,1.001001001001,2
2009,Microsoft Research Cambridge,MS2,34,1000,1000,0,1,
2009,Microsoft Research Cambridge,MS2,35,1000,1000,0,1,
2009,Microsoft Research Cambridge,MS2,36,1000,1000,0,1,
2009,Microsoft Research Cambridge,MS2,37,1000,987,13,1.00806451612903,2.6
2009,Microsoft Research Cambridge,MS2,38,1000,994,6,1.00300902708124,2
2009,Microsoft Research Cambridge,MS2,39,1000,985,15,1.01112234580384,3.75
2009,Microsoft Research Cambridge,MS2,40,1000,713,287,1.22699386503067,2.81372549019608
2009,Microsoft Research Cambridge,MS2,41,1000,984,16,1.00806451612903,2
2009,Microsoft Research Cambridge,MS2,42,1000,1000,0,1,
2009,Microsoft Research Cambridge,MS2,43,1000,985,15,1.00806451612903,2.14285714285714
2009,Microsoft Research Cambridge,MS2,44,1000,973,27,1.02459016393443,9
2009,Microsoft Research Cambridge,MS2,45,1000,998,2,1.001001001001,2
2009,Microsoft Research Cambridge,MS2,46,1000,998,2,1.001001001001,2
2009,Microsoft Research Cambridge,MS2,47,1000,984,16,1.01010101010101,2.66666666666667
2009,Microsoft Research Cambridge,MS2,48,1000,929,71,1.04602510460251,2.62962962962963
2009,Microsoft Research Cambridge,MS2,49,1000,979,21,1.01112234580384,2.1
2009,Microsoft Research Cambridge,MS2,50,1000,943,57,1.03305785123967,2.28
2009,Microsoft Research Asia,MSRAAF,1,993,993,0,1,
2009,Microsoft Research Asia,MSRAAF,2,1000,1000,0,1,
2009,Microsoft Research Asia,MSRAAF,3,1000,1000,0,1,
2009,Microsoft Research Asia,MSRAAF,4,998,998,0,1,
2009,Microsoft Research Asia,MSRAAF,5,999,999,0,1,
2009,Microsoft Research Asia,MSRAAF,6,999,999,0,1,
2009,Microsoft Research Asia,MSRAAF,7,1000,1000,0,1,
2009,Microsoft Research Asia,MSRAAF,8,1000,1000,0,1,
2009,Microsoft Research Asia,MSRAAF,9,1000,1000,0,1,
2009,Microsoft Research Asia,MSRAAF,10,1000,1000,0,1,
2009,Microsoft Research Asia,MSRAAF,11,1000,1000,0,1,
2009,Microsoft Research Asia,MSRAAF,12,1000,1000,0,1,
2009,Microsoft Research Asia,MSRAAF,13,998,998,0,1,
2009,Microsoft Research Asia,MSRAAF,14,1000,1000,0,1,
2009,Microsoft Research Asia,MSRAAF,15,998,998,0,1,
2009,Microsoft Research Asia,MSRAAF,16,1000,1000,0,1,
2009,Microsoft Research Asia,MSRAAF,17,1000,1000,0,1,
2009,Microsoft Research Asia,MSRAAF,18,1000,1000,0,1,
2009,Microsoft Research Asia,MSRAAF,19,1000,1000,0,1,
2009,Microsoft Research Asia,MSRAAF,20,1000,1000,0,1,
2009,Microsoft Research Asia,MSRAAF,21,999,999,0,1,
2009,Microsoft Research Asia,MSRAAF,22,1000,1000,0,1,
2009,Microsoft Research Asia,MSRAAF,23,1000,1000,0,1,
2009,Microsoft Research Asia,MSRAAF,24,998,998,0,1,
2009,Microsoft Research Asia,MSRAAF,25,1000,1000,0,1,
2009,Microsoft Research Asia,MSRAAF,26,996,996,0,1,
2009,Microsoft Research Asia,MSRAAF,27,998,998,0,1,
2009,Microsoft Research Asia,MSRAAF,28,1000,1000,0,1,
2009,Microsoft Research Asia,MSRAAF,29,1000,1000,0,1,
2009,Microsoft Research Asia,MSRAAF,30,999,999,0,1,
2009,Microsoft Research Asia,MSRAAF,31,1000,1000,0,1,
2009,Microsoft Research Asia,MSRAAF,32,1000,1000,0,1,
2009,Microsoft Research Asia,MSRAAF,33,1000,1000,0,1,
2009,Microsoft Research Asia,MSRAAF,34,1000,1000,0,1,
2009,Microsoft Research Asia,MSRAAF,35,999,999,0,1,
2009,Microsoft Research Asia,MSRAAF,36,998,998,0,1,
2009,Microsoft Research Asia,MSRAAF,37,997,997,0,1,
2009,Microsoft Research Asia,MSRAAF,38,999,999,0,1,
2009,Microsoft Research Asia,MSRAAF,39,1000,1000,0,1,
2009,Microsoft Research Asia,MSRAAF,40,1000,1000,0,1,
2009,Microsoft Research Asia,MSRAAF,41,1000,1000,0,1,
2009,Microsoft Research Asia,MSRAAF,42,999,999,0,1,
2009,Microsoft Research Asia,MSRAAF,43,997,997,0,1,
2009,Microsoft Research Asia,MSRAAF,44,1000,1000,0,1,
2009,Microsoft Research Asia,MSRAAF,45,999,999,0,1,
2009,Microsoft Research Asia,MSRAAF,46,999,999,0,1,
2009,Microsoft Research Asia,MSRAAF,47,1000,1000,0,1,
2009,Microsoft Research Asia,MSRAAF,48,1000,1000,0,1,
2009,Microsoft Research Asia,MSRAAF,49,999,999,0,1,
2009,Microsoft Research Asia,MSRAAF,50,1000,1000,0,1,
2009,Microsoft Research Asia,MSRAC,1,993,993,0,1,
2009,Microsoft Research Asia,MSRAC,2,1000,1000,0,1,
2009,Microsoft Research Asia,MSRAC,3,1000,1000,0,1,
2009,Microsoft Research Asia,MSRAC,4,998,998,0,1,
2009,Microsoft Research Asia,MSRAC,5,999,999,0,1,
2009,Microsoft Research Asia,MSRAC,6,999,999,0,1,
2009,Microsoft Research Asia,MSRAC,7,1000,1000,0,1,
2009,Microsoft Research Asia,MSRAC,8,1000,1000,0,1,
2009,Microsoft Research Asia,MSRAC,9,1000,1000,0,1,
2009,Microsoft Research Asia,MSRAC,10,1000,1000,0,1,
2009,Microsoft Research Asia,MSRAC,11,1000,1000,0,1,
2009,Microsoft Research Asia,MSRAC,12,1000,1000,0,1,
2009,Microsoft Research Asia,MSRAC,13,998,998,0,1,
2009,Microsoft Research Asia,MSRAC,14,1000,1000,0,1,
2009,Microsoft Research Asia,MSRAC,15,998,998,0,1,
2009,Microsoft Research Asia,MSRAC,16,1000,1000,0,1,
2009,Microsoft Research Asia,MSRAC,17,1000,1000,0,1,
2009,Microsoft Research Asia,MSRAC,18,1000,1000,0,1,
2009,Microsoft Research Asia,MSRAC,19,1000,1000,0,1,
2009,Microsoft Research Asia,MSRAC,20,1000,1000,0,1,
2009,Microsoft Research Asia,MSRAC,21,999,999,0,1,
2009,Microsoft Research Asia,MSRAC,22,1000,1000,0,1,
2009,Microsoft Research Asia,MSRAC,23,1000,1000,0,1,
2009,Microsoft Research Asia,MSRAC,24,998,998,0,1,
2009,Microsoft Research Asia,MSRAC,25,1000,1000,0,1,
2009,Microsoft Research Asia,MSRAC,26,996,996,0,1,
2009,Microsoft Research Asia,MSRAC,27,998,998,0,1,
2009,Microsoft Research Asia,MSRAC,28,1000,1000,0,1,
2009,Microsoft Research Asia,MSRAC,29,1000,1000,0,1,
2009,Microsoft Research Asia,MSRAC,30,999,999,0,1,
2009,Microsoft Research Asia,MSRAC,31,1000,1000,0,1,
2009,Microsoft Research Asia,MSRAC,32,1000,1000,0,1,
2009,Microsoft Research Asia,MSRAC,33,1000,1000,0,1,
2009,Microsoft Research Asia,MSRAC,34,1000,1000,0,1,
2009,Microsoft Research Asia,MSRAC,35,999,999,0,1,
2009,Microsoft Research Asia,MSRAC,36,998,998,0,1,
2009,Microsoft Research Asia,MSRAC,37,997,997,0,1,
2009,Microsoft Research Asia,MSRAC,38,999,999,0,1,
2009,Microsoft Research Asia,MSRAC,39,1000,1000,0,1,
2009,Microsoft Research Asia,MSRAC,40,1000,1000,0,1,
2009,Microsoft Research Asia,MSRAC,41,1000,1000,0,1,
2009,Microsoft Research Asia,MSRAC,42,999,999,0,1,
2009,Microsoft Research Asia,MSRAC,43,997,997,0,1,
2009,Microsoft Research Asia,MSRAC,44,1000,1000,0,1,
2009,Microsoft Research Asia,MSRAC,45,999,999,0,1,
2009,Microsoft Research Asia,MSRAC,46,999,999,0,1,
2009,Microsoft Research Asia,MSRAC,47,1000,1000,0,1,
2009,Microsoft Research Asia,MSRAC,48,1000,1000,0,1,
2009,Microsoft Research Asia,MSRAC,49,999,999,0,1,
2009,Microsoft Research Asia,MSRAC,50,1000,1000,0,1,
2009,Microsoft Research Asia,MSRANORM,1,1000,1000,0,1,
2009,Microsoft Research Asia,MSRANORM,2,1000,1000,0,1,
2009,Microsoft Research Asia,MSRANORM,3,1000,1000,0,1,
2009,Microsoft Research Asia,MSRANORM,4,1000,1000,0,1,
2009,Microsoft Research Asia,MSRANORM,5,1000,1000,0,1,
2009,Microsoft Research Asia,MSRANORM,6,1000,1000,0,1,
2009,Microsoft Research Asia,MSRANORM,7,1000,1000,0,1,
2009,Microsoft Research Asia,MSRANORM,8,1000,1000,0,1,
2009,Microsoft Research Asia,MSRANORM,9,1000,1000,0,1,
2009,Microsoft Research Asia,MSRANORM,10,1000,1000,0,1,
2009,Microsoft Research Asia,MSRANORM,11,1000,1000,0,1,
2009,Microsoft Research Asia,MSRANORM,12,1000,1000,0,1,
2009,Microsoft Research Asia,MSRANORM,13,1000,1000,0,1,
2009,Microsoft Research Asia,MSRANORM,14,1000,1000,0,1,
2009,Microsoft Research Asia,MSRANORM,15,1000,1000,0,1,
2009,Microsoft Research Asia,MSRANORM,16,1000,1000,0,1,
2009,Microsoft Research Asia,MSRANORM,17,1000,1000,0,1,
2009,Microsoft Research Asia,MSRANORM,18,1000,1000,0,1,
2009,Microsoft Research Asia,MSRANORM,19,1000,1000,0,1,
2009,Microsoft Research Asia,MSRANORM,20,1000,1000,0,1,
2009,Microsoft Research Asia,MSRANORM,21,1000,1000,0,1,
2009,Microsoft Research Asia,MSRANORM,22,1000,1000,0,1,
2009,Microsoft Research Asia,MSRANORM,23,1000,1000,0,1,
2009,Microsoft Research Asia,MSRANORM,24,1000,1000,0,1,
2009,Microsoft Research Asia,MSRANORM,25,1000,1000,0,1,
2009,Microsoft Research Asia,MSRANORM,26,1000,1000,0,1,
2009,Microsoft Research Asia,MSRANORM,27,1000,1000,0,1,
2009,Microsoft Research Asia,MSRANORM,28,1000,1000,0,1,
2009,Microsoft Research Asia,MSRANORM,29,1000,1000,0,1,
2009,Microsoft Research Asia,MSRANORM,30,1000,1000,0,1,
2009,Microsoft Research Asia,MSRANORM,31,1000,1000,0,1,
2009,Microsoft Research Asia,MSRANORM,32,1000,1000,0,1,
2009,Microsoft Research Asia,MSRANORM,33,1000,1000,0,1,
2009,Microsoft Research Asia,MSRANORM,34,1000,1000,0,1,
2009,Microsoft Research Asia,MSRANORM,35,1000,1000,0,1,
2009,Microsoft Research Asia,MSRANORM,36,1000,1000,0,1,
2009,Microsoft Research Asia,MSRANORM,37,1000,1000,0,1,
2009,Microsoft Research Asia,MSRANORM,38,1000,1000,0,1,
2009,Microsoft Research Asia,MSRANORM,39,1000,1000,0,1,
2009,Microsoft Research Asia,MSRANORM,40,1000,1000,0,1,
2009,Microsoft Research Asia,MSRANORM,41,1000,1000,0,1,
2009,Microsoft Research Asia,MSRANORM,42,1000,1000,0,1,
2009,Microsoft Research Asia,MSRANORM,43,1000,1000,0,1,
2009,Microsoft Research Asia,MSRANORM,44,1000,1000,0,1,
2009,Microsoft Research Asia,MSRANORM,45,1000,1000,0,1,
2009,Microsoft Research Asia,MSRANORM,46,1000,1000,0,1,
2009,Microsoft Research Asia,MSRANORM,47,1000,1000,0,1,
2009,Microsoft Research Asia,MSRANORM,48,1000,1000,0,1,
2009,Microsoft Research Asia,MSRANORM,49,1000,1000,0,1,
2009,Microsoft Research Asia,MSRANORM,50,1000,1000,0,1,
2009,Northeastern University,NeuLMWeb300,1,1000,831,169,1.0989010989011,2.13924050632911
2009,Northeastern University,NeuLMWeb300,2,1000,920,80,1.04493207941484,2.16216216216216
2009,Northeastern University,NeuLMWeb300,3,1000,966,34,1.01729399796541,2
2009,Northeastern University,NeuLMWeb300,4,1000,947,53,1.02880658436214,2.12
2009,Northeastern University,NeuLMWeb300,5,1000,929,71,1.03734439834025,2.02857142857143
2009,Northeastern University,NeuLMWeb300,6,1000,755,245,1.15074798619102,2.14912280701754
2009,Northeastern University,NeuLMWeb300,7,1000,646,354,1.48588410104012,13.1111111111111
2009,Northeastern University,NeuLMWeb300,8,1000,938,62,1.03305785123967,2.06666666666667
2009,Northeastern University,NeuLMWeb300,9,1000,968,32,1.01626016260163,2
2009,Northeastern University,NeuLMWeb300,10,1000,927,73,1.04166666666667,2.21212121212121
2009,Northeastern University,NeuLMWeb300,11,1000,968,32,1.01626016260163,2
2009,Northeastern University,NeuLMWeb300,12,1000,787,213,1.13636363636364,2.29032258064516
2009,Northeastern University,NeuLMWeb300,13,1000,654,346,1.25156445556946,2.38620689655172
2009,Northeastern University,NeuLMWeb300,14,1000,925,75,1.03950103950104,2.02702702702703
2009,Northeastern University,NeuLMWeb300,15,1000,677,323,1.28205128205128,3.13592233009709
2009,Northeastern University,NeuLMWeb300,16,1000,940,60,1.03092783505155,2
2009,Northeastern University,NeuLMWeb300,17,1000,974,26,1.01317122593718,2
2009,Northeastern University,NeuLMWeb300,18,1000,963,37,1.01936799184506,2.05555555555556
2009,Northeastern University,NeuLMWeb300,19,1000,876,124,1.07642626480086,2.33962264150943
2009,Northeastern University,NeuLMWeb300,20,1000,928,72,1.03842159916926,2.05714285714286
2009,Northeastern University,NeuLMWeb300,21,1000,931,69,1.04058272632674,2.3
2009,Northeastern University,NeuLMWeb300,22,1000,982,18,1.00908173562059,2
2009,Northeastern University,NeuLMWeb300,23,1000,684,316,1.25786163522013,2.84684684684685
2009,Northeastern University,NeuLMWeb300,24,1000,944,56,1.02880658436214,2
2009,Northeastern University,NeuLMWeb300,25,1000,883,117,1.06382978723404,2.05263157894737
2009,Northeastern University,NeuLMWeb300,26,1000,974,26,1.01317122593718,2
2009,Northeastern University,NeuLMWeb300,27,1000,961,39,1.02040816326531,2.05263157894737
2009,Northeastern University,NeuLMWeb300,28,1000,898,102,1.05596620908131,2.08163265306122
2009,Northeastern University,NeuLMWeb300,29,1000,960,40,1.02040816326531,2
2009,Northeastern University,NeuLMWeb300,30,1000,963,37,1.01936799184506,2.05555555555556
2009,Northeastern University,NeuLMWeb300,31,1000,923,77,1.04275286757039,2.13888888888889
2009,Northeastern University,NeuLMWeb300,32,1000,974,26,1.01317122593718,2
2009,Northeastern University,NeuLMWeb300,33,1000,959,41,1.02249488752556,2.15789473684211
2009,Northeastern University,NeuLMWeb300,34,1000,823,177,1.11731843575419,2.45833333333333
2009,Northeastern University,NeuLMWeb300,35,1000,909,91,1.04931794333683,2.06818181818182
2009,Northeastern University,NeuLMWeb300,36,1000,970,30,1.01522842639594,2
2009,Northeastern University,NeuLMWeb300,37,1000,938,62,1.03305785123967,2.06666666666667
2009,Northeastern University,NeuLMWeb300,38,1000,964,36,1.0183299389002,2
2009,Northeastern University,NeuLMWeb300,39,1000,957,43,1.02249488752556,2.04761904761905
2009,Northeastern University,NeuLMWeb300,40,135,127,8,1.03053435114504,2
2009,Northeastern University,NeuLMWeb300,41,1000,896,104,1.06723585912487,2.53658536585366
2009,Northeastern University,NeuLMWeb300,42,1000,917,83,1.04384133611691,2.02439024390244
2009,Northeastern University,NeuLMWeb300,43,1000,967,33,1.01729399796541,2.0625
2009,Northeastern University,NeuLMWeb300,44,1000,926,74,1.03950103950104,2.05555555555556
2009,Northeastern University,NeuLMWeb300,45,1000,937,63,1.03412616339193,2.1
2009,Northeastern University,NeuLMWeb300,46,1000,937,63,1.03305785123967,2.03225806451613
2009,Northeastern University,NeuLMWeb300,47,1000,979,21,1.01112234580384,2.1
2009,Northeastern University,NeuLMWeb300,48,1000,937,63,1.03842159916926,2.42307692307692
2009,Northeastern University,NeuLMWeb300,49,1000,939,61,1.03626943005181,2.34615384615385
2009,Northeastern University,NeuLMWeb300,50,1000,925,75,1.04602510460251,2.41935483870968
2009,Northeastern University,NeuLMWeb600,1,1000,835,165,1.09649122807018,2.14285714285714
2009,Northeastern University,NeuLMWeb600,2,1000,922,78,1.04384133611691,2.16666666666667
2009,Northeastern University,NeuLMWeb600,3,1000,966,34,1.01729399796541,2
2009,Northeastern University,NeuLMWeb600,4,1000,947,53,1.02880658436214,2.12
2009,Northeastern University,NeuLMWeb600,5,1000,929,71,1.03734439834025,2.02857142857143
2009,Northeastern University,NeuLMWeb600,6,1000,757,243,1.14942528735632,2.15044247787611
2009,Northeastern University,NeuLMWeb600,7,1000,646,354,1.48588410104012,13.1111111111111
2009,Northeastern University,NeuLMWeb600,8,1000,938,62,1.03305785123967,2.06666666666667
2009,Northeastern University,NeuLMWeb600,9,1000,968,32,1.01626016260163,2
2009,Northeastern University,NeuLMWeb600,10,1000,927,73,1.04166666666667,2.21212121212121
2009,Northeastern University,NeuLMWeb600,11,1000,972,28,1.01419878296146,2
2009,Northeastern University,NeuLMWeb600,12,1000,787,213,1.13636363636364,2.29032258064516
2009,Northeastern University,NeuLMWeb600,13,1000,659,341,1.24688279301746,2.38461538461538
2009,Northeastern University,NeuLMWeb600,14,1000,921,79,1.04166666666667,2.02564102564103
2009,Northeastern University,NeuLMWeb600,15,1000,675,325,1.28369704749679,3.125
2009,Northeastern University,NeuLMWeb600,16,1000,938,62,1.03199174406605,2
2009,Northeastern University,NeuLMWeb600,17,1000,974,26,1.01317122593718,2
2009,Northeastern University,NeuLMWeb600,18,1000,964,36,1.01936799184506,2.11764705882353
2009,Northeastern University,NeuLMWeb600,19,1000,884,116,1.07066381156317,2.32
2009,Northeastern University,NeuLMWeb600,20,1000,922,78,1.04166666666667,2.05263157894737
2009,Northeastern University,NeuLMWeb600,21,1000,931,69,1.04058272632674,2.3
2009,Northeastern University,NeuLMWeb600,22,1000,982,18,1.00908173562059,2
2009,Northeastern University,NeuLMWeb600,23,1000,696,304,1.24688279301746,2.86792452830189
2009,Northeastern University,NeuLMWeb600,24,1000,944,56,1.02880658436214,2
2009,Northeastern University,NeuLMWeb600,25,1000,881,119,1.06496272630458,2.05172413793103
2009,Northeastern University,NeuLMWeb600,26,1000,976,24,1.01214574898785,2
2009,Northeastern University,NeuLMWeb600,27,1000,961,39,1.02040816326531,2.05263157894737
2009,Northeastern University,NeuLMWeb600,28,1000,870,130,1.0752688172043,2.16666666666667
2009,Northeastern University,NeuLMWeb600,29,1000,956,44,1.02249488752556,2
2009,Northeastern University,NeuLMWeb600,30,1000,965,35,1.0183299389002,2.05882352941176
2009,Northeastern University,NeuLMWeb600,31,1000,923,77,1.04275286757039,2.13888888888889
2009,Northeastern University,NeuLMWeb600,32,1000,974,26,1.01317122593718,2
2009,Northeastern University,NeuLMWeb600,33,1000,959,41,1.02249488752556,2.15789473684211
2009,Northeastern University,NeuLMWeb600,34,1000,827,173,1.11482720178372,2.47142857142857
2009,Northeastern University,NeuLMWeb600,35,1000,910,90,1.04931794333683,2.09302325581395
2009,Northeastern University,NeuLMWeb600,36,1000,972,28,1.01419878296146,2
2009,Northeastern University,NeuLMWeb600,37,1000,940,60,1.03199174406605,2.06896551724138
2009,Northeastern University,NeuLMWeb600,38,1000,964,36,1.0183299389002,2
2009,Northeastern University,NeuLMWeb600,39,1000,951,49,1.02564102564103,2.04166666666667
2009,Northeastern University,NeuLMWeb600,40,136,128,8,1.03030303030303,2
2009,Northeastern University,NeuLMWeb600,41,1000,896,104,1.06723585912487,2.53658536585366
2009,Northeastern University,NeuLMWeb600,42,1000,919,81,1.04275286757039,2.025
2009,Northeastern University,NeuLMWeb600,43,1000,969,31,1.01626016260163,2.06666666666667
2009,Northeastern University,NeuLMWeb600,44,1000,928,72,1.03842159916926,2.05714285714286
2009,Northeastern University,NeuLMWeb600,45,1000,937,63,1.03412616339193,2.1
2009,Northeastern University,NeuLMWeb600,46,1000,939,61,1.03199174406605,2.03333333333333
2009,Northeastern University,NeuLMWeb600,47,1000,979,21,1.01112234580384,2.1
2009,Northeastern University,NeuLMWeb600,48,1000,937,63,1.03842159916926,2.42307692307692
2009,Northeastern University,NeuLMWeb600,49,1000,949,51,1.02774922918808,2.125
2009,Northeastern University,NeuLMWeb600,50,1000,927,73,1.04493207941484,2.43333333333333
2009,Northeastern University,NeuLMWebBase,1,1000,845,155,1.09170305676856,2.1830985915493
2009,Northeastern University,NeuLMWebBase,2,1000,920,80,1.04493207941484,2.16216216216216
2009,Northeastern University,NeuLMWebBase,3,1000,962,38,1.01936799184506,2
2009,Northeastern University,NeuLMWebBase,4,1000,947,53,1.02880658436214,2.12
2009,Northeastern University,NeuLMWebBase,5,1000,929,71,1.03734439834025,2.02857142857143
2009,Northeastern University,NeuLMWebBase,6,1000,757,243,1.14942528735632,2.15044247787611
2009,Northeastern University,NeuLMWebBase,7,1000,654,346,1.47275405007364,13.84
2009,Northeastern University,NeuLMWebBase,8,1000,938,62,1.03305785123967,2.06666666666667
2009,Northeastern University,NeuLMWebBase,9,1000,966,34,1.01729399796541,2
2009,Northeastern University,NeuLMWebBase,10,1000,939,61,1.03305785123967,2.10344827586207
2009,Northeastern University,NeuLMWebBase,11,1000,972,28,1.01419878296146,2
2009,Northeastern University,NeuLMWebBase,12,1000,787,213,1.13636363636364,2.29032258064516
2009,Northeastern University,NeuLMWebBase,13,1000,665,335,1.24223602484472,2.39285714285714
2009,Northeastern University,NeuLMWebBase,14,1000,921,79,1.04166666666667,2.02564102564103
2009,Northeastern University,NeuLMWebBase,15,1000,675,325,1.28369704749679,3.125
2009,Northeastern University,NeuLMWebBase,16,1000,940,60,1.03092783505155,2
2009,Northeastern University,NeuLMWebBase,17,1000,974,26,1.01317122593718,2
2009,Northeastern University,NeuLMWebBase,18,1000,966,34,1.0183299389002,2.125
2009,Northeastern University,NeuLMWebBase,19,1000,892,108,1.06496272630458,2.29787234042553
2009,Northeastern University,NeuLMWebBase,20,1000,922,78,1.04166666666667,2.05263157894737
2009,Northeastern University,NeuLMWebBase,21,1000,931,69,1.04058272632674,2.3
2009,Northeastern University,NeuLMWebBase,22,1000,982,18,1.00908173562059,2
2009,Northeastern University,NeuLMWebBase,23,1000,698,302,1.2453300124533,2.87619047619048
2009,Northeastern University,NeuLMWebBase,24,1000,944,56,1.02880658436214,2
2009,Northeastern University,NeuLMWebBase,25,1000,883,117,1.06382978723404,2.05263157894737
2009,Northeastern University,NeuLMWebBase,26,1000,974,26,1.01317122593718,2
2009,Northeastern University,NeuLMWebBase,27,1000,961,39,1.02040816326531,2.05263157894737
2009,Northeastern University,NeuLMWebBase,28,1000,870,130,1.0752688172043,2.16666666666667
2009,Northeastern University,NeuLMWebBase,29,1000,958,42,1.02145045965271,2
2009,Northeastern University,NeuLMWebBase,30,1000,965,35,1.0183299389002,2.05882352941176
2009,Northeastern University,NeuLMWebBase,31,1000,923,77,1.04275286757039,2.13888888888889
2009,Northeastern University,NeuLMWebBase,32,1000,974,26,1.01317122593718,2
2009,Northeastern University,NeuLMWebBase,33,1000,959,41,1.02249488752556,2.15789473684211
2009,Northeastern University,NeuLMWebBase,34,1000,827,173,1.11482720178372,2.47142857142857
2009,Northeastern University,NeuLMWebBase,35,1000,910,90,1.04931794333683,2.09302325581395
2009,Northeastern University,NeuLMWebBase,36,1000,972,28,1.01419878296146,2
2009,Northeastern University,NeuLMWebBase,37,1000,940,60,1.03199174406605,2.06896551724138
2009,Northeastern University,NeuLMWebBase,38,1000,964,36,1.0183299389002,2
2009,Northeastern University,NeuLMWebBase,39,1000,951,49,1.02564102564103,2.04166666666667
2009,Northeastern University,NeuLMWebBase,40,141,133,8,1.02919708029197,2
2009,Northeastern University,NeuLMWebBase,41,1000,891,109,1.07066381156317,2.53488372093023
2009,Northeastern University,NeuLMWebBase,42,1000,913,87,1.04602510460251,2.02325581395349
2009,Northeastern University,NeuLMWebBase,43,1000,969,31,1.01626016260163,2.06666666666667
2009,Northeastern University,NeuLMWebBase,44,1000,926,74,1.03950103950104,2.05555555555556
2009,Northeastern University,NeuLMWebBase,45,1000,937,63,1.03412616339193,2.1
2009,Northeastern University,NeuLMWebBase,46,1000,943,57,1.02986611740474,2.03571428571429
2009,Northeastern University,NeuLMWebBase,47,1000,979,21,1.01112234580384,2.1
2009,Northeastern University,NeuLMWebBase,48,1000,937,63,1.03842159916926,2.42307692307692
2009,Northeastern University,NeuLMWebBase,49,1000,953,47,1.02564102564103,2.13636363636364
2009,Northeastern University,NeuLMWebBase,50,1000,929,71,1.04384133611691,2.44827586206897
2009,RMIT University,RmitLm,1,1000,732,268,1.20481927710843,2.73469387755102
2009,RMIT University,RmitLm,2,1000,906,94,1.05042016806723,2.04347826086957
2009,RMIT University,RmitLm,3,1000,927,73,1.04384133611691,2.35483870967742
2009,RMIT University,RmitLm,4,1000,819,181,1.12485939257593,2.58571428571429
2009,RMIT University,RmitLm,5,1000,867,133,1.08342361863489,2.375
2009,RMIT University,RmitLm,6,1000,901,99,1.05596620908131,2.15217391304348
2009,RMIT University,RmitLm,7,1000,610,390,1.53374233128834,9.28571428571429
2009,RMIT University,RmitLm,8,1000,821,179,1.11731843575419,2.41891891891892
2009,RMIT University,RmitLm,9,1000,921,79,1.05042016806723,2.54838709677419
2009,RMIT University,RmitLm,10,1000,858,142,1.085776330076,2.25396825396825
2009,RMIT University,RmitLm,11,1000,874,126,1.0752688172043,2.25
2009,RMIT University,RmitLm,12,1000,877,123,1.07411385606874,2.27777777777778
2009,RMIT University,RmitLm,13,1000,786,214,1.16550116550117,2.97222222222222
2009,RMIT University,RmitLm,14,1000,837,163,1.0989010989011,2.23287671232877
2009,RMIT University,RmitLm,15,1000,616,384,1.39082058414465,3.72815533980583
2009,RMIT University,RmitLm,16,1000,833,167,1.09529025191676,2.0875
2009,RMIT University,RmitLm,17,1000,966,34,1.0183299389002,2.125
2009,RMIT University,RmitLm,18,1000,932,68,1.03842159916926,2.19354838709677
2009,RMIT University,RmitLm,19,1000,793,207,1.15606936416185,2.875
2009,RMIT University,RmitLm,20,1000,837,163,1.10497237569061,2.39705882352941
2009,RMIT University,RmitLm,21,1000,889,111,1.08342361863489,3.26470588235294
2009,RMIT University,RmitLm,22,1000,953,47,1.02459016393443,2.04347826086957
2009,RMIT University,RmitLm,23,1000,383,617,2.05761316872428,5.99029126213592
2009,RMIT University,RmitLm,24,1000,836,164,1.0989010989011,2.21621621621622
2009,RMIT University,RmitLm,25,1000,743,257,1.18063754427391,2.47115384615385
2009,RMIT University,RmitLm,26,1000,900,100,1.06044538706257,2.32558139534884
2009,RMIT University,RmitLm,27,1000,909,91,1.0515247108307,2.16666666666667
2009,RMIT University,RmitLm,28,1000,695,305,1.25944584382872,3.08080808080808
2009,RMIT University,RmitLm,29,1000,936,64,1.03950103950104,2.46153846153846
2009,RMIT University,RmitLm,30,1000,871,129,1.07181136120043,2.08064516129032
2009,RMIT University,RmitLm,31,1000,777,223,1.1454753722795,2.32291666666667
2009,RMIT University,RmitLm,32,1000,856,144,1.08813928182807,2.28571428571429
2009,RMIT University,RmitLm,33,1000,919,81,1.04602510460251,2.18918918918919
2009,RMIT University,RmitLm,34,1000,820,180,1.11856823266219,2.43243243243243
2009,RMIT University,RmitLm,35,1000,756,244,1.16009280742459,2.30188679245283
2009,RMIT University,RmitLm,36,1000,952,48,1.02564102564103,2.08695652173913
2009,RMIT University,RmitLm,37,1000,918,82,1.04712041884817,2.21621621621622
2009,RMIT University,RmitLm,38,1000,917,83,1.04602510460251,2.12820512820513
2009,RMIT University,RmitLm,39,1000,907,93,1.06157112526539,2.65714285714286
2009,RMIT University,RmitLm,40,15,11,4,1.15384615384615,2
2009,RMIT University,RmitLm,41,1000,774,226,1.15740740740741,2.51111111111111
2009,RMIT University,RmitLm,42,1000,862,138,1.09649122807018,2.76
2009,RMIT University,RmitLm,43,1000,921,79,1.04493207941484,2.19444444444444
2009,RMIT University,RmitLm,44,1000,776,224,1.17924528301887,3.11111111111111
2009,RMIT University,RmitLm,45,1000,861,139,1.09289617486339,2.57407407407407
2009,RMIT University,RmitLm,46,1000,890,110,1.06837606837607,2.39130434782609
2009,RMIT University,RmitLm,47,1000,894,106,1.06044538706257,2.16326530612245
2009,RMIT University,RmitLm,48,1000,894,106,1.07296137339056,2.78947368421053
2009,RMIT University,RmitLm,49,1000,758,242,1.17647058823529,2.6304347826087
2009,RMIT University,RmitLm,50,1000,882,118,1.09051254089422,3.37142857142857
2009,RMIT University,RmitOkapi,1,1000,874,126,1.07991360691145,2.42307692307692
2009,RMIT University,RmitOkapi,2,1000,904,96,1.05263157894737,2.08695652173913
2009,RMIT University,RmitOkapi,3,1000,883,117,1.06496272630458,2.08928571428571
2009,RMIT University,RmitOkapi,4,1000,805,195,1.13250283125708,2.5
2009,RMIT University,RmitOkapi,5,1000,813,187,1.11607142857143,2.25301204819277
2009,RMIT University,RmitOkapi,6,1000,826,174,1.10619469026549,2.23076923076923
2009,RMIT University,RmitOkapi,7,1000,887,113,1.07066381156317,2.40425531914894
2009,RMIT University,RmitOkapi,8,1000,692,308,1.22100122100122,2.4251968503937
2009,RMIT University,RmitOkapi,9,1000,904,96,1.06044538706257,2.46153846153846
2009,RMIT University,RmitOkapi,10,1000,834,166,1.1037527593819,2.30555555555556
2009,RMIT University,RmitOkapi,11,1000,843,157,1.10253583241455,2.453125
2009,RMIT University,RmitOkapi,12,1000,782,218,1.17647058823529,3.20588235294118
2009,RMIT University,RmitOkapi,13,1000,768,232,1.17924528301887,2.9
2009,RMIT University,RmitOkapi,14,1000,843,157,1.09529025191676,2.24285714285714
2009,RMIT University,RmitOkapi,15,1000,809,191,1.12485939257593,2.3875
2009,RMIT University,RmitOkapi,16,1000,728,272,1.16414435389988,2.0763358778626
2009,RMIT University,RmitOkapi,17,1000,883,117,1.08225108225108,2.85365853658537
2009,RMIT University,RmitOkapi,18,1000,897,103,1.06157112526539,2.28888888888889
2009,RMIT University,RmitOkapi,19,1000,752,248,1.17096018735363,2.43137254901961
2009,RMIT University,RmitOkapi,20,1000,806,194,1.11982082866741,2.22988505747126
2009,RMIT University,RmitOkapi,21,1000,866,134,1.09769484083425,2.97777777777778
2009,RMIT University,RmitOkapi,22,1000,930,70,1.03950103950104,2.1875
2009,RMIT University,RmitOkapi,23,1000,401,599,1.98019801980198,5.75961538461539
2009,RMIT University,RmitOkapi,24,1000,768,232,1.14810562571757,2.25242718446602
2009,RMIT University,RmitOkapi,25,1000,691,309,1.21359223300971,2.32330827067669
2009,RMIT University,RmitOkapi,26,1000,910,90,1.0515247108307,2.19512195121951
2009,RMIT University,RmitOkapi,27,1000,745,255,1.19904076738609,2.86516853932584
2009,RMIT University,RmitOkapi,28,1000,705,295,1.25,3.10526315789474
2009,RMIT University,RmitOkapi,29,1000,900,100,1.07066381156317,2.94117647058824
2009,RMIT University,RmitOkapi,30,1000,803,197,1.11731843575419,2.14130434782609
2009,RMIT University,RmitOkapi,31,1000,755,245,1.16414435389988,2.35576923076923
2009,RMIT University,RmitOkapi,32,1000,777,223,1.14942528735632,2.39784946236559
2009,RMIT University,RmitOkapi,33,1000,904,96,1.05708245243129,2.28571428571429
2009,RMIT University,RmitOkapi,34,1000,800,200,1.13378684807256,2.4390243902439
2009,RMIT University,RmitOkapi,35,1000,744,256,1.16686114352392,2.26548672566372
2009,RMIT University,RmitOkapi,36,1000,941,59,1.03092783505155,2.03448275862069
2009,RMIT University,RmitOkapi,37,1000,631,369,1.33868808567604,3.18103448275862
2009,RMIT University,RmitOkapi,38,1000,892,108,1.06044538706257,2.11764705882353
2009,RMIT University,RmitOkapi,39,1000,881,119,1.07642626480086,2.47916666666667
2009,RMIT University,RmitOkapi,40,15,11,4,1.15384615384615,2
2009,RMIT University,RmitOkapi,41,1000,876,124,1.07066381156317,2.13793103448276
2009,RMIT University,RmitOkapi,42,1000,920,80,1.04602510460251,2.22222222222222
2009,RMIT University,RmitOkapi,43,1000,880,120,1.07066381156317,2.22222222222222
2009,RMIT University,RmitOkapi,44,1000,854,146,1.09289617486339,2.39344262295082
2009,RMIT University,RmitOkapi,45,1000,848,152,1.1001100110011,2.49180327868852
2009,RMIT University,RmitOkapi,46,1000,878,122,1.07642626480086,2.3921568627451
2009,RMIT University,RmitOkapi,47,1000,876,124,1.06951871657754,2.10169491525424
2009,RMIT University,RmitOkapi,48,1000,882,118,1.08108108108108,2.74418604651163
2009,RMIT University,RmitOkapi,49,1000,750,250,1.17785630153121,2.52525252525253
2009,RMIT University,RmitOkapi,50,1000,931,69,1.03950103950104,2.2258064516129
2009,"IIIT, Hyderabad",SIEL09,1,1000,629,371,1.37741046831956,3.82474226804124
2009,"IIIT, Hyderabad",SIEL09,2,1000,933,67,1.03950103950104,2.31034482758621
2009,"IIIT, Hyderabad",SIEL09,3,1000,850,150,1.1001100110011,2.54237288135593
2009,"IIIT, Hyderabad",SIEL09,4,1000,816,184,1.14678899082569,3.28571428571429
2009,"IIIT, Hyderabad",SIEL09,5,1000,789,211,1.13378684807256,2.26881720430108
2009,"IIIT, Hyderabad",SIEL09,6,1000,342,658,2.23214285714286,6.20754716981132
2009,"IIIT, Hyderabad",SIEL09,7,1000,905,95,1.06496272630458,2.79411764705882
2009,"IIIT, Hyderabad",SIEL09,8,1000,756,244,1.18764845605701,2.83720930232558
2009,"IIIT, Hyderabad",SIEL09,9,1000,791,209,1.16279069767442,3.02898550724638
2009,"IIIT, Hyderabad",SIEL09,10,1000,820,180,1.15874855156431,4.18604651162791
2009,"IIIT, Hyderabad",SIEL09,11,1000,884,116,1.06837606837607,2.23076923076923
2009,"IIIT, Hyderabad",SIEL09,12,1000,667,333,1.27226463104326,2.79831932773109
2009,"IIIT, Hyderabad",SIEL09,13,1000,590,410,1.45985401459854,4.31578947368421
2009,"IIIT, Hyderabad",SIEL09,14,1000,793,207,1.14285714285714,2.52439024390244
2009,"IIIT, Hyderabad",SIEL09,15,1000,787,213,1.14678899082569,2.50588235294118
2009,"IIIT, Hyderabad",SIEL09,16,1000,784,216,1.15074798619102,2.54117647058824
2009,"IIIT, Hyderabad",SIEL09,17,1000,962,38,1.02040816326531,2.11111111111111
2009,"IIIT, Hyderabad",SIEL09,18,1000,879,121,1.08108108108108,2.6304347826087
2009,"IIIT, Hyderabad",SIEL09,19,1000,733,267,1.21951219512195,3.06896551724138
2009,"IIIT, Hyderabad",SIEL09,20,1000,834,166,1.12359550561798,2.96428571428571
2009,"IIIT, Hyderabad",SIEL09,21,1000,854,146,1.10619469026549,2.92
2009,"IIIT, Hyderabad",SIEL09,22,1000,889,111,1.07642626480086,2.775
2009,"IIIT, Hyderabad",SIEL09,23,1000,815,185,1.14025085518814,2.98387096774194
2009,"IIIT, Hyderabad",SIEL09,24,1000,812,188,1.13122171945701,2.61111111111111
2009,"IIIT, Hyderabad",SIEL09,25,1000,625,375,1.3262599469496,2.90697674418605
2009,"IIIT, Hyderabad",SIEL09,26,1000,887,113,1.07296137339056,2.51111111111111
2009,"IIIT, Hyderabad",SIEL09,27,1000,681,319,1.35869565217391,5.8
2009,"IIIT, Hyderabad",SIEL09,28,1000,593,407,1.45985401459854,4.42391304347826
2009,"IIIT, Hyderabad",SIEL09,29,1000,800,200,1.14155251141553,2.63157894736842
2009,"IIIT, Hyderabad",SIEL09,30,1000,880,120,1.07066381156317,2.22222222222222
2009,"IIIT, Hyderabad",SIEL09,31,1000,719,281,1.23609394313968,3.12222222222222
2009,"IIIT, Hyderabad",SIEL09,32,1000,859,141,1.07991360691145,2.1044776119403
2009,"IIIT, Hyderabad",SIEL09,33,1000,948,52,1.02986611740474,2.26086956521739
2009,"IIIT, Hyderabad",SIEL09,34,1000,850,150,1.10741971207087,2.83018867924528
2009,"IIIT, Hyderabad",SIEL09,35,1000,719,281,1.20772946859903,2.57798165137615
2009,"IIIT, Hyderabad",SIEL09,36,1000,902,98,1.07411385606874,3.37931034482759
2009,"IIIT, Hyderabad",SIEL09,37,1000,806,194,1.13895216400911,2.69444444444444
2009,"IIIT, Hyderabad",SIEL09,38,1000,837,163,1.11234705228031,2.62903225806452
2009,"IIIT, Hyderabad",SIEL09,39,1000,892,108,1.07066381156317,2.57142857142857
2009,"IIIT, Hyderabad",SIEL09,40,17,11,6,1.30769230769231,3
2009,"IIIT, Hyderabad",SIEL09,41,1000,833,167,1.09769484083425,2.14102564102564
2009,"IIIT, Hyderabad",SIEL09,42,1000,900,100,1.06382978723404,2.5
2009,"IIIT, Hyderabad",SIEL09,43,1000,851,149,1.10987791342952,2.98
2009,"IIIT, Hyderabad",SIEL09,44,1000,588,412,1.53139356814701,6.33846153846154
2009,"IIIT, Hyderabad",SIEL09,45,1000,831,169,1.12233445566779,2.81666666666667
2009,"IIIT, Hyderabad",SIEL09,46,1000,711,289,1.26582278481013,3.65822784810127
2009,"IIIT, Hyderabad",SIEL09,47,1000,705,295,1.2987012987013,4.53846153846154
2009,"IIIT, Hyderabad",SIEL09,48,1000,875,125,1.07991360691145,2.45098039215686
2009,"IIIT, Hyderabad",SIEL09,49,1000,839,161,1.10132158590308,2.33333333333333
2009,"IIIT, Hyderabad",SIEL09,50,1000,912,88,1.05708245243129,2.58823529411765
2009,Sabir Research,Sab9wtBase,1,1000,826,174,1.11982082866741,2.59701492537313
2009,Sabir Research,Sab9wtBase,2,1000,875,125,1.08108108108108,2.5
2009,Sabir Research,Sab9wtBase,3,1000,661,339,1.28369704749679,2.8728813559322
2009,Sabir Research,Sab9wtBase,4,1000,755,245,1.17785630153121,2.6063829787234
2009,Sabir Research,Sab9wtBase,5,1000,842,158,1.1001100110011,2.35820895522388
2009,Sabir Research,Sab9wtBase,6,1000,740,260,1.16009280742459,2.13114754098361
2009,Sabir Research,Sab9wtBase,7,1000,768,232,1.22399020807834,4.73469387755102
2009,Sabir Research,Sab9wtBase,8,1000,669,331,1.22699386503067,2.26712328767123
2009,Sabir Research,Sab9wtBase,9,1000,809,191,1.15340253748558,3.29310344827586
2009,Sabir Research,Sab9wtBase,10,1000,956,44,1.02669404517454,2.44444444444444
2009,Sabir Research,Sab9wtBase,11,1000,743,257,1.21359223300971,3.17283950617284
2009,Sabir Research,Sab9wtBase,12,1000,631,369,1.31061598951507,2.79545454545455
2009,Sabir Research,Sab9wtBase,13,1000,511,489,1.53139356814701,3.44366197183099
2009,Sabir Research,Sab9wtBase,14,1000,150,850,2.32558139534884,3.03571428571429
2009,Sabir Research,Sab9wtBase,15,1000,802,198,1.12866817155756,2.35714285714286
2009,Sabir Research,Sab9wtBase,16,1000,652,348,1.26742712294043,2.54014598540146
2009,Sabir Research,Sab9wtBase,17,1000,744,256,1.17508813160987,2.39252336448598
2009,Sabir Research,Sab9wtBase,18,1000,834,166,1.10132158590308,2.24324324324324
2009,Sabir Research,Sab9wtBase,19,1000,716,284,1.22100122100122,2.75728155339806
2009,Sabir Research,Sab9wtBase,20,1000,726,274,1.20192307692308,2.58490566037736
2009,Sabir Research,Sab9wtBase,21,1000,795,205,1.12866817155756,2.25274725274725
2009,Sabir Research,Sab9wtBase,22,1000,861,139,1.08459869848156,2.27868852459016
2009,Sabir Research,Sab9wtBase,23,1000,649,351,1.30039011703511,2.925
2009,Sabir Research,Sab9wtBase,24,1000,600,400,1.3262599469496,2.5974025974026
2009,Sabir Research,Sab9wtBase,25,1000,702,298,1.20918984280532,2.384
2009,Sabir Research,Sab9wtBase,26,1000,788,212,1.14155251141553,2.40909090909091
2009,Sabir Research,Sab9wtBase,27,1000,922,78,1.04493207941484,2.22857142857143
2009,Sabir Research,Sab9wtBase,28,1000,727,273,1.29032258064516,5.6875
2009,Sabir Research,Sab9wtBase,29,1000,831,169,1.12107623318386,2.77049180327869
2009,Sabir Research,Sab9wtBase,30,1000,625,375,1.25786163522013,2.20588235294118
2009,Sabir Research,Sab9wtBase,31,1000,591,409,1.50829562594268,5.68055555555556
2009,Sabir Research,Sab9wtBase,32,1000,717,283,1.18203309692671,2.1937984496124
2009,Sabir Research,Sab9wtBase,33,1000,922,78,1.04712041884817,2.36363636363636
2009,Sabir Research,Sab9wtBase,34,1000,366,634,2.13219616204691,6.15533980582524
2009,Sabir Research,Sab9wtBase,35,1000,696,304,1.21065375302663,2.33846153846154
2009,Sabir Research,Sab9wtBase,36,1000,708,292,1.30718954248366,5.12280701754386
2009,Sabir Research,Sab9wtBase,37,1000,897,103,1.05932203389831,2.19148936170213
2009,Sabir Research,Sab9wtBase,38,1000,747,253,1.15606936416185,2.14406779661017
2009,Sabir Research,Sab9wtBase,39,1000,680,320,1.30548302872063,3.72093023255814
2009,Sabir Research,Sab9wtBase,40,451,418,33,1.04883720930233,2.75
2009,Sabir Research,Sab9wtBase,41,1000,573,427,1.33689839572193,2.44
2009,Sabir Research,Sab9wtBase,42,1000,888,112,1.06609808102345,2.24
2009,Sabir Research,Sab9wtBase,43,1000,781,219,1.1441647597254,2.35483870967742
2009,Sabir Research,Sab9wtBase,44,1000,764,236,1.15874855156431,2.38383838383838
2009,Sabir Research,Sab9wtBase,45,1000,848,152,1.09409190371991,2.3030303030303
2009,Sabir Research,Sab9wtBase,46,1000,713,287,1.18343195266272,2.17424242424242
2009,Sabir Research,Sab9wtBase,47,1000,533,467,1.45985401459854,3.07236842105263
2009,Sabir Research,Sab9wtBase,48,1000,874,126,1.08108108108108,2.47058823529412
2009,Sabir Research,Sab9wtBase,49,1000,765,235,1.17370892018779,2.70114942528736
2009,Sabir Research,Sab9wtBase,50,1000,877,123,1.07411385606874,2.27777777777778
2009,Sabir Research,Sab9wtBf1,1,1000,923,77,1.04493207941484,2.26470588235294
2009,Sabir Research,Sab9wtBf1,2,1000,858,142,1.09170305676856,2.44827586206897
2009,Sabir Research,Sab9wtBf1,3,1000,709,291,1.23152709359606,2.8252427184466
2009,Sabir Research,Sab9wtBf1,4,1000,852,148,1.10864745011086,2.96
2009,Sabir Research,Sab9wtBf1,5,1000,812,188,1.12485939257593,2.44155844155844
2009,Sabir Research,Sab9wtBf1,6,1000,725,275,1.17233294255569,2.1484375
2009,Sabir Research,Sab9wtBf1,7,1000,950,50,1.02564102564103,2
2009,Sabir Research,Sab9wtBf1,8,1000,491,509,1.49925037481259,2.89204545454545
2009,Sabir Research,Sab9wtBf1,9,1000,762,238,1.22549019607843,4.40740740740741
2009,Sabir Research,Sab9wtBf1,10,1000,910,90,1.0482180293501,2.04545454545455
2009,Sabir Research,Sab9wtBf1,11,1000,740,260,1.21212121212121,3.05882352941176
2009,Sabir Research,Sab9wtBf1,12,1000,843,157,1.11856823266219,3.07843137254902
2009,Sabir Research,Sab9wtBf1,13,1000,682,318,1.25156445556946,2.71794871794872
2009,Sabir Research,Sab9wtBf1,14,1000,56,944,2.51256281407035,2.76023391812866
2009,Sabir Research,Sab9wtBf1,15,1000,828,172,1.11358574610245,2.45714285714286
2009,Sabir Research,Sab9wtBf1,16,1000,631,369,1.29366106080207,2.59859154929577
2009,Sabir Research,Sab9wtBf1,17,1000,835,165,1.10253583241455,2.29166666666667
2009,Sabir Research,Sab9wtBf1,18,1000,844,156,1.09769484083425,2.32835820895522
2009,Sabir Research,Sab9wtBf1,19,1000,819,181,1.12107623318386,2.47945205479452
2009,Sabir Research,Sab9wtBf1,20,1000,724,276,1.18203309692671,2.26229508196721
2009,Sabir Research,Sab9wtBf1,21,1000,891,109,1.07181136120043,2.5952380952381
2009,Sabir Research,Sab9wtBf1,22,1000,890,110,1.06496272630458,2.24489795918367
2009,Sabir Research,Sab9wtBf1,23,1000,759,241,1.17924528301887,2.70786516853933
2009,Sabir Research,Sab9wtBf1,24,1000,651,349,1.24688279301746,2.3112582781457
2009,Sabir Research,Sab9wtBf1,25,1000,744,256,1.16822429906542,2.28571428571429
2009,Sabir Research,Sab9wtBf1,26,1000,787,213,1.13895216400911,2.34065934065934
2009,Sabir Research,Sab9wtBf1,27,1000,909,91,1.06269925611052,2.84375
2009,Sabir Research,Sab9wtBf1,28,1000,698,302,1.3351134846462,5.92156862745098
2009,Sabir Research,Sab9wtBf1,29,1000,682,318,1.20481927710843,2.14864864864865
2009,Sabir Research,Sab9wtBf1,30,1000,573,427,1.31578947368421,2.28342245989305
2009,Sabir Research,Sab9wtBf1,31,1000,585,415,1.53609831029186,6.28787878787879
2009,Sabir Research,Sab9wtBf1,32,1000,706,294,1.19047619047619,2.19402985074627
2009,Sabir Research,Sab9wtBf1,33,1000,941,59,1.0351966873706,2.36
2009,Sabir Research,Sab9wtBf1,34,1000,486,514,1.71526586620926,5.29896907216495
2009,Sabir Research,Sab9wtBf1,35,1000,657,343,1.25156445556946,2.41549295774648
2009,Sabir Research,Sab9wtBf1,36,1000,809,191,1.20192307692308,8.30434782608696
2009,Sabir Research,Sab9wtBf1,37,1000,897,103,1.05932203389831,2.19148936170213
2009,Sabir Research,Sab9wtBf1,38,1000,791,209,1.14155251141553,2.45882352941177
2009,Sabir Research,Sab9wtBf1,39,1000,743,257,1.20772946859903,3.02352941176471
2009,Sabir Research,Sab9wtBf1,40,1000,396,604,1.85185185185185,4.19444444444444
2009,Sabir Research,Sab9wtBf1,41,1000,615,385,1.29198966408269,2.42138364779874
2009,Sabir Research,Sab9wtBf1,42,1000,871,129,1.08932461873638,2.74468085106383
2009,Sabir Research,Sab9wtBf1,43,1000,805,195,1.12739571589628,2.37804878048781
2009,Sabir Research,Sab9wtBf1,44,1000,704,296,1.23304562268804,2.76635514018692
2009,Sabir Research,Sab9wtBf1,45,1000,871,129,1.07874865156419,2.30357142857143
2009,Sabir Research,Sab9wtBf1,46,1000,713,287,1.18343195266272,2.17424242424242
2009,Sabir Research,Sab9wtBf1,47,1000,889,111,1.06837606837607,2.36170212765957
2009,Sabir Research,Sab9wtBf1,48,1000,905,95,1.05820105820106,2.375
2009,Sabir Research,Sab9wtBf1,49,1000,783,217,1.15874855156431,2.7125
2009,Sabir Research,Sab9wtBf1,50,1000,867,133,1.07874865156419,2.21666666666667
2009,Sabir Research,Sab9wtBf2,1,1000,874,126,1.08225108225108,2.52
2009,Sabir Research,Sab9wtBf2,2,1000,867,133,1.08695652173913,2.50943396226415
2009,Sabir Research,Sab9wtBf2,3,1000,700,300,1.24843945068664,2.97029702970297
2009,Sabir Research,Sab9wtBf2,4,1000,786,214,1.16144018583043,2.85333333333333
2009,Sabir Research,Sab9wtBf2,5,1000,858,142,1.08459869848156,2.21875
2009,Sabir Research,Sab9wtBf2,6,1000,735,265,1.16279069767442,2.12
2009,Sabir Research,Sab9wtBf2,7,1000,815,185,1.17647058823529,5.28571428571429
2009,Sabir Research,Sab9wtBf2,8,1000,647,353,1.24843945068664,2.29220779220779
2009,Sabir Research,Sab9wtBf2,9,1000,815,185,1.15074798619102,3.42592592592593
2009,Sabir Research,Sab9wtBf2,10,1000,960,40,1.02145045965271,2.10526315789474
2009,Sabir Research,Sab9wtBf2,11,1000,758,242,1.19760479041916,3.14285714285714
2009,Sabir Research,Sab9wtBf2,12,1000,636,364,1.30718954248366,2.82170542635659
2009,Sabir Research,Sab9wtBf2,13,1000,624,376,1.34408602150538,3.13333333333333
2009,Sabir Research,Sab9wtBf2,14,1000,64,936,2.41545893719807,2.67428571428571
2009,Sabir Research,Sab9wtBf2,15,1000,847,153,1.09769484083425,2.390625
2009,Sabir Research,Sab9wtBf2,16,1000,630,370,1.29533678756477,2.6056338028169
2009,Sabir Research,Sab9wtBf2,17,1000,831,169,1.10619469026549,2.31506849315069
2009,Sabir Research,Sab9wtBf2,18,1000,874,126,1.0752688172043,2.25
2009,Sabir Research,Sab9wtBf2,19,1000,820,180,1.12359550561798,2.57142857142857
2009,Sabir Research,Sab9wtBf2,20,1000,742,258,1.17096018735363,2.30357142857143
2009,Sabir Research,Sab9wtBf2,21,1000,875,125,1.07296137339056,2.19298245614035
2009,Sabir Research,Sab9wtBf2,22,1000,852,148,1.09529025191676,2.42622950819672
2009,Sabir Research,Sab9wtBf2,23,1000,693,307,1.24069478908189,2.71681415929204
2009,Sabir Research,Sab9wtBf2,24,1000,663,337,1.23152709359606,2.26174496644295
2009,Sabir Research,Sab9wtBf2,25,1000,724,276,1.18343195266272,2.28099173553719
2009,Sabir Research,Sab9wtBf2,26,1000,803,197,1.12866817155756,2.37349397590361
2009,Sabir Research,Sab9wtBf2,27,1000,935,65,1.03734439834025,2.24137931034483
2009,Sabir Research,Sab9wtBf2,28,1000,767,233,1.22699386503067,4.85416666666667
2009,Sabir Research,Sab9wtBf2,29,1000,856,144,1.09051254089422,2.36065573770492
2009,Sabir Research,Sab9wtBf2,30,1000,605,395,1.28205128205128,2.25714285714286
2009,Sabir Research,Sab9wtBf2,31,1000,636,364,1.41242937853107,5.05555555555556
2009,Sabir Research,Sab9wtBf2,32,1000,727,273,1.17647058823529,2.21951219512195
2009,Sabir Research,Sab9wtBf2,33,1000,934,66,1.03950103950104,2.35714285714286
2009,Sabir Research,Sab9wtBf2,34,1000,488,512,1.70357751277683,5.17171717171717
2009,Sabir Research,Sab9wtBf2,35,1000,700,300,1.20918984280532,2.36220472440945
2009,Sabir Research,Sab9wtBf2,36,1000,779,221,1.23456790123457,7.12903225806452
2009,Sabir Research,Sab9wtBf2,37,1000,899,101,1.05820105820106,2.19565217391304
2009,Sabir Research,Sab9wtBf2,38,1000,771,229,1.1441647597254,2.22330097087379
2009,Sabir Research,Sab9wtBf2,39,1000,698,302,1.28040973111396,3.63855421686747
2009,Sabir Research,Sab9wtBf2,40,1000,800,200,1.15740740740741,3.125
2009,Sabir Research,Sab9wtBf2,41,1000,573,427,1.34048257372654,2.46820809248555
2009,Sabir Research,Sab9wtBf2,42,1000,866,134,1.1001100110011,3.11627906976744
2009,Sabir Research,Sab9wtBf2,43,1000,804,196,1.12485939257593,2.30588235294118
2009,Sabir Research,Sab9wtBf2,44,1000,755,245,1.17508813160987,2.55208333333333
2009,Sabir Research,Sab9wtBf2,45,1000,878,122,1.07411385606874,2.30188679245283
2009,Sabir Research,Sab9wtBf2,46,1000,721,279,1.17785630153121,2.1796875
2009,Sabir Research,Sab9wtBf2,47,1000,766,234,1.16279069767442,2.48936170212766
2009,Sabir Research,Sab9wtBf2,48,1000,899,101,1.06609808102345,2.58974358974359
2009,Sabir Research,Sab9wtBf2,49,1000,786,214,1.15473441108545,2.675
2009,Sabir Research,Sab9wtBf2,50,1000,877,123,1.0752688172043,2.32075471698113
2009,Tsinghua University (Min Zhang),THUIR09An,1,235,235,0,1,
2009,Tsinghua University (Min Zhang),THUIR09An,2,136,130,6,1.02255639097744,2
2009,Tsinghua University (Min Zhang),THUIR09An,3,1000,980,20,1.01010101010101,2
2009,Tsinghua University (Min Zhang),THUIR09An,4,1000,719,281,1.18623962040332,2.26612903225806
2009,Tsinghua University (Min Zhang),THUIR09An,5,1000,972,28,1.01936799184506,3.11111111111111
2009,Tsinghua University (Min Zhang),THUIR09An,6,851,769,82,1.06508135168961,2.73333333333333
2009,Tsinghua University (Min Zhang),THUIR09An,7,1000,984,16,1.00806451612903,2
2009,Tsinghua University (Min Zhang),THUIR09An,8,1000,827,173,1.10497237569061,2.21794871794872
2009,Tsinghua University (Min Zhang),THUIR09An,9,1000,953,47,1.02564102564103,2.13636363636364
2009,Tsinghua University (Min Zhang),THUIR09An,10,1000,975,25,1.01419878296146,2.27272727272727
2009,Tsinghua University (Min Zhang),THUIR09An,11,37,37,0,1,
2009,Tsinghua University (Min Zhang),THUIR09An,12,1000,761,239,1.17233294255569,2.59782608695652
2009,Tsinghua University (Min Zhang),THUIR09An,13,1000,569,431,1.33689839572193,2.40782122905028
2009,Tsinghua University (Min Zhang),THUIR09An,14,1000,833,167,1.09529025191676,2.0875
2009,Tsinghua University (Min Zhang),THUIR09An,15,1000,968,32,1.02145045965271,2.90909090909091
2009,Tsinghua University (Min Zhang),THUIR09An,16,747,745,2,1.00134048257373,2
2009,Tsinghua University (Min Zhang),THUIR09An,17,1000,953,47,1.02459016393443,2.04347826086957
2009,Tsinghua University (Min Zhang),THUIR09An,18,151,151,0,1,
2009,Tsinghua University (Min Zhang),THUIR09An,19,1000,614,386,1.27551020408163,2.27058823529412
2009,Tsinghua University (Min Zhang),THUIR09An,20,1000,800,200,1.11856823266219,2.12765957446809
2009,Tsinghua University (Min Zhang),THUIR09An,21,1000,767,233,1.14285714285714,2.15740740740741
2009,Tsinghua University (Min Zhang),THUIR09An,22,1000,968,32,1.01626016260163,2
2009,Tsinghua University (Min Zhang),THUIR09An,23,1000,688,312,1.20048019207683,2.15172413793103
2009,Tsinghua University (Min Zhang),THUIR09An,24,1000,693,307,1.19331742243437,2.11724137931034
2009,Tsinghua University (Min Zhang),THUIR09An,25,1000,913,87,1.04602510460251,2.02325581395349
2009,Tsinghua University (Min Zhang),THUIR09An,26,543,541,2,1.00184501845018,2
2009,Tsinghua University (Min Zhang),THUIR09An,27,1000,830,170,1.10497237569061,2.26666666666667
2009,Tsinghua University (Min Zhang),THUIR09An,28,1000,794,206,1.13765642775882,2.42352941176471
2009,Tsinghua University (Min Zhang),THUIR09An,29,426,416,10,1.01187648456057,2
2009,Tsinghua University (Min Zhang),THUIR09An,30,1000,962,38,1.01936799184506,2
2009,Tsinghua University (Min Zhang),THUIR09An,31,1000,740,260,1.18764845605701,2.54901960784314
2009,Tsinghua University (Min Zhang),THUIR09An,32,1000,988,12,1.00603621730382,2
2009,Tsinghua University (Min Zhang),THUIR09An,33,1000,930,70,1.03842159916926,2.12121212121212
2009,Tsinghua University (Min Zhang),THUIR09An,34,1000,901,99,1.05485232067511,2.1063829787234
2009,Tsinghua University (Min Zhang),THUIR09An,35,1000,879,121,1.06837606837607,2.12280701754386
2009,Tsinghua University (Min Zhang),THUIR09An,36,1000,635,365,1.26422250316056,2.33974358974359
2009,Tsinghua University (Min Zhang),THUIR09An,37,1000,906,94,1.05932203389831,2.47368421052632
2009,Tsinghua University (Min Zhang),THUIR09An,38,1000,963,37,1.01936799184506,2.05555555555556
2009,Tsinghua University (Min Zhang),THUIR09An,39,1000,935,65,1.0351966873706,2.09677419354839
2009,Tsinghua University (Min Zhang),THUIR09An,40,21,21,0,1,
2009,Tsinghua University (Min Zhang),THUIR09An,41,402,402,0,1,
2009,Tsinghua University (Min Zhang),THUIR09An,42,1000,944,56,1.03412616339193,2.43478260869565
2009,Tsinghua University (Min Zhang),THUIR09An,43,1000,956,44,1.02459016393443,2.2
2009,Tsinghua University (Min Zhang),THUIR09An,44,1000,952,48,1.02880658436214,2.4
2009,Tsinghua University (Min Zhang),THUIR09An,45,1000,883,117,1.08108108108108,2.78571428571429
2009,Tsinghua University (Min Zhang),THUIR09An,46,71,71,0,1,
2009,Tsinghua University (Min Zhang),THUIR09An,47,178,178,0,1,
2009,Tsinghua University (Min Zhang),THUIR09An,48,601,546,55,1.05438596491228,2.29166666666667
2009,Tsinghua University (Min Zhang),THUIR09An,49,290,288,2,1.00346020761246,2
2009,Tsinghua University (Min Zhang),THUIR09An,50,1000,975,25,1.01522842639594,2.5
2009,Tsinghua University (Min Zhang),THUIR09LuTA,1,1000,964,36,1.02669404517454,3.6
2009,Tsinghua University (Min Zhang),THUIR09LuTA,2,1000,937,63,1.04166666666667,2.73913043478261
2009,Tsinghua University (Min Zhang),THUIR09LuTA,3,1000,990,10,1.00704934541793,3.33333333333333
2009,Tsinghua University (Min Zhang),THUIR09LuTA,4,1000,979,21,1.01214574898785,2.33333333333333
2009,Tsinghua University (Min Zhang),THUIR09LuTA,5,1000,976,24,1.01317122593718,2.18181818181818
2009,Tsinghua University (Min Zhang),THUIR09LuTA,6,1000,905,95,1.06044538706257,2.5
2009,Tsinghua University (Min Zhang),THUIR09LuTA,7,1000,953,47,1.0351966873706,3.61538461538462
2009,Tsinghua University (Min Zhang),THUIR09LuTA,8,1000,978,22,1.01522842639594,3.14285714285714
2009,Tsinghua University (Min Zhang),THUIR09LuTA,9,1000,1000,0,1,
2009,Tsinghua University (Min Zhang),THUIR09LuTA,10,1000,975,25,1.01626016260163,2.77777777777778
2009,Tsinghua University (Min Zhang),THUIR09LuTA,11,1000,561,439,1.63132137030995,8.44230769230769
2009,Tsinghua University (Min Zhang),THUIR09LuTA,12,1000,996,4,1.00200400801603,2
2009,Tsinghua University (Min Zhang),THUIR09LuTA,13,1000,814,186,1.16822429906542,4.42857142857143
2009,Tsinghua University (Min Zhang),THUIR09LuTA,14,1000,993,7,1.00401606425703,2.33333333333333
2009,Tsinghua University (Min Zhang),THUIR09LuTA,15,1000,993,7,1.00401606425703,2.33333333333333
2009,Tsinghua University (Min Zhang),THUIR09LuTA,16,1000,975,25,1.01419878296146,2.27272727272727
2009,Tsinghua University (Min Zhang),THUIR09LuTA,17,1000,996,4,1.00200400801603,2
2009,Tsinghua University (Min Zhang),THUIR09LuTA,18,1000,981,19,1.01112234580384,2.375
2009,Tsinghua University (Min Zhang),THUIR09LuTA,19,1000,900,100,1.07181136120043,3.03030303030303
2009,Tsinghua University (Min Zhang),THUIR09LuTA,20,1000,992,8,1.00401606425703,2
2009,Tsinghua University (Min Zhang),THUIR09LuTA,21,1000,989,11,1.00704934541793,2.75
2009,Tsinghua University (Min Zhang),THUIR09LuTA,22,1000,996,4,1.00200400801603,2
2009,Tsinghua University (Min Zhang),THUIR09LuTA,23,1000,967,33,1.01936799184506,2.35714285714286
2009,Tsinghua University (Min Zhang),THUIR09LuTA,24,1000,992,8,1.00401606425703,2
2009,Tsinghua University (Min Zhang),THUIR09LuTA,25,1000,996,4,1.00200400801603,2
2009,Tsinghua University (Min Zhang),THUIR09LuTA,26,1000,979,21,1.01522842639594,3.5
2009,Tsinghua University (Min Zhang),THUIR09LuTA,27,1000,963,37,1.02986611740474,4.625
2009,Tsinghua University (Min Zhang),THUIR09LuTA,28,1000,973,27,1.01626016260163,2.45454545454545
2009,Tsinghua University (Min Zhang),THUIR09LuTA,29,1000,951,49,1.02774922918808,2.22727272727273
2009,Tsinghua University (Min Zhang),THUIR09LuTA,30,1000,974,26,1.01729399796541,2.88888888888889
2009,Tsinghua University (Min Zhang),THUIR09LuTA,31,1000,945,55,1.03305785123967,2.39130434782609
2009,Tsinghua University (Min Zhang),THUIR09LuTA,32,1000,996,4,1.00200400801603,2
2009,Tsinghua University (Min Zhang),THUIR09LuTA,33,1000,988,12,1.00704934541793,2.4
2009,Tsinghua University (Min Zhang),THUIR09LuTA,34,1000,998,2,1.001001001001,2
2009,Tsinghua University (Min Zhang),THUIR09LuTA,35,1000,993,7,1.00401606425703,2.33333333333333
2009,Tsinghua University (Min Zhang),THUIR09LuTA,36,1000,976,24,1.0183299389002,4
2009,Tsinghua University (Min Zhang),THUIR09LuTA,37,1000,996,4,1.00200400801603,2
2009,Tsinghua University (Min Zhang),THUIR09LuTA,38,1000,990,10,1.00502512562814,2
2009,Tsinghua University (Min Zhang),THUIR09LuTA,39,1000,985,15,1.00806451612903,2.14285714285714
2009,Tsinghua University (Min Zhang),THUIR09LuTA,40,1000,899,101,1.06723585912487,2.65789473684211
2009,Tsinghua University (Min Zhang),THUIR09LuTA,41,1000,923,77,1.06723585912487,5.5
2009,Tsinghua University (Min Zhang),THUIR09LuTA,42,1000,979,21,1.01317122593718,2.625
2009,Tsinghua University (Min Zhang),THUIR09LuTA,43,1000,987,13,1.00704934541793,2.16666666666667
2009,Tsinghua University (Min Zhang),THUIR09LuTA,44,1000,943,57,1.04166666666667,3.35294117647059
2009,Tsinghua University (Min Zhang),THUIR09LuTA,45,1000,960,40,1.02354145342886,2.35294117647059
2009,Tsinghua University (Min Zhang),THUIR09LuTA,46,1000,936,64,1.04166666666667,2.66666666666667
2009,Tsinghua University (Min Zhang),THUIR09LuTA,47,1000,918,82,1.05596620908131,2.82758620689655
2009,Tsinghua University (Min Zhang),THUIR09LuTA,48,1000,941,59,1.03734439834025,2.56521739130435
2009,Tsinghua University (Min Zhang),THUIR09LuTA,49,1000,941,59,1.0351966873706,2.36
2009,Tsinghua University (Min Zhang),THUIR09LuTA,50,1000,954,46,1.02880658436214,2.55555555555556
2009,Tsinghua University (Min Zhang),THUIR09TxAn,1,1000,962,38,1.02145045965271,2.23529411764706
2009,Tsinghua University (Min Zhang),THUIR09TxAn,2,1000,980,20,1.01214574898785,2.5
2009,Tsinghua University (Min Zhang),THUIR09TxAn,3,1000,986,14,1.00704934541793,2
2009,Tsinghua University (Min Zhang),THUIR09TxAn,4,1000,909,91,1.05042016806723,2.11627906976744
2009,Tsinghua University (Min Zhang),THUIR09TxAn,5,1000,982,18,1.00908173562059,2
2009,Tsinghua University (Min Zhang),THUIR09TxAn,6,1000,978,22,1.01112234580384,2
2009,Tsinghua University (Min Zhang),THUIR09TxAn,7,1000,964,36,1.01936799184506,2.11764705882353
2009,Tsinghua University (Min Zhang),THUIR09TxAn,8,1000,938,62,1.03412616339193,2.13793103448276
2009,Tsinghua University (Min Zhang),THUIR09TxAn,9,1000,982,18,1.00908173562059,2
2009,Tsinghua University (Min Zhang),THUIR09TxAn,10,1000,492,508,1.83150183150183,9.40740740740741
2009,Tsinghua University (Min Zhang),THUIR09TxAn,11,1000,862,138,1.1001100110011,2.93617021276596
2009,Tsinghua University (Min Zhang),THUIR09TxAn,12,1000,885,115,1.09170305676856,3.70967741935484
2009,Tsinghua University (Min Zhang),THUIR09TxAn,13,1000,848,152,1.09051254089422,2.20289855072464
2009,Tsinghua University (Min Zhang),THUIR09TxAn,14,1000,964,36,1.0183299389002,2
2009,Tsinghua University (Min Zhang),THUIR09TxAn,15,1000,976,24,1.01317122593718,2.18181818181818
2009,Tsinghua University (Min Zhang),THUIR09TxAn,16,1000,990,10,1.00502512562814,2
2009,Tsinghua University (Min Zhang),THUIR09TxAn,17,1000,975,25,1.01317122593718,2.08333333333333
2009,Tsinghua University (Min Zhang),THUIR09TxAn,18,1000,976,24,1.01214574898785,2
2009,Tsinghua University (Min Zhang),THUIR09TxAn,19,1000,866,134,1.0752688172043,2.09375
2009,Tsinghua University (Min Zhang),THUIR09TxAn,20,1000,953,47,1.02459016393443,2.04347826086957
2009,Tsinghua University (Min Zhang),THUIR09TxAn,21,1000,931,69,1.03626943005181,2.02941176470588
2009,Tsinghua University (Min Zhang),THUIR09TxAn,22,1000,994,6,1.00300902708124,2
2009,Tsinghua University (Min Zhang),THUIR09TxAn,23,1000,933,67,1.0351966873706,2.03030303030303
2009,Tsinghua University (Min Zhang),THUIR09TxAn,24,1000,915,85,1.04493207941484,2.02380952380952
2009,Tsinghua University (Min Zhang),THUIR09TxAn,25,1000,962,38,1.01936799184506,2
2009,Tsinghua University (Min Zhang),THUIR09TxAn,26,1000,984,16,1.00806451612903,2
2009,Tsinghua University (Min Zhang),THUIR09TxAn,27,1000,928,72,1.03734439834025,2
2009,Tsinghua University (Min Zhang),THUIR09TxAn,28,1000,873,127,1.07991360691145,2.39622641509434
2009,Tsinghua University (Min Zhang),THUIR09TxAn,29,1000,958,42,1.02249488752556,2.1
2009,Tsinghua University (Min Zhang),THUIR09TxAn,30,1000,976,24,1.01214574898785,2
2009,Tsinghua University (Min Zhang),THUIR09TxAn,31,1000,911,89,1.04931794333683,2.11904761904762
2009,Tsinghua University (Min Zhang),THUIR09TxAn,32,1000,971,29,1.01522842639594,2.07142857142857
2009,Tsinghua University (Min Zhang),THUIR09TxAn,33,1000,980,20,1.01010101010101,2
2009,Tsinghua University (Min Zhang),THUIR09TxAn,34,1000,938,62,1.03199174406605,2
2009,Tsinghua University (Min Zhang),THUIR09TxAn,35,1000,936,64,1.03626943005181,2.20689655172414
2009,Tsinghua University (Min Zhang),THUIR09TxAn,36,1000,881,119,1.06382978723404,2.01694915254237
2009,Tsinghua University (Min Zhang),THUIR09TxAn,37,1000,981,19,1.01010101010101,2.11111111111111
2009,Tsinghua University (Min Zhang),THUIR09TxAn,38,1000,955,45,1.03199174406605,3.21428571428571
2009,Tsinghua University (Min Zhang),THUIR09TxAn,39,1000,976,24,1.01419878296146,2.4
2009,Tsinghua University (Min Zhang),THUIR09TxAn,40,1000,940,60,1.03412616339193,2.22222222222222
2009,Tsinghua University (Min Zhang),THUIR09TxAn,41,1000,922,78,1.05374077976818,2.88888888888889
2009,Tsinghua University (Min Zhang),THUIR09TxAn,42,1000,965,35,1.01936799184506,2.1875
2009,Tsinghua University (Min Zhang),THUIR09TxAn,43,1000,974,26,1.01522842639594,2.36363636363636
2009,Tsinghua University (Min Zhang),THUIR09TxAn,44,1000,909,91,1.06157112526539,2.75757575757576
2009,Tsinghua University (Min Zhang),THUIR09TxAn,45,1000,941,59,1.03412616339193,2.26923076923077
2009,Tsinghua University (Min Zhang),THUIR09TxAn,46,1000,988,12,1.00603621730382,2
2009,Tsinghua University (Min Zhang),THUIR09TxAn,47,1000,740,260,1.30378096479791,9.62962962962963
2009,Tsinghua University (Min Zhang),THUIR09TxAn,48,1000,962,38,1.02040816326531,2.11111111111111
2009,Tsinghua University (Min Zhang),THUIR09TxAn,49,1000,970,30,1.01522842639594,2
2009,Tsinghua University (Min Zhang),THUIR09TxAn,50,1000,960,40,1.02354145342886,2.35294117647059
2009,"SCSI, University College Dublin",UCDSIFTinter,1,1000,170,830,3.37837837837838,6.58730158730159
2009,"SCSI, University College Dublin",UCDSIFTinter,2,1000,161,839,3.66300366300366,7.49107142857143
2009,"SCSI, University College Dublin",UCDSIFTinter,3,1000,104,896,5.71428571428571,12.6197183098592
2009,"SCSI, University College Dublin",UCDSIFTinter,4,1000,87,913,6.49350649350649,13.6268656716418
2009,"SCSI, University College Dublin",UCDSIFTinter,5,1000,181,819,3.003003003003,5.38815789473684
2009,"SCSI, University College Dublin",UCDSIFTinter,6,1000,122,878,4.60829493087558,9.24210526315789
2009,"SCSI, University College Dublin",UCDSIFTinter,7,1000,141,859,3.87596899224806,7.34188034188034
2009,"SCSI, University College Dublin",UCDSIFTinter,8,1000,57,943,8.92857142857143,17.1454545454545
2009,"SCSI, University College Dublin",UCDSIFTinter,9,1000,155,845,3.53356890459364,6.6015625
2009,"SCSI, University College Dublin",UCDSIFTinter,10,1000,120,880,4.80769230769231,10
2009,"SCSI, University College Dublin",UCDSIFTinter,11,1000,166,834,3.80228136882129,8.5979381443299
2009,"SCSI, University College Dublin",UCDSIFTinter,12,1000,59,941,8.84955752212389,17.4259259259259
2009,"SCSI, University College Dublin",UCDSIFTinter,13,1000,99,901,6.45161290322581,16.0892857142857
2009,"SCSI, University College Dublin",UCDSIFTinter,14,1000,92,908,6.41025641025641,14.1875
2009,"SCSI, University College Dublin",UCDSIFTinter,15,1000,89,911,6.36942675159236,13.3970588235294
2009,"SCSI, University College Dublin",UCDSIFTinter,16,1000,217,783,2.67379679144385,4.98726114649682
2009,"SCSI, University College Dublin",UCDSIFTinter,17,1000,78,922,6.89655172413793,13.7611940298507
2009,"SCSI, University College Dublin",UCDSIFTinter,18,1000,181,819,3.15457413249211,6.02205882352941
2009,"SCSI, University College Dublin",UCDSIFTinter,19,1000,105,895,4.97512437810945,9.32291666666667
2009,"SCSI, University College Dublin",UCDSIFTinter,20,1000,104,896,4.97512437810945,9.23711340206185
2009,"SCSI, University College Dublin",UCDSIFTinter,21,1000,81,919,6.84931506849315,14.1384615384615
2009,"SCSI, University College Dublin",UCDSIFTinter,22,1000,143,857,4.03225806451613,8.16190476190476
2009,"SCSI, University College Dublin",UCDSIFTinter,23,1000,78,922,7.93650793650794,19.2083333333333
2009,"SCSI, University College Dublin",UCDSIFTinter,24,1000,138,862,4.16666666666667,8.45098039215686
2009,"SCSI, University College Dublin",UCDSIFTinter,25,1000,127,873,4.80769230769231,10.7777777777778
2009,"SCSI, University College Dublin",UCDSIFTinter,26,1000,238,762,2.42130750605327,4.35428571428571
2009,"SCSI, University College Dublin",UCDSIFTinter,27,1000,96,904,5.3475935828877,9.93406593406593
2009,"SCSI, University College Dublin",UCDSIFTinter,28,1000,100,900,5.37634408602151,10.4651162790698
2009,"SCSI, University College Dublin",UCDSIFTinter,29,1000,195,805,2.98507462686567,5.75
2009,"SCSI, University College Dublin",UCDSIFTinter,30,1000,142,858,3.86100386100386,7.33333333333333
2009,"SCSI, University College Dublin",UCDSIFTinter,31,1000,59,941,8.7719298245614,17.1090909090909
2009,"SCSI, University College Dublin",UCDSIFTinter,32,1000,208,792,2.93255131964809,5.95488721804511
2009,"SCSI, University College Dublin",UCDSIFTinter,33,1000,130,870,4.60829493087558,10
2009,"SCSI, University College Dublin",UCDSIFTinter,34,1000,121,879,4.80769230769231,10.1034482758621
2009,"SCSI, University College Dublin",UCDSIFTinter,35,1000,103,897,5.26315789473684,10.3103448275862
2009,"SCSI, University College Dublin",UCDSIFTinter,36,1000,76,924,6.25,11
2009,"SCSI, University College Dublin",UCDSIFTinter,37,1000,115,885,4.60829493087558,8.67647058823529
2009,"SCSI, University College Dublin",UCDSIFTinter,38,1000,109,891,5.58659217877095,12.7285714285714
2009,"SCSI, University College Dublin",UCDSIFTinter,39,1000,153,847,3.64963503649635,7
2009,"SCSI, University College Dublin",UCDSIFTinter,40,163,69,94,1.75268817204301,3.91666666666667
2009,"SCSI, University College Dublin",UCDSIFTinter,41,1000,188,812,2.89017341040462,5.13924050632911
2009,"SCSI, University College Dublin",UCDSIFTinter,42,1000,187,813,3.25732899022801,6.775
2009,"SCSI, University College Dublin",UCDSIFTinter,43,1000,174,826,3.40136054421769,6.88333333333333
2009,"SCSI, University College Dublin",UCDSIFTinter,44,1000,144,856,3.42465753424658,5.78378378378378
2009,"SCSI, University College Dublin",UCDSIFTinter,45,1000,158,842,3.84615384615385,8.25490196078432
2009,"SCSI, University College Dublin",UCDSIFTinter,46,1000,136,864,4.29184549356223,8.90721649484536
2009,"SCSI, University College Dublin",UCDSIFTinter,47,1000,176,824,3.3112582781457,6.53968253968254
2009,"SCSI, University College Dublin",UCDSIFTinter,48,1000,141,859,4.52488687782805,10.7375
2009,"SCSI, University College Dublin",UCDSIFTinter,49,1000,240,760,2.42130750605327,4.39306358381503
2009,"SCSI, University College Dublin",UCDSIFTinter,50,1000,198,802,3.15457413249211,6.73949579831933
2009,"SCSI, University College Dublin",UCDSIFTprob,1,1000,305,695,2.17391304347826,4.48387096774194
2009,"SCSI, University College Dublin",UCDSIFTprob,2,1000,250,750,2.73972602739726,6.52173913043478
2009,"SCSI, University College Dublin",UCDSIFTprob,3,1000,19,981,10.6382978723404,13.08
2009,"SCSI, University College Dublin",UCDSIFTprob,4,1000,23,977,9.25925925925926,11.4941176470588
2009,"SCSI, University College Dublin",UCDSIFTprob,5,1000,459,541,1.53374233128834,2.80310880829016
2009,"SCSI, University College Dublin",UCDSIFTprob,6,1000,74,926,4.80769230769231,6.91044776119403
2009,"SCSI, University College Dublin",UCDSIFTprob,7,1000,184,816,2.71739130434783,4.43478260869565
2009,"SCSI, University College Dublin",UCDSIFTprob,8,1000,0,1000,58.8235294117647,58.8235294117647
2009,"SCSI, University College Dublin",UCDSIFTprob,9,1000,208,792,2.4330900243309,3.90147783251232
2009,"SCSI, University College Dublin",UCDSIFTprob,10,1000,140,860,3.54609929078014,6.05633802816901
2009,"SCSI, University College Dublin",UCDSIFTprob,11,1000,237,763,2.52525252525253,4.79874213836478
2009,"SCSI, University College Dublin",UCDSIFTprob,12,1000,7,993,22.2222222222222,26.1315789473684
2009,"SCSI, University College Dublin",UCDSIFTprob,13,1000,0,1000,58.8235294117647,58.8235294117647
2009,"SCSI, University College Dublin",UCDSIFTprob,14,1000,17,983,11.4942528735632,14.0428571428571
2009,"SCSI, University College Dublin",UCDSIFTprob,15,1000,17,983,14.7058823529412,19.2745098039216
2009,"SCSI, University College Dublin",UCDSIFTprob,16,1000,485,515,1.58227848101266,3.50340136054422
2009,"SCSI, University College Dublin",UCDSIFTprob,17,1000,40,960,11.1111111111111,19.2
2009,"SCSI, University College Dublin",UCDSIFTprob,18,1000,311,689,2.01207243460765,3.70430107526882
2009,"SCSI, University College Dublin",UCDSIFTprob,19,1000,45,955,5.58659217877095,7.12686567164179
2009,"SCSI, University College Dublin",UCDSIFTprob,20,1000,111,889,3.96825396825397,6.30496453900709
2009,"SCSI, University College Dublin",UCDSIFTprob,21,1000,31,969,9.43396226415094,12.92
2009,"SCSI, University College Dublin",UCDSIFTprob,22,1000,125,875,3.7037037037037,6.03448275862069
2009,"SCSI, University College Dublin",UCDSIFTprob,23,1000,4,996,25.6410256410256,28.4571428571429
2009,"SCSI, University College Dublin",UCDSIFTprob,24,1000,154,846,2.80898876404494,4.18811881188119
2009,"SCSI, University College Dublin",UCDSIFTprob,25,1000,75,925,4.52488687782805,6.33561643835617
2009,"SCSI, University College Dublin",UCDSIFTprob,26,1000,632,368,1.32275132275132,2.96774193548387
2009,"SCSI, University College Dublin",UCDSIFTprob,27,1000,50,950,6.17283950617284,8.48214285714286
2009,"SCSI, University College Dublin",UCDSIFTprob,28,1000,25,975,8.92857142857143,11.2068965517241
2009,"SCSI, University College Dublin",UCDSIFTprob,29,1000,262,738,2.32558139534884,4.39285714285714
2009,"SCSI, University College Dublin",UCDSIFTprob,30,1000,119,881,4.08163265306122,6.99206349206349
2009,"SCSI, University College Dublin",UCDSIFTprob,31,1000,14,986,26.3157894736842,41.0833333333333
2009,"SCSI, University College Dublin",UCDSIFTprob,32,1000,389,611,1.66666666666667,2.8957345971564
2009,"SCSI, University College Dublin",UCDSIFTprob,33,1000,80,920,4.76190476190476,7.07692307692308
2009,"SCSI, University College Dublin",UCDSIFTprob,34,1000,56,944,5.43478260869565,7.375
2009,"SCSI, University College Dublin",UCDSIFTprob,35,1000,50,950,5.84795321637427,7.85123966942149
2009,"SCSI, University College Dublin",UCDSIFTprob,36,1000,15,985,12.8205128205128,15.6349206349206
2009,"SCSI, University College Dublin",UCDSIFTprob,37,1000,89,911,4.50450450450451,6.84962406015038
2009,"SCSI, University College Dublin",UCDSIFTprob,38,1000,75,925,5.4945054945055,8.64485981308411
2009,"SCSI, University College Dublin",UCDSIFTprob,39,1000,244,756,2.2883295194508,3.91709844559586
2009,"SCSI, University College Dublin",UCDSIFTprob,40,163,68,95,1.63,2.96875
2009,"SCSI, University College Dublin",UCDSIFTprob,41,1000,487,513,1.5527950310559,3.26751592356688
2009,"SCSI, University College Dublin",UCDSIFTprob,42,1000,310,690,2.04918032786885,3.87640449438202
2009,"SCSI, University College Dublin",UCDSIFTprob,43,1000,292,708,2.04081632653061,3.57575757575758
2009,"SCSI, University College Dublin",UCDSIFTprob,44,1000,362,638,1.84842883548983,3.56424581005587
2009,"SCSI, University College Dublin",UCDSIFTprob,45,1000,221,779,2.52525252525253,4.45142857142857
2009,"SCSI, University College Dublin",UCDSIFTprob,46,1000,150,850,3.33333333333333,5.66666666666667
2009,"SCSI, University College Dublin",UCDSIFTprob,47,1000,289,711,2.14132762312634,3.99438202247191
2009,"SCSI, University College Dublin",UCDSIFTprob,48,1000,118,882,4.03225806451613,6.78461538461538
2009,"SCSI, University College Dublin",UCDSIFTprob,49,1000,620,380,1.33155792276964,2.90076335877863
2009,"SCSI, University College Dublin",UCDSIFTprob,50,1000,317,683,1.90839694656489,3.29951690821256
2009,"SCSI, University College Dublin",UCDSIFTslide,1,1000,281,719,2.42130750605327,5.4469696969697
2009,"SCSI, University College Dublin",UCDSIFTslide,2,1000,297,703,2.24215246636771,4.71812080536913
2009,"SCSI, University College Dublin",UCDSIFTslide,3,1000,258,742,2.5,5.22535211267606
2009,"SCSI, University College Dublin",UCDSIFTslide,4,1000,226,774,2.89017341040462,6.45
2009,"SCSI, University College Dublin",UCDSIFTslide,5,1000,376,624,1.8348623853211,3.69230769230769
2009,"SCSI, University College Dublin",UCDSIFTslide,6,1000,279,721,2.27272727272727,4.47826086956522
2009,"SCSI, University College Dublin",UCDSIFTslide,7,1000,292,708,2.3094688221709,5.02127659574468
2009,"SCSI, University College Dublin",UCDSIFTslide,8,1000,93,907,4.40528634361233,6.76865671641791
2009,"SCSI, University College Dublin",UCDSIFTslide,9,1000,302,698,2.2271714922049,4.74829931972789
2009,"SCSI, University College Dublin",UCDSIFTslide,10,1000,279,721,2.25733634311512,4.39634146341463
2009,"SCSI, University College Dublin",UCDSIFTslide,11,1000,236,764,2.67379679144385,5.53623188405797
2009,"SCSI, University College Dublin",UCDSIFTslide,12,1000,93,907,4.40528634361233,6.76865671641791
2009,"SCSI, University College Dublin",UCDSIFTslide,13,1000,156,844,2.9940119760479,4.74157303370787
2009,"SCSI, University College Dublin",UCDSIFTslide,14,1000,148,852,3.50877192982456,6.21897810218978
2009,"SCSI, University College Dublin",UCDSIFTslide,15,1000,111,889,4.20168067226891,7
2009,"SCSI, University College Dublin",UCDSIFTslide,16,1000,391,609,1.85528756957328,4.11486486486487
2009,"SCSI, University College Dublin",UCDSIFTslide,17,1000,168,832,3.43642611683849,6.76422764227642
2009,"SCSI, University College Dublin",UCDSIFTslide,18,1000,338,662,2.02429149797571,4.24358974358974
2009,"SCSI, University College Dublin",UCDSIFTslide,19,1000,215,785,2.91545189504373,6.1328125
2009,"SCSI, University College Dublin",UCDSIFTslide,20,1000,240,760,2.67379679144385,5.67164179104478
2009,"SCSI, University College Dublin",UCDSIFTslide,21,1000,209,791,2.9940119760479,6.328
2009,"SCSI, University College Dublin",UCDSIFTslide,22,1000,286,714,2.17864923747277,4.1271676300578
2009,"SCSI, University College Dublin",UCDSIFTslide,23,1000,146,854,3.20512820512821,5.14457831325301
2009,"SCSI, University College Dublin",UCDSIFTslide,24,1000,290,710,2.2271714922049,4.46540880503145
2009,"SCSI, University College Dublin",UCDSIFTslide,25,1000,203,797,2.89017341040462,5.57342657342657
2009,"SCSI, University College Dublin",UCDSIFTslide,26,1000,394,606,1.7921146953405,3.69512195121951
2009,"SCSI, University College Dublin",UCDSIFTslide,27,1000,203,797,2.84900284900285,5.38513513513514
2009,"SCSI, University College Dublin",UCDSIFTslide,28,1000,285,715,2.23713646532438,4.41358024691358
2009,"SCSI, University College Dublin",UCDSIFTslide,29,1000,304,696,2.2271714922049,4.8
2009,"SCSI, University College Dublin",UCDSIFTslide,30,1000,302,698,2.16919739696312,4.38993710691824
2009,"SCSI, University College Dublin",UCDSIFTslide,31,1000,93,907,4.3859649122807,6.71851851851852
2009,"SCSI, University College Dublin",UCDSIFTslide,32,1000,344,656,2.03252032520325,4.43243243243243
2009,"SCSI, University College Dublin",UCDSIFTslide,33,1000,296,704,2.34192037470726,5.37404580152672
2009,"SCSI, University College Dublin",UCDSIFTslide,34,1000,352,648,2,4.37837837837838
2009,"SCSI, University College Dublin",UCDSIFTslide,35,1000,233,767,2.55754475703325,4.85443037974684
2009,"SCSI, University College Dublin",UCDSIFTslide,36,1000,248,752,2.38095238095238,4.37209302325581
2009,"SCSI, University College Dublin",UCDSIFTslide,37,1000,327,673,2.02429149797571,4.02994011976048
2009,"SCSI, University College Dublin",UCDSIFTslide,38,1000,172,828,3.52112676056338,7.39285714285714
2009,"SCSI, University College Dublin",UCDSIFTslide,39,1000,302,698,2.24215246636771,4.84722222222222
2009,"SCSI, University College Dublin",UCDSIFTslide,40,163,87,76,1.38135593220339,2.45161290322581
2009,"SCSI, University College Dublin",UCDSIFTslide,41,1000,390,610,1.86567164179104,4.17808219178082
2009,"SCSI, University College Dublin",UCDSIFTslide,42,1000,327,673,2.22222222222222,5.47154471544716
2009,"SCSI, University College Dublin",UCDSIFTslide,43,1000,325,675,2.05761316872428,4.19254658385093
2009,"SCSI, University College Dublin",UCDSIFTslide,44,1000,335,665,2.05338809034908,4.375
2009,"SCSI, University College Dublin",UCDSIFTslide,45,1000,260,740,2.48756218905473,5.2112676056338
2009,"SCSI, University College Dublin",UCDSIFTslide,46,1000,282,718,2.2883295194508,4.63225806451613
2009,"SCSI, University College Dublin",UCDSIFTslide,47,1000,353,647,1.97628458498024,4.22875816993464
2009,"SCSI, University College Dublin",UCDSIFTslide,48,1000,192,808,2.86532951289398,5.14649681528662
2009,"SCSI, University College Dublin",UCDSIFTslide,49,1000,369,631,1.93798449612403,4.29251700680272
2009,"SCSI, University College Dublin",UCDSIFTslide,50,1000,320,680,2.06611570247934,4.14634146341463
2009,University of Delaware (Fang),UDWAxBL,1,1000,912,88,1.04931794333683,2.14634146341463
2009,University of Delaware (Fang),UDWAxBL,2,1000,913,87,1.04931794333683,2.175
2009,University of Delaware (Fang),UDWAxBL,3,1000,783,217,1.12994350282486,2.12745098039216
2009,University of Delaware (Fang),UDWAxBL,4,1000,882,118,1.06496272630458,2.07017543859649
2009,University of Delaware (Fang),UDWAxBL,5,1000,903,97,1.05263157894737,2.06382978723404
2009,University of Delaware (Fang),UDWAxBL,6,1000,897,103,1.05485232067511,2.01960784313725
2009,University of Delaware (Fang),UDWAxBL,7,1000,781,219,1.13507377979569,2.19
2009,University of Delaware (Fang),UDWAxBL,8,1000,793,207,1.11856823266219,2.04950495049505
2009,University of Delaware (Fang),UDWAxBL,9,1000,653,347,1.24688279301746,2.32885906040268
2009,University of Delaware (Fang),UDWAxBL,10,1000,804,196,1.11856823266219,2.17777777777778
2009,University of Delaware (Fang),UDWAxBL,11,1000,970,30,1.01522842639594,2
2009,University of Delaware (Fang),UDWAxBL,12,1000,516,484,1.39275766016713,2.3960396039604
2009,University of Delaware (Fang),UDWAxBL,13,1000,133,867,2.97619047619048,4.27093596059113
2009,University of Delaware (Fang),UDWAxBL,14,1000,828,172,1.09529025191676,2.02352941176471
2009,University of Delaware (Fang),UDWAxBL,15,1000,798,202,1.11856823266219,2.10416666666667
2009,University of Delaware (Fang),UDWAxBL,16,1000,946,54,1.02880658436214,2.07692307692308
2009,University of Delaware (Fang),UDWAxBL,17,1000,847,153,1.085776330076,2.06756756756757
2009,University of Delaware (Fang),UDWAxBL,18,1000,958,42,1.02249488752556,2.1
2009,University of Delaware (Fang),UDWAxBL,19,1000,506,494,1.3986013986014,2.36363636363636
2009,University of Delaware (Fang),UDWAxBL,20,1000,851,149,1.08225108225108,2.04109589041096
2009,University of Delaware (Fang),UDWAxBL,21,1000,826,174,1.10253583241455,2.14814814814815
2009,University of Delaware (Fang),UDWAxBL,22,1000,978,22,1.01112234580384,2
2009,University of Delaware (Fang),UDWAxBL,23,1000,399,601,1.63398692810458,2.82159624413146
2009,University of Delaware (Fang),UDWAxBL,24,1000,745,255,1.16009280742459,2.17948717948718
2009,University of Delaware (Fang),UDWAxBL,25,1000,879,121,1.06496272630458,2.01666666666667
2009,University of Delaware (Fang),UDWAxBL,26,1000,917,83,1.04384133611691,2.02439024390244
2009,University of Delaware (Fang),UDWAxBL,27,1000,912,88,1.04712041884817,2.04651162790698
2009,University of Delaware (Fang),UDWAxBL,28,1000,881,119,1.06837606837607,2.16363636363636
2009,University of Delaware (Fang),UDWAxBL,29,1000,922,78,1.04058272632674,2
2009,University of Delaware (Fang),UDWAxBL,30,1000,880,120,1.06496272630458,2.03389830508475
2009,University of Delaware (Fang),UDWAxBL,31,1000,884,116,1.06496272630458,2.10909090909091
2009,University of Delaware (Fang),UDWAxBL,32,1000,729,271,1.17096018735363,2.168
2009,University of Delaware (Fang),UDWAxBL,33,1000,918,82,1.04384133611691,2.05
2009,University of Delaware (Fang),UDWAxBL,34,1000,473,527,1.46198830409357,2.49763033175355
2009,University of Delaware (Fang),UDWAxBL,35,1000,890,110,1.06269925611052,2.15686274509804
2009,University of Delaware (Fang),UDWAxBL,36,1000,686,314,1.20627261761158,2.1958041958042
2009,University of Delaware (Fang),UDWAxBL,37,1000,778,222,1.17647058823529,3.08333333333333
2009,University of Delaware (Fang),UDWAxBL,38,1000,854,146,1.08108108108108,2.05633802816901
2009,University of Delaware (Fang),UDWAxBL,39,1000,935,65,1.03412616339193,2.03125
2009,University of Delaware (Fang),UDWAxBL,40,141,129,12,1.04444444444444,2
2009,University of Delaware (Fang),UDWAxBL,41,1000,948,52,1.02669404517454,2
2009,University of Delaware (Fang),UDWAxBL,42,1000,824,176,1.1001100110011,2.07058823529412
2009,University of Delaware (Fang),UDWAxBL,43,1000,926,74,1.04058272632674,2.11428571428571
2009,University of Delaware (Fang),UDWAxBL,44,1000,768,232,1.14025085518814,2.12844036697248
2009,University of Delaware (Fang),UDWAxBL,45,1000,843,157,1.09170305676856,2.15068493150685
2009,University of Delaware (Fang),UDWAxBL,46,1000,938,62,1.03305785123967,2.06666666666667
2009,University of Delaware (Fang),UDWAxBL,47,1000,967,33,1.01729399796541,2.0625
2009,University of Delaware (Fang),UDWAxBL,48,1000,938,62,1.0351966873706,2.21428571428571
2009,University of Delaware (Fang),UDWAxBL,49,1000,865,135,1.08342361863489,2.32758620689655
2009,University of Delaware (Fang),UDWAxBL,50,1000,949,51,1.02669404517454,2.04
2009,University of Delaware (Fang),UDWAxQE,1,1000,901,99,1.05374077976818,2.0625
2009,University of Delaware (Fang),UDWAxQE,2,1000,970,30,1.01626016260163,2.14285714285714
2009,University of Delaware (Fang),UDWAxQE,3,1000,785,215,1.12485939257593,2.06730769230769
2009,University of Delaware (Fang),UDWAxQE,4,1000,974,26,1.01317122593718,2
2009,University of Delaware (Fang),UDWAxQE,5,1000,938,62,1.03199174406605,2
2009,University of Delaware (Fang),UDWAxQE,6,1000,932,68,1.03734439834025,2.125
2009,University of Delaware (Fang),UDWAxQE,7,1000,901,99,1.05263157894737,2.02040816326531
2009,University of Delaware (Fang),UDWAxQE,8,1000,884,116,1.06951871657754,2.27450980392157
2009,University of Delaware (Fang),UDWAxQE,9,1000,932,68,1.03626943005181,2.06060606060606
2009,University of Delaware (Fang),UDWAxQE,10,1000,952,48,1.02774922918808,2.28571428571429
2009,University of Delaware (Fang),UDWAxQE,11,1000,925,75,1.04166666666667,2.14285714285714
2009,University of Delaware (Fang),UDWAxQE,12,1000,940,60,1.03305785123967,2.14285714285714
2009,University of Delaware (Fang),UDWAxQE,13,1000,912,88,1.04712041884817,2.04651162790698
2009,University of Delaware (Fang),UDWAxQE,14,1000,933,67,1.03734439834025,2.16129032258065
2009,University of Delaware (Fang),UDWAxQE,15,1000,917,83,1.04384133611691,2.02439024390244
2009,University of Delaware (Fang),UDWAxQE,16,1000,989,11,1.00603621730382,2.2
2009,University of Delaware (Fang),UDWAxQE,17,1000,968,32,1.01626016260163,2
2009,University of Delaware (Fang),UDWAxQE,18,1000,924,76,1.04058272632674,2.05405405405405
2009,University of Delaware (Fang),UDWAxQE,19,1000,346,654,1.73010380622837,2.81896551724138
2009,University of Delaware (Fang),UDWAxQE,20,1000,640,360,1.30548302872063,2.85714285714286
2009,University of Delaware (Fang),UDWAxQE,21,1000,866,134,1.07991360691145,2.23333333333333
2009,University of Delaware (Fang),UDWAxQE,22,1000,923,77,1.05263157894737,2.85185185185185
2009,University of Delaware (Fang),UDWAxQE,23,1000,952,48,1.02459016393443,2
2009,University of Delaware (Fang),UDWAxQE,24,1000,890,110,1.05932203389831,2.03703703703704
2009,University of Delaware (Fang),UDWAxQE,25,1000,923,77,1.04058272632674,2.02631578947368
2009,University of Delaware (Fang),UDWAxQE,26,1000,900,100,1.05485232067511,2.08333333333333
2009,University of Delaware (Fang),UDWAxQE,27,1000,949,51,1.02669404517454,2.04
2009,University of Delaware (Fang),UDWAxQE,28,1000,910,90,1.05042016806723,2.14285714285714
2009,University of Delaware (Fang),UDWAxQE,29,1000,951,49,1.02564102564103,2.04166666666667
2009,University of Delaware (Fang),UDWAxQE,30,1000,953,47,1.02459016393443,2.04347826086957
2009,University of Delaware (Fang),UDWAxQE,31,1000,741,259,1.19760479041916,2.75531914893617
2009,University of Delaware (Fang),UDWAxQE,32,1000,865,135,1.07642626480086,2.109375
2009,University of Delaware (Fang),UDWAxQE,33,1000,983,17,1.00908173562059,2.125
2009,University of Delaware (Fang),UDWAxQE,34,1000,849,151,1.12107623318386,3.51162790697674
2009,University of Delaware (Fang),UDWAxQE,35,1000,965,35,1.01936799184506,2.1875
2009,University of Delaware (Fang),UDWAxQE,36,1000,972,28,1.01419878296146,2
2009,University of Delaware (Fang),UDWAxQE,37,1000,950,50,1.02669404517454,2.08333333333333
2009,University of Delaware (Fang),UDWAxQE,38,1000,958,42,1.02145045965271,2
2009,University of Delaware (Fang),UDWAxQE,39,1000,954,46,1.02459016393443,2.09090909090909
2009,University of Delaware (Fang),UDWAxQE,40,1000,951,49,1.03199174406605,2.72222222222222
2009,University of Delaware (Fang),UDWAxQE,41,1000,898,102,1.06157112526539,2.31818181818182
2009,University of Delaware (Fang),UDWAxQE,42,1000,884,116,1.06269925611052,2.03508771929825
2009,University of Delaware (Fang),UDWAxQE,43,1000,951,49,1.02564102564103,2.04166666666667
2009,University of Delaware (Fang),UDWAxQE,44,1000,908,92,1.04931794333683,2.04444444444444
2009,University of Delaware (Fang),UDWAxQE,45,1000,945,55,1.02880658436214,2.03703703703704
2009,University of Delaware (Fang),UDWAxQE,46,1000,895,105,1.05820105820106,2.1
2009,University of Delaware (Fang),UDWAxQE,47,1000,967,33,1.01729399796541,2.0625
2009,University of Delaware (Fang),UDWAxQE,48,1000,946,54,1.02986611740474,2.16
2009,University of Delaware (Fang),UDWAxQE,49,1000,895,105,1.06157112526539,2.23404255319149
2009,University of Delaware (Fang),UDWAxQE,50,1000,970,30,1.01522842639594,2
2009,University of Delaware (Fang),UDWAxQEWeb,1,1000,880,120,1.06496272630458,2.03389830508475
2009,University of Delaware (Fang),UDWAxQEWeb,2,1000,971,29,1.01626016260163,2.23076923076923
2009,University of Delaware (Fang),UDWAxQEWeb,3,1000,926,74,1.03950103950104,2.05555555555556
2009,University of Delaware (Fang),UDWAxQEWeb,4,1000,970,30,1.01522842639594,2
2009,University of Delaware (Fang),UDWAxQEWeb,5,1000,866,134,1.07411385606874,2.06153846153846
2009,University of Delaware (Fang),UDWAxQEWeb,6,1000,912,88,1.04602510460251,2
2009,University of Delaware (Fang),UDWAxQEWeb,7,1000,870,130,1.07411385606874,2.13114754098361
2009,University of Delaware (Fang),UDWAxQEWeb,8,1000,934,66,1.03412616339193,2
2009,University of Delaware (Fang),UDWAxQEWeb,9,1000,938,62,1.0351966873706,2.21428571428571
2009,University of Delaware (Fang),UDWAxQEWeb,10,1000,899,101,1.05485232067511,2.06122448979592
2009,University of Delaware (Fang),UDWAxQEWeb,11,1000,938,62,1.03305785123967,2.06666666666667
2009,University of Delaware (Fang),UDWAxQEWeb,12,1000,881,119,1.06382978723404,2.01694915254237
2009,University of Delaware (Fang),UDWAxQEWeb,13,1000,924,76,1.04166666666667,2.11111111111111
2009,University of Delaware (Fang),UDWAxQEWeb,14,1000,947,53,1.02774922918808,2.03846153846154
2009,University of Delaware (Fang),UDWAxQEWeb,15,1000,906,94,1.04931794333683,2
2009,University of Delaware (Fang),UDWAxQEWeb,16,1000,958,42,1.02145045965271,2
2009,University of Delaware (Fang),UDWAxQEWeb,17,1000,938,62,1.03199174406605,2
2009,University of Delaware (Fang),UDWAxQEWeb,18,1000,935,65,1.03626943005181,2.16666666666667
2009,University of Delaware (Fang),UDWAxQEWeb,19,1000,920,80,1.04384133611691,2.10526315789474
2009,University of Delaware (Fang),UDWAxQEWeb,20,1000,959,41,1.02145045965271,2.05
2009,University of Delaware (Fang),UDWAxQEWeb,21,1000,928,72,1.03842159916926,2.05714285714286
2009,University of Delaware (Fang),UDWAxQEWeb,22,1000,986,14,1.00704934541793,2
2009,University of Delaware (Fang),UDWAxQEWeb,23,1000,317,683,1.82815356489945,2.9695652173913
2009,University of Delaware (Fang),UDWAxQEWeb,24,1000,902,98,1.05263157894737,2.04166666666667
2009,University of Delaware (Fang),UDWAxQEWeb,25,1000,890,110,1.06269925611052,2.15686274509804
2009,University of Delaware (Fang),UDWAxQEWeb,26,1000,928,72,1.03734439834025,2
2009,University of Delaware (Fang),UDWAxQEWeb,27,1000,962,38,1.02040816326531,2.11111111111111
2009,University of Delaware (Fang),UDWAxQEWeb,28,1000,923,77,1.04275286757039,2.13888888888889
2009,University of Delaware (Fang),UDWAxQEWeb,29,1000,917,83,1.04384133611691,2.02439024390244
2009,University of Delaware (Fang),UDWAxQEWeb,30,1000,922,78,1.04166666666667,2.05263157894737
2009,University of Delaware (Fang),UDWAxQEWeb,31,1000,917,83,1.04602510460251,2.12820512820513
2009,University of Delaware (Fang),UDWAxQEWeb,32,1000,868,132,1.07642626480086,2.16393442622951
2009,University of Delaware (Fang),UDWAxQEWeb,33,1000,956,44,1.02249488752556,2
2009,University of Delaware (Fang),UDWAxQEWeb,34,1000,918,82,1.04602510460251,2.15789473684211
2009,University of Delaware (Fang),UDWAxQEWeb,35,1000,961,39,1.02040816326531,2.05263157894737
2009,University of Delaware (Fang),UDWAxQEWeb,36,1000,970,30,1.01522842639594,2
2009,University of Delaware (Fang),UDWAxQEWeb,37,1000,968,32,1.01626016260163,2
2009,University of Delaware (Fang),UDWAxQEWeb,38,1000,922,78,1.04166666666667,2.05263157894737
2009,University of Delaware (Fang),UDWAxQEWeb,39,1000,960,40,1.02040816326531,2
2009,University of Delaware (Fang),UDWAxQEWeb,40,1000,934,66,1.03412616339193,2
2009,University of Delaware (Fang),UDWAxQEWeb,41,1000,948,52,1.02669404517454,2
2009,University of Delaware (Fang),UDWAxQEWeb,42,1000,891,109,1.05932203389831,2.05660377358491
2009,University of Delaware (Fang),UDWAxQEWeb,43,1000,931,69,1.03626943005181,2.02941176470588
2009,University of Delaware (Fang),UDWAxQEWeb,44,1000,875,125,1.07642626480086,2.31481481481482
2009,University of Delaware (Fang),UDWAxQEWeb,45,1000,937,63,1.03305785123967,2.03225806451613
2009,University of Delaware (Fang),UDWAxQEWeb,46,1000,965,35,1.0183299389002,2.05882352941176
2009,University of Delaware (Fang),UDWAxQEWeb,47,1000,959,41,1.02145045965271,2.05
2009,University of Delaware (Fang),UDWAxQEWeb,48,1000,969,31,1.01626016260163,2.06666666666667
2009,University of Delaware (Fang),UDWAxQEWeb,49,1000,937,63,1.03305785123967,2.03225806451613
2009,University of Delaware (Fang),UDWAxQEWeb,50,1000,929,71,1.03842159916926,2.08823529411765
2009,"University of Maryland, College Park",UMHOObm25B,1,1000,935,65,1.04058272632674,2.5
2009,"University of Maryland, College Park",UMHOObm25B,2,1000,823,177,1.10987791342952,2.26923076923077
2009,"University of Maryland, College Park",UMHOObm25B,3,1000,871,129,1.07991360691145,2.34545454545455
2009,"University of Maryland, College Park",UMHOObm25B,4,1000,802,198,1.14025085518814,2.64
2009,"University of Maryland, College Park",UMHOObm25B,5,1000,782,218,1.15740740740741,2.65853658536585
2009,"University of Maryland, College Park",UMHOObm25B,6,1000,584,416,1.32275132275132,2.41860465116279
2009,"University of Maryland, College Park",UMHOObm25B,7,1000,962,38,1.01936799184506,2
2009,"University of Maryland, College Park",UMHOObm25B,8,1000,841,159,1.1037527593819,2.44615384615385
2009,"University of Maryland, College Park",UMHOObm25B,9,1000,950,50,1.02774922918808,2.17391304347826
2009,"University of Maryland, College Park",UMHOObm25B,10,1000,793,207,1.14285714285714,2.52439024390244
2009,"University of Maryland, College Park",UMHOObm25B,11,1000,870,130,1.08225108225108,2.40740740740741
2009,"University of Maryland, College Park",UMHOObm25B,12,1000,752,248,1.18203309692671,2.63829787234043
2009,"University of Maryland, College Park",UMHOObm25B,13,1000,422,578,1.70648464163823,3.52439024390244
2009,"University of Maryland, College Park",UMHOObm25B,14,1000,782,218,1.13378684807256,2.18
2009,"University of Maryland, College Park",UMHOObm25B,15,1000,811,189,1.12994350282486,2.55405405405405
2009,"University of Maryland, College Park",UMHOObm25B,16,1000,755,245,1.1454753722795,2.07627118644068
2009,"University of Maryland, College Park",UMHOObm25B,17,1000,963,37,1.02040816326531,2.17647058823529
2009,"University of Maryland, College Park",UMHOObm25B,18,1000,939,61,1.03412616339193,2.17857142857143
2009,"University of Maryland, College Park",UMHOObm25B,19,1000,770,230,1.17508813160987,2.83950617283951
2009,"University of Maryland, College Park",UMHOObm25B,20,1000,858,142,1.08813928182807,2.32786885245902
2009,"University of Maryland, College Park",UMHOObm25B,21,1000,875,125,1.09289617486339,3.125
2009,"University of Maryland, College Park",UMHOObm25B,22,1000,953,47,1.02564102564103,2.13636363636364
2009,"University of Maryland, College Park",UMHOObm25B,23,1000,428,572,1.89753320683112,5.77777777777778
2009,"University of Maryland, College Park",UMHOObm25B,24,1000,847,153,1.09409190371991,2.28358208955224
2009,"University of Maryland, College Park",UMHOObm25B,25,1000,693,307,1.23152709359606,2.57983193277311
2009,"University of Maryland, College Park",UMHOObm25B,26,1000,890,110,1.06609808102345,2.29166666666667
2009,"University of Maryland, College Park",UMHOObm25B,27,1000,901,99,1.05708245243129,2.2
2009,"University of Maryland, College Park",UMHOObm25B,28,1000,637,363,1.33868808567604,3.3
2009,"University of Maryland, College Park",UMHOObm25B,29,1000,894,106,1.07066381156317,2.65
2009,"University of Maryland, College Park",UMHOObm25B,30,1000,861,139,1.07642626480086,2.04411764705882
2009,"University of Maryland, College Park",UMHOObm25B,31,1000,770,230,1.16279069767442,2.55555555555556
2009,"University of Maryland, College Park",UMHOObm25B,32,1000,866,134,1.08108108108108,2.27118644067797
2009,"University of Maryland, College Park",UMHOObm25B,33,1000,928,72,1.03950103950104,2.11764705882353
2009,"University of Maryland, College Park",UMHOObm25B,34,1000,782,218,1.16009280742459,2.725
2009,"University of Maryland, College Park",UMHOObm25B,35,1000,743,257,1.17370892018779,2.35779816513761
2009,"University of Maryland, College Park",UMHOObm25B,36,1000,926,74,1.04275286757039,2.24242424242424
2009,"University of Maryland, College Park",UMHOObm25B,37,1000,866,134,1.07874865156419,2.19672131147541
2009,"University of Maryland, College Park",UMHOObm25B,38,1000,861,139,1.0752688172043,2.01449275362319
2009,"University of Maryland, College Park",UMHOObm25B,39,1000,861,139,1.09170305676856,2.52727272727273
2009,"University of Maryland, College Park",UMHOObm25B,40,132,120,12,1.04761904761905,2
2009,"University of Maryland, College Park",UMHOObm25B,41,1000,859,141,1.08225108225108,2.16923076923077
2009,"University of Maryland, College Park",UMHOObm25B,42,1000,848,152,1.10741971207087,2.76363636363636
2009,"University of Maryland, College Park",UMHOObm25B,43,1000,904,96,1.05708245243129,2.28571428571429
2009,"University of Maryland, College Park",UMHOObm25B,44,1000,869,131,1.08459869848156,2.47169811320755
2009,"University of Maryland, College Park",UMHOObm25B,45,1000,855,145,1.09289617486339,2.41666666666667
2009,"University of Maryland, College Park",UMHOObm25B,46,1000,875,125,1.08459869848156,2.65957446808511
2009,"University of Maryland, College Park",UMHOObm25B,47,1000,883,117,1.06609808102345,2.12727272727273
2009,"University of Maryland, College Park",UMHOObm25B,48,1000,856,144,1.09649122807018,2.57142857142857
2009,"University of Maryland, College Park",UMHOObm25B,49,1000,766,234,1.17647058823529,2.78571428571429
2009,"University of Maryland, College Park",UMHOObm25B,50,1000,937,63,1.03412616339193,2.1
2009,"University of Maryland, College Park",UMHOObm25GS,1,1000,930,70,1.04384133611691,2.5
2009,"University of Maryland, College Park",UMHOObm25GS,2,1000,848,152,1.0989010989011,2.45161290322581
2009,"University of Maryland, College Park",UMHOObm25GS,3,1000,854,146,1.11111111111111,3.17391304347826
2009,"University of Maryland, College Park",UMHOObm25GS,4,1000,807,193,1.15606936416185,3.32758620689655
2009,"University of Maryland, College Park",UMHOObm25GS,5,1000,810,190,1.12866817155756,2.5
2009,"University of Maryland, College Park",UMHOObm25GS,6,1000,657,343,1.25156445556946,2.41549295774648
2009,"University of Maryland, College Park",UMHOObm25GS,7,1000,578,422,1.44092219020173,3.63793103448276
2009,"University of Maryland, College Park",UMHOObm25GS,8,1000,805,195,1.14025085518814,2.70833333333333
2009,"University of Maryland, College Park",UMHOObm25GS,9,1000,950,50,1.03305785123967,2.77777777777778
2009,"University of Maryland, College Park",UMHOObm25GS,10,1000,897,103,1.05820105820106,2.14583333333333
2009,"University of Maryland, College Park",UMHOObm25GS,11,1000,782,218,1.15606936416185,2.62650602409639
2009,"University of Maryland, College Park",UMHOObm25GS,12,1000,681,319,1.24223602484472,2.57258064516129
2009,"University of Maryland, College Park",UMHOObm25GS,13,1000,614,386,1.43061516452074,4.54117647058824
2009,"University of Maryland, College Park",UMHOObm25GS,14,1000,793,207,1.14678899082569,2.62025316455696
2009,"University of Maryland, College Park",UMHOObm25GS,15,1000,877,123,1.0752688172043,2.32075471698113
2009,"University of Maryland, College Park",UMHOObm25GS,16,1000,773,227,1.15740740740741,2.49450549450549
2009,"University of Maryland, College Park",UMHOObm25GS,17,1000,952,48,1.03092783505155,2.66666666666667
2009,"University of Maryland, College Park",UMHOObm25GS,18,1000,821,179,1.11982082866741,2.48611111111111
2009,"University of Maryland, College Park",UMHOObm25GS,19,1000,864,136,1.08813928182807,2.47272727272727
2009,"University of Maryland, College Park",UMHOObm25GS,20,1000,864,136,1.08108108108108,2.22950819672131
2009,"University of Maryland, College Park",UMHOObm25GS,21,1000,817,183,1.12485939257593,2.54166666666667
2009,"University of Maryland, College Park",UMHOObm25GS,22,1000,934,66,1.0351966873706,2.0625
2009,"University of Maryland, College Park",UMHOObm25GS,23,1000,872,128,1.09529025191676,3.1219512195122
2009,"University of Maryland, College Park",UMHOObm25GS,24,1000,772,228,1.16822429906542,2.71428571428571
2009,"University of Maryland, College Park",UMHOObm25GS,25,1000,704,296,1.22549019607843,2.64285714285714
2009,"University of Maryland, College Park",UMHOObm25GS,26,1000,823,177,1.11111111111111,2.2987012987013
2009,"University of Maryland, College Park",UMHOObm25GS,27,1000,900,100,1.05708245243129,2.17391304347826
2009,"University of Maryland, College Park",UMHOObm25GS,28,1000,822,178,1.12612612612613,2.6969696969697
2009,"University of Maryland, College Park",UMHOObm25GS,29,1000,946,54,1.02880658436214,2.07692307692308
2009,"University of Maryland, College Park",UMHOObm25GS,30,1000,731,269,1.17647058823529,2.26050420168067
2009,"University of Maryland, College Park",UMHOObm25GS,31,1000,723,277,1.19189511323004,2.38793103448276
2009,"University of Maryland, College Park",UMHOObm25GS,32,1000,774,226,1.17647058823529,2.97368421052632
2009,"University of Maryland, College Park",UMHOObm25GS,33,1000,922,78,1.04602510460251,2.29411764705882
2009,"University of Maryland, College Park",UMHOObm25GS,34,1000,942,58,1.03842159916926,2.76190476190476
2009,"University of Maryland, College Park",UMHOObm25GS,35,1000,667,333,1.25786163522013,2.6015625
2009,"University of Maryland, College Park",UMHOObm25GS,36,1000,850,150,1.1001100110011,2.54237288135593
2009,"University of Maryland, College Park",UMHOObm25GS,37,1000,855,145,1.09289617486339,2.41666666666667
2009,"University of Maryland, College Park",UMHOObm25GS,38,1000,850,150,1.09409190371991,2.34375
2009,"University of Maryland, College Park",UMHOObm25GS,39,1000,913,87,1.05374077976818,2.41666666666667
2009,"University of Maryland, College Park",UMHOObm25GS,40,1000,445,555,1.58982511923688,3.01630434782609
2009,"University of Maryland, College Park",UMHOObm25GS,41,1000,734,266,1.20192307692308,2.71428571428571
2009,"University of Maryland, College Park",UMHOObm25GS,42,1000,923,77,1.05374077976818,2.96153846153846
2009,"University of Maryland, College Park",UMHOObm25GS,43,1000,891,109,1.07066381156317,2.53488372093023
2009,"University of Maryland, College Park",UMHOObm25GS,44,1000,703,297,1.26582278481013,3.41379310344828
2009,"University of Maryland, College Park",UMHOObm25GS,45,1000,888,112,1.06951871657754,2.38297872340426
2009,"University of Maryland, College Park",UMHOObm25GS,46,1000,659,341,1.23915737298637,2.30405405405405
2009,"University of Maryland, College Park",UMHOObm25GS,47,1000,877,123,1.08225108225108,2.61702127659575
2009,"University of Maryland, College Park",UMHOObm25GS,48,1000,867,133,1.08695652173913,2.50943396226415
2009,"University of Maryland, College Park",UMHOObm25GS,49,1000,820,180,1.12866817155756,2.72727272727273
2009,"University of Maryland, College Park",UMHOObm25GS,50,1000,854,146,1.09529025191676,2.47457627118644
2009,"University of Maryland, College Park",UMHOObm25IF,1,1000,951,49,1.02986611740474,2.45
2009,"University of Maryland, College Park",UMHOObm25IF,2,1000,947,53,1.03092783505155,2.30434782608696
2009,"University of Maryland, College Park",UMHOObm25IF,3,1000,897,103,1.07181136120043,2.86111111111111
2009,"University of Maryland, College Park",UMHOObm25IF,4,1000,881,119,1.10132158590308,4.40740740740741
2009,"University of Maryland, College Park",UMHOObm25IF,5,1000,942,58,1.03199174406605,2.14814814814815
2009,"University of Maryland, College Park",UMHOObm25IF,6,1000,919,81,1.04493207941484,2.13157894736842
2009,"University of Maryland, College Park",UMHOObm25IF,7,1000,842,158,1.11856823266219,3.03846153846154
2009,"University of Maryland, College Park",UMHOObm25IF,8,1000,884,116,1.08459869848156,3.05263157894737
2009,"University of Maryland, College Park",UMHOObm25IF,9,1000,966,34,1.02354145342886,3.09090909090909
2009,"University of Maryland, College Park",UMHOObm25IF,10,1000,981,19,1.01112234580384,2.375
2009,"University of Maryland, College Park",UMHOObm25IF,11,1000,924,76,1.04931794333683,2.62068965517241
2009,"University of Maryland, College Park",UMHOObm25IF,12,1000,884,116,1.09769484083425,4.2962962962963
2009,"University of Maryland, College Park",UMHOObm25IF,13,1000,740,260,1.26422250316056,5.09803921568627
2009,"University of Maryland, College Park",UMHOObm25IF,14,1000,933,67,1.0351966873706,2.03030303030303
2009,"University of Maryland, College Park",UMHOObm25IF,15,1000,924,76,1.05708245243129,3.45454545454545
2009,"University of Maryland, College Park",UMHOObm25IF,16,1000,954,46,1.02564102564103,2.19047619047619
2009,"University of Maryland, College Park",UMHOObm25IF,17,1000,976,24,1.01317122593718,2.18181818181818
2009,"University of Maryland, College Park",UMHOObm25IF,18,1000,917,83,1.05708245243129,2.86206896551724
2009,"University of Maryland, College Park",UMHOObm25IF,19,1000,935,65,1.04275286757039,2.70833333333333
2009,"University of Maryland, College Park",UMHOObm25IF,20,1000,969,31,1.01626016260163,2.06666666666667
2009,"University of Maryland, College Park",UMHOObm25IF,21,1000,902,98,1.06044538706257,2.39024390243902
2009,"University of Maryland, College Park",UMHOObm25IF,22,1000,978,22,1.01214574898785,2.2
2009,"University of Maryland, College Park",UMHOObm25IF,23,1000,950,50,1.02880658436214,2.27272727272727
2009,"University of Maryland, College Park",UMHOObm25IF,24,1000,886,114,1.08342361863489,3.08108108108108
2009,"University of Maryland, College Park",UMHOObm25IF,25,1000,935,65,1.03734439834025,2.24137931034483
2009,"University of Maryland, College Park",UMHOObm25IF,26,1000,959,41,1.02145045965271,2.05
2009,"University of Maryland, College Park",UMHOObm25IF,27,1000,957,43,1.02564102564103,2.38888888888889
2009,"University of Maryland, College Park",UMHOObm25IF,28,1000,868,132,1.08813928182807,2.58823529411765
2009,"University of Maryland, College Park",UMHOObm25IF,29,1000,982,18,1.00908173562059,2
2009,"University of Maryland, College Park",UMHOObm25IF,30,1000,973,27,1.01419878296146,2.07692307692308
2009,"University of Maryland, College Park",UMHOObm25IF,31,1000,901,99,1.05596620908131,2.15217391304348
2009,"University of Maryland, College Park",UMHOObm25IF,32,1000,891,109,1.07642626480086,2.86842105263158
2009,"University of Maryland, College Park",UMHOObm25IF,33,1000,966,34,1.01936799184506,2.26666666666667
2009,"University of Maryland, College Park",UMHOObm25IF,34,1000,976,24,1.01317122593718,2.18181818181818
2009,"University of Maryland, College Park",UMHOObm25IF,35,1000,964,36,1.01936799184506,2.11764705882353
2009,"University of Maryland, College Park",UMHOObm25IF,36,1000,954,46,1.02880658436214,2.55555555555556
2009,"University of Maryland, College Park",UMHOObm25IF,37,1000,959,41,1.02145045965271,2.05
2009,"University of Maryland, College Park",UMHOObm25IF,38,1000,958,42,1.02459016393443,2.33333333333333
2009,"University of Maryland, College Park",UMHOObm25IF,39,1000,966,34,1.01936799184506,2.26666666666667
2009,"University of Maryland, College Park",UMHOObm25IF,40,1000,778,222,1.15874855156431,2.61176470588235
2009,"University of Maryland, College Park",UMHOObm25IF,41,1000,925,75,1.04931794333683,2.67857142857143
2009,"University of Maryland, College Park",UMHOObm25IF,42,1000,954,46,1.02986611740474,2.70588235294118
2009,"University of Maryland, College Park",UMHOObm25IF,43,1000,955,45,1.02880658436214,2.64705882352941
2009,"University of Maryland, College Park",UMHOObm25IF,44,1000,860,140,1.0989010989011,2.8
2009,"University of Maryland, College Park",UMHOObm25IF,45,1000,965,35,1.0183299389002,2.05882352941176
2009,"University of Maryland, College Park",UMHOObm25IF,46,1000,950,50,1.02986611740474,2.38095238095238
2009,"University of Maryland, College Park",UMHOObm25IF,47,1000,918,82,1.05708245243129,2.92857142857143
2009,"University of Maryland, College Park",UMHOObm25IF,48,1000,909,91,1.0515247108307,2.16666666666667
2009,"University of Maryland, College Park",UMHOObm25IF,49,1000,912,88,1.05485232067511,2.44444444444444
2009,"University of Maryland, College Park",UMHOObm25IF,50,1000,941,59,1.03412616339193,2.26923076923077
2009,"University of Maryland, College Park",UMHOOqlB,1,1000,758,242,1.18063754427391,2.71910112359551
2009,"University of Maryland, College Park",UMHOOqlB,2,1000,835,165,1.10253583241455,2.29166666666667
2009,"University of Maryland, College Park",UMHOOqlB,3,1000,876,124,1.0752688172043,2.2962962962963
2009,"University of Maryland, College Park",UMHOOqlB,4,1000,806,194,1.13765642775882,2.65753424657534
2009,"University of Maryland, College Park",UMHOOqlB,5,1000,833,167,1.10741971207087,2.38571428571429
2009,"University of Maryland, College Park",UMHOOqlB,6,1000,583,417,1.32450331125828,2.42441860465116
2009,"University of Maryland, College Park",UMHOOqlB,7,1000,917,83,1.05932203389831,3.07407407407407
2009,"University of Maryland, College Park",UMHOOqlB,8,1000,831,169,1.11358574610245,2.52238805970149
2009,"University of Maryland, College Park",UMHOOqlB,9,1000,952,48,1.02669404517454,2.18181818181818
2009,"University of Maryland, College Park",UMHOOqlB,10,1000,850,150,1.09051254089422,2.23880597014925
2009,"University of Maryland, College Park",UMHOOqlB,11,1000,845,155,1.09170305676856,2.1830985915493
2009,"University of Maryland, College Park",UMHOOqlB,12,1000,752,248,1.18203309692671,2.63829787234043
2009,"University of Maryland, College Park",UMHOOqlB,13,1000,378,622,1.79856115107914,3.49438202247191
2009,"University of Maryland, College Park",UMHOOqlB,14,1000,782,218,1.13378684807256,2.18
2009,"University of Maryland, College Park",UMHOOqlB,15,1000,772,228,1.16279069767442,2.59090909090909
2009,"University of Maryland, College Park",UMHOOqlB,16,1000,818,182,1.10619469026549,2.11627906976744
2009,"University of Maryland, College Park",UMHOOqlB,17,1000,959,41,1.02249488752556,2.15789473684211
2009,"University of Maryland, College Park",UMHOOqlB,18,1000,919,81,1.04602510460251,2.18918918918919
2009,"University of Maryland, College Park",UMHOOqlB,19,1000,760,240,1.18343195266272,2.82352941176471
2009,"University of Maryland, College Park",UMHOOqlB,20,1000,860,140,1.08695652173913,2.33333333333333
2009,"University of Maryland, College Park",UMHOOqlB,21,1000,877,123,1.09170305676856,3.15384615384615
2009,"University of Maryland, College Park",UMHOOqlB,22,1000,951,49,1.02669404517454,2.1304347826087
2009,"University of Maryland, College Park",UMHOOqlB,23,1000,402,598,1.99203187250996,5.98
2009,"University of Maryland, College Park",UMHOOqlB,24,1000,840,160,1.09769484083425,2.25352112676056
2009,"University of Maryland, College Park",UMHOOqlB,25,1000,698,302,1.21951219512195,2.47540983606557
2009,"University of Maryland, College Park",UMHOOqlB,26,1000,891,109,1.06496272630458,2.27083333333333
2009,"University of Maryland, College Park",UMHOOqlB,27,1000,903,97,1.05596620908131,2.20454545454545
2009,"University of Maryland, College Park",UMHOOqlB,28,1000,668,332,1.29366106080207,3.16190476190476
2009,"University of Maryland, College Park",UMHOOqlB,29,1000,936,64,1.03626943005181,2.20689655172414
2009,"University of Maryland, College Park",UMHOOqlB,30,1000,866,134,1.07411385606874,2.06153846153846
2009,"University of Maryland, College Park",UMHOOqlB,31,1000,774,226,1.15740740740741,2.51111111111111
2009,"University of Maryland, College Park",UMHOOqlB,32,1000,870,130,1.08225108225108,2.40740740740741
2009,"University of Maryland, College Park",UMHOOqlB,33,1000,926,74,1.04058272632674,2.11428571428571
2009,"University of Maryland, College Park",UMHOOqlB,34,1000,776,224,1.16414435389988,2.69879518072289
2009,"University of Maryland, College Park",UMHOOqlB,35,1000,729,271,1.18623962040332,2.37719298245614
2009,"University of Maryland, College Park",UMHOOqlB,36,1000,922,78,1.04493207941484,2.22857142857143
2009,"University of Maryland, College Park",UMHOOqlB,37,1000,883,117,1.07066381156317,2.29411764705882
2009,"University of Maryland, College Park",UMHOOqlB,38,1000,866,134,1.07296137339056,2.03030303030303
2009,"University of Maryland, College Park",UMHOOqlB,39,1000,889,111,1.07181136120043,2.52272727272727
2009,"University of Maryland, College Park",UMHOOqlB,40,132,120,12,1.04761904761905,2
2009,"University of Maryland, College Park",UMHOOqlB,41,1000,784,216,1.1441647597254,2.4
2009,"University of Maryland, College Park",UMHOOqlB,42,1000,857,143,1.10497237569061,2.97916666666667
2009,"University of Maryland, College Park",UMHOOqlB,43,1000,897,103,1.06044538706257,2.23913043478261
2009,"University of Maryland, College Park",UMHOOqlB,44,1000,870,130,1.08108108108108,2.36363636363636
2009,"University of Maryland, College Park",UMHOOqlB,45,1000,846,154,1.0989010989011,2.40625
2009,"University of Maryland, College Park",UMHOOqlB,46,1000,864,136,1.09170305676856,2.61538461538462
2009,"University of Maryland, College Park",UMHOOqlB,47,1000,898,102,1.05820105820106,2.17021276595745
2009,"University of Maryland, College Park",UMHOOqlB,48,1000,874,126,1.08225108225108,2.52
2009,"University of Maryland, College Park",UMHOOqlB,49,1000,740,260,1.19760479041916,2.73684210526316
2009,"University of Maryland, College Park",UMHOOqlB,50,1000,916,84,1.06496272630458,3.65217391304348
2009,"University of Maryland, College Park",UMHOOqlGS,1,1000,489,511,1.5015015015015,2.88700564971751
2009,"University of Maryland, College Park",UMHOOqlGS,2,1000,874,126,1.07874865156419,2.37735849056604
2009,"University of Maryland, College Park",UMHOOqlGS,3,1000,856,144,1.10987791342952,3.2
2009,"University of Maryland, College Park",UMHOOqlGS,4,1000,809,191,1.15473441108545,3.35087719298246
2009,"University of Maryland, College Park",UMHOOqlGS,5,1000,830,170,1.11234705228031,2.46376811594203
2009,"University of Maryland, College Park",UMHOOqlGS,6,1000,649,351,1.25944584382872,2.42068965517241
2009,"University of Maryland, College Park",UMHOOqlGS,7,1000,773,227,1.18623962040332,3.24285714285714
2009,"University of Maryland, College Park",UMHOOqlGS,8,1000,801,199,1.14285714285714,2.68918918918919
2009,"University of Maryland, College Park",UMHOOqlGS,9,1000,914,86,1.05820105820106,2.7741935483871
2009,"University of Maryland, College Park",UMHOOqlGS,10,1000,913,87,1.04712041884817,2.07142857142857
2009,"University of Maryland, College Park",UMHOOqlGS,11,1000,804,196,1.13895216400911,2.64864864864865
2009,"University of Maryland, College Park",UMHOOqlGS,12,1000,681,319,1.24223602484472,2.57258064516129
2009,"University of Maryland, College Park",UMHOOqlGS,13,1000,612,388,1.43061516452074,4.45977011494253
2009,"University of Maryland, College Park",UMHOOqlGS,14,1000,801,199,1.14155251141553,2.65333333333333
2009,"University of Maryland, College Park",UMHOOqlGS,15,1000,878,122,1.07758620689655,2.44
2009,"University of Maryland, College Park",UMHOOqlGS,16,1000,799,201,1.13895216400911,2.54430379746835
2009,"University of Maryland, College Park",UMHOOqlGS,17,1000,931,69,1.04384133611691,2.55555555555556
2009,"University of Maryland, College Park",UMHOOqlGS,18,1000,862,138,1.08225108225108,2.2258064516129
2009,"University of Maryland, College Park",UMHOOqlGS,19,1000,866,134,1.08695652173913,2.48148148148148
2009,"University of Maryland, College Park",UMHOOqlGS,20,1000,868,132,1.07874865156419,2.23728813559322
2009,"University of Maryland, College Park",UMHOOqlGS,21,1000,814,186,1.12739571589628,2.54794520547945
2009,"University of Maryland, College Park",UMHOOqlGS,22,1000,930,70,1.03734439834025,2.05882352941176
2009,"University of Maryland, College Park",UMHOOqlGS,23,1000,870,130,1.09649122807018,3.0952380952381
2009,"University of Maryland, College Park",UMHOOqlGS,24,1000,772,228,1.16822429906542,2.71428571428571
2009,"University of Maryland, College Park",UMHOOqlGS,25,1000,698,302,1.23456790123457,2.69642857142857
2009,"University of Maryland, College Park",UMHOOqlGS,26,1000,829,171,1.10132158590308,2.16455696202532
2009,"University of Maryland, College Park",UMHOOqlGS,27,1000,904,96,1.05485232067511,2.18181818181818
2009,"University of Maryland, College Park",UMHOOqlGS,28,1000,822,178,1.12612612612613,2.6969696969697
2009,"University of Maryland, College Park",UMHOOqlGS,29,1000,942,58,1.0351966873706,2.41666666666667
2009,"University of Maryland, College Park",UMHOOqlGS,30,1000,687,313,1.20481927710843,2.18881118881119
2009,"University of Maryland, College Park",UMHOOqlGS,31,1000,723,277,1.19189511323004,2.38793103448276
2009,"University of Maryland, College Park",UMHOOqlGS,32,1000,821,179,1.13250283125708,2.88709677419355
2009,"University of Maryland, College Park",UMHOOqlGS,33,1000,924,76,1.04493207941484,2.3030303030303
2009,"University of Maryland, College Park",UMHOOqlGS,34,1000,934,66,1.04384133611691,2.75
2009,"University of Maryland, College Park",UMHOOqlGS,35,1000,664,336,1.26103404791929,2.6046511627907
2009,"University of Maryland, College Park",UMHOOqlGS,36,1000,848,152,1.10132158590308,2.53333333333333
2009,"University of Maryland, College Park",UMHOOqlGS,37,1000,853,147,1.09409190371991,2.40983606557377
2009,"University of Maryland, College Park",UMHOOqlGS,38,1000,863,137,1.08342361863489,2.28333333333333
2009,"University of Maryland, College Park",UMHOOqlGS,39,1000,915,85,1.05263157894737,2.42857142857143
2009,"University of Maryland, College Park",UMHOOqlGS,40,1000,443,557,1.59235668789809,3.01081081081081
2009,"University of Maryland, College Park",UMHOOqlGS,41,1000,747,253,1.19189511323004,2.75
2009,"University of Maryland, College Park",UMHOOqlGS,42,1000,731,269,1.19047619047619,2.46788990825688
2009,"University of Maryland, College Park",UMHOOqlGS,43,1000,877,123,1.07874865156419,2.46
2009,"University of Maryland, College Park",UMHOOqlGS,44,1000,742,258,1.230012300123,3.63380281690141
2009,"University of Maryland, College Park",UMHOOqlGS,45,1000,893,107,1.06609808102345,2.37777777777778
2009,"University of Maryland, College Park",UMHOOqlGS,46,1000,674,326,1.22699386503067,2.31205673758865
2009,"University of Maryland, College Park",UMHOOqlGS,47,1000,880,120,1.07991360691145,2.60869565217391
2009,"University of Maryland, College Park",UMHOOqlGS,48,1000,852,148,1.10864745011086,2.96
2009,"University of Maryland, College Park",UMHOOqlGS,49,1000,814,186,1.1454753722795,3.15254237288136
2009,"University of Maryland, College Park",UMHOOqlGS,50,1000,854,146,1.09289617486339,2.39344262295082
2009,"University of Maryland, College Park",UMHOOqlIF,1,1000,767,233,1.15207373271889,2.30693069306931
2009,"University of Maryland, College Park",UMHOOqlIF,2,1000,962,38,1.01936799184506,2
2009,"University of Maryland, College Park",UMHOOqlIF,3,1000,905,95,1.06382978723404,2.71428571428571
2009,"University of Maryland, College Park",UMHOOqlIF,4,1000,877,123,1.1037527593819,4.24137931034483
2009,"University of Maryland, College Park",UMHOOqlIF,5,1000,932,68,1.03950103950104,2.26666666666667
2009,"University of Maryland, College Park",UMHOOqlIF,6,1000,894,106,1.06044538706257,2.16326530612245
2009,"University of Maryland, College Park",UMHOOqlIF,7,1000,864,136,1.09529025191676,2.77551020408163
2009,"University of Maryland, College Park",UMHOOqlIF,8,1000,888,112,1.07758620689655,2.8
2009,"University of Maryland, College Park",UMHOOqlIF,9,1000,958,42,1.02774922918808,2.8
2009,"University of Maryland, College Park",UMHOOqlIF,10,1000,981,19,1.01112234580384,2.375
2009,"University of Maryland, College Park",UMHOOqlIF,11,1000,916,84,1.05485232067511,2.625
2009,"University of Maryland, College Park",UMHOOqlIF,12,1000,927,73,1.05596620908131,3.65
2009,"University of Maryland, College Park",UMHOOqlIF,13,1000,696,304,1.33689839572193,5.84615384615385
2009,"University of Maryland, College Park",UMHOOqlIF,14,1000,927,73,1.04058272632674,2.14705882352941
2009,"University of Maryland, College Park",UMHOOqlIF,15,1000,946,54,1.03092783505155,2.25
2009,"University of Maryland, College Park",UMHOOqlIF,16,1000,938,62,1.03412616339193,2.13793103448276
2009,"University of Maryland, College Park",UMHOOqlIF,17,1000,975,25,1.01419878296146,2.27272727272727
2009,"University of Maryland, College Park",UMHOOqlIF,18,1000,934,66,1.03734439834025,2.2
2009,"University of Maryland, College Park",UMHOOqlIF,19,1000,933,67,1.04384133611691,2.68
2009,"University of Maryland, College Park",UMHOOqlIF,20,1000,973,27,1.01419878296146,2.07692307692308
2009,"University of Maryland, College Park",UMHOOqlIF,21,1000,935,65,1.03842159916926,2.32142857142857
2009,"University of Maryland, College Park",UMHOOqlIF,22,1000,979,21,1.01214574898785,2.33333333333333
2009,"University of Maryland, College Park",UMHOOqlIF,23,1000,940,60,1.0351966873706,2.30769230769231
2009,"University of Maryland, College Park",UMHOOqlIF,24,1000,887,113,1.07642626480086,2.69047619047619
2009,"University of Maryland, College Park",UMHOOqlIF,25,1000,912,88,1.04712041884817,2.04651162790698
2009,"University of Maryland, College Park",UMHOOqlIF,26,1000,946,54,1.02880658436214,2.07692307692308
2009,"University of Maryland, College Park",UMHOOqlIF,27,1000,958,42,1.02459016393443,2.33333333333333
2009,"University of Maryland, College Park",UMHOOqlIF,28,1000,889,111,1.07642626480086,2.775
2009,"University of Maryland, College Park",UMHOOqlIF,29,1000,981,19,1.01317122593718,3.16666666666667
2009,"University of Maryland, College Park",UMHOOqlIF,30,1000,960,40,1.02040816326531,2
2009,"University of Maryland, College Park",UMHOOqlIF,31,1000,885,115,1.06837606837607,2.25490196078431
2009,"University of Maryland, College Park",UMHOOqlIF,32,1000,915,85,1.06269925611052,3.26923076923077
2009,"University of Maryland, College Park",UMHOOqlIF,33,1000,972,28,1.01522842639594,2.15384615384615
2009,"University of Maryland, College Park",UMHOOqlIF,34,1000,970,30,1.01729399796541,2.30769230769231
2009,"University of Maryland, College Park",UMHOOqlIF,35,1000,889,111,1.06951871657754,2.41304347826087
2009,"University of Maryland, College Park",UMHOOqlIF,36,1000,952,48,1.02986611740474,2.52631578947368
2009,"University of Maryland, College Park",UMHOOqlIF,37,1000,943,57,1.03199174406605,2.19230769230769
2009,"University of Maryland, College Park",UMHOOqlIF,38,1000,954,46,1.02459016393443,2.09090909090909
2009,"University of Maryland, College Park",UMHOOqlIF,39,1000,964,36,1.01936799184506,2.11764705882353
2009,"University of Maryland, College Park",UMHOOqlIF,40,1000,780,220,1.15740740740741,2.61904761904762
2009,"University of Maryland, College Park",UMHOOqlIF,41,1000,896,104,1.06723585912487,2.53658536585366
2009,"University of Maryland, College Park",UMHOOqlIF,42,1000,906,94,1.05932203389831,2.47368421052632
2009,"University of Maryland, College Park",UMHOOqlIF,43,1000,923,77,1.04712041884817,2.40625
2009,"University of Maryland, College Park",UMHOOqlIF,44,1000,868,132,1.09409190371991,2.8695652173913
2009,"University of Maryland, College Park",UMHOOqlIF,45,1000,963,37,1.01936799184506,2.05555555555556
2009,"University of Maryland, College Park",UMHOOqlIF,46,1000,958,42,1.02459016393443,2.33333333333333
2009,"University of Maryland, College Park",UMHOOqlIF,47,1000,955,45,1.02669404517454,2.36842105263158
2009,"University of Maryland, College Park",UMHOOqlIF,48,1000,905,95,1.06157112526539,2.56756756756757
2009,"University of Maryland, College Park",UMHOOqlIF,49,1000,902,98,1.06269925611052,2.51282051282051
2009,"University of Maryland, College Park",UMHOOqlIF,50,1000,951,49,1.02774922918808,2.22727272727273
2009,"University of Maryland, College Park",UMHOOsd,1,1000,854,146,1.11111111111111,3.17391304347826
2009,"University of Maryland, College Park",UMHOOsd,2,1000,818,182,1.11482720178372,2.30379746835443
2009,"University of Maryland, College Park",UMHOOsd,3,1000,871,129,1.07991360691145,2.34545454545455
2009,"University of Maryland, College Park",UMHOOsd,4,1000,802,198,1.14025085518814,2.64
2009,"University of Maryland, College Park",UMHOOsd,5,1000,840,160,1.1001100110011,2.31884057971015
2009,"University of Maryland, College Park",UMHOOsd,6,1000,584,416,1.32275132275132,2.41860465116279
2009,"University of Maryland, College Park",UMHOOsd,7,1000,950,50,1.02669404517454,2.08333333333333
2009,"University of Maryland, College Park",UMHOOsd,8,1000,841,159,1.1037527593819,2.44615384615385
2009,"University of Maryland, College Park",UMHOOsd,9,1000,932,68,1.03950103950104,2.26666666666667
2009,"University of Maryland, College Park",UMHOOsd,10,1000,828,172,1.10864745011086,2.32432432432432
2009,"University of Maryland, College Park",UMHOOsd,11,1000,857,143,1.08225108225108,2.13432835820896
2009,"University of Maryland, College Park",UMHOOsd,12,1000,752,248,1.18203309692671,2.63829787234043
2009,"University of Maryland, College Park",UMHOOsd,13,1000,422,578,1.70648464163823,3.52439024390244
2009,"University of Maryland, College Park",UMHOOsd,14,1000,782,218,1.13378684807256,2.18
2009,"University of Maryland, College Park",UMHOOsd,15,1000,909,91,1.05263157894737,2.21951219512195
2009,"University of Maryland, College Park",UMHOOsd,16,1000,745,255,1.15340253748558,2.09016393442623
2009,"University of Maryland, College Park",UMHOOsd,17,1000,967,33,1.0183299389002,2.2
2009,"University of Maryland, College Park",UMHOOsd,18,1000,913,87,1.0515247108307,2.28947368421053
2009,"University of Maryland, College Park",UMHOOsd,19,1000,770,230,1.17508813160987,2.83950617283951
2009,"University of Maryland, College Park",UMHOOsd,20,1000,858,142,1.08813928182807,2.32786885245902
2009,"University of Maryland, College Park",UMHOOsd,21,1000,875,125,1.09289617486339,3.125
2009,"University of Maryland, College Park",UMHOOsd,22,1000,961,39,1.02145045965271,2.16666666666667
2009,"University of Maryland, College Park",UMHOOsd,23,1000,428,572,1.89753320683112,5.77777777777778
2009,"University of Maryland, College Park",UMHOOsd,24,1000,847,153,1.09409190371991,2.28358208955224
2009,"University of Maryland, College Park",UMHOOsd,25,1000,693,307,1.23152709359606,2.57983193277311
2009,"University of Maryland, College Park",UMHOOsd,26,1000,854,146,1.09649122807018,2.51724137931035
2009,"University of Maryland, College Park",UMHOOsd,27,1000,901,99,1.05708245243129,2.2
2009,"University of Maryland, College Park",UMHOOsd,28,1000,637,363,1.33868808567604,3.3
2009,"University of Maryland, College Park",UMHOOsd,29,1000,941,59,1.0351966873706,2.36
2009,"University of Maryland, College Park",UMHOOsd,30,1000,863,137,1.0752688172043,2.04477611940299
2009,"University of Maryland, College Park",UMHOOsd,31,1000,770,230,1.16279069767442,2.55555555555556
2009,"University of Maryland, College Park",UMHOOsd,32,1000,855,145,1.08695652173913,2.23076923076923
2009,"University of Maryland, College Park",UMHOOsd,33,1000,925,75,1.04384133611691,2.27272727272727
2009,"University of Maryland, College Park",UMHOOsd,34,1000,930,70,1.03734439834025,2.05882352941176
2009,"University of Maryland, College Park",UMHOOsd,35,1000,743,257,1.17370892018779,2.35779816513761
2009,"University of Maryland, College Park",UMHOOsd,36,1000,926,74,1.04275286757039,2.24242424242424
2009,"University of Maryland, College Park",UMHOOsd,37,1000,839,161,1.11482720178372,2.77586206896552
2009,"University of Maryland, College Park",UMHOOsd,38,1000,912,88,1.04712041884817,2.04651162790698
2009,"University of Maryland, College Park",UMHOOsd,39,1000,840,160,1.10497237569061,2.46153846153846
2009,"University of Maryland, College Park",UMHOOsd,40,132,120,12,1.04761904761905,2
2009,"University of Maryland, College Park",UMHOOsd,41,1000,793,207,1.13895216400911,2.43529411764706
2009,"University of Maryland, College Park",UMHOOsd,42,1000,840,160,1.1001100110011,2.31884057971015
2009,"University of Maryland, College Park",UMHOOsd,43,1000,898,102,1.06157112526539,2.31818181818182
2009,"University of Maryland, College Park",UMHOOsd,44,1000,797,203,1.16686114352392,3.38333333333333
2009,"University of Maryland, College Park",UMHOOsd,45,1000,878,122,1.0752688172043,2.34615384615385
2009,"University of Maryland, College Park",UMHOOsd,46,1000,855,145,1.10497237569061,2.9
2009,"University of Maryland, College Park",UMHOOsd,47,1000,898,102,1.05932203389831,2.21739130434783
2009,"University of Maryland, College Park",UMHOOsd,48,1000,889,111,1.07296137339056,2.58139534883721
2009,"University of Maryland, College Park",UMHOOsd,49,1000,738,262,1.19760479041916,2.70103092783505
2009,"University of Maryland, College Park",UMHOOsd,50,1000,926,74,1.04166666666667,2.17647058823529
2009,"University of Maryland, College Park",UMHOOsdp,1,1000,854,146,1.11111111111111,3.17391304347826
2009,"University of Maryland, College Park",UMHOOsdp,2,1000,818,182,1.11482720178372,2.30379746835443
2009,"University of Maryland, College Park",UMHOOsdp,3,1000,871,129,1.07991360691145,2.34545454545455
2009,"University of Maryland, College Park",UMHOOsdp,4,1000,802,198,1.14025085518814,2.64
2009,"University of Maryland, College Park",UMHOOsdp,5,1000,840,160,1.1001100110011,2.31884057971015
2009,"University of Maryland, College Park",UMHOOsdp,6,1000,584,416,1.32275132275132,2.41860465116279
2009,"University of Maryland, College Park",UMHOOsdp,7,1000,950,50,1.02669404517454,2.08333333333333
2009,"University of Maryland, College Park",UMHOOsdp,8,1000,841,159,1.1037527593819,2.44615384615385
2009,"University of Maryland, College Park",UMHOOsdp,9,1000,932,68,1.03950103950104,2.26666666666667
2009,"University of Maryland, College Park",UMHOOsdp,10,1000,828,172,1.10864745011086,2.32432432432432
2009,"University of Maryland, College Park",UMHOOsdp,11,1000,857,143,1.08225108225108,2.13432835820896
2009,"University of Maryland, College Park",UMHOOsdp,12,1000,752,248,1.18203309692671,2.63829787234043
2009,"University of Maryland, College Park",UMHOOsdp,13,1000,422,578,1.70648464163823,3.52439024390244
2009,"University of Maryland, College Park",UMHOOsdp,14,1000,782,218,1.13378684807256,2.18
2009,"University of Maryland, College Park",UMHOOsdp,15,1000,909,91,1.05263157894737,2.21951219512195
2009,"University of Maryland, College Park",UMHOOsdp,16,1000,745,255,1.15340253748558,2.09016393442623
2009,"University of Maryland, College Park",UMHOOsdp,17,1000,967,33,1.0183299389002,2.2
2009,"University of Maryland, College Park",UMHOOsdp,18,1000,913,87,1.0515247108307,2.28947368421053
2009,"University of Maryland, College Park",UMHOOsdp,19,1000,770,230,1.17508813160987,2.83950617283951
2009,"University of Maryland, College Park",UMHOOsdp,20,1000,858,142,1.08813928182807,2.32786885245902
2009,"University of Maryland, College Park",UMHOOsdp,21,1000,875,125,1.09289617486339,3.125
2009,"University of Maryland, College Park",UMHOOsdp,22,1000,961,39,1.02145045965271,2.16666666666667
2009,"University of Maryland, College Park",UMHOOsdp,23,1000,428,572,1.89753320683112,5.77777777777778
2009,"University of Maryland, College Park",UMHOOsdp,24,1000,847,153,1.09409190371991,2.28358208955224
2009,"University of Maryland, College Park",UMHOOsdp,25,1000,693,307,1.23152709359606,2.57983193277311
2009,"University of Maryland, College Park",UMHOOsdp,26,1000,854,146,1.09649122807018,2.51724137931035
2009,"University of Maryland, College Park",UMHOOsdp,27,1000,901,99,1.05708245243129,2.2
2009,"University of Maryland, College Park",UMHOOsdp,28,1000,637,363,1.33868808567604,3.3
2009,"University of Maryland, College Park",UMHOOsdp,29,1000,880,120,1.07874865156419,2.5531914893617
2009,"University of Maryland, College Park",UMHOOsdp,30,1000,863,137,1.0752688172043,2.04477611940299
2009,"University of Maryland, College Park",UMHOOsdp,31,1000,770,230,1.16279069767442,2.55555555555556
2009,"University of Maryland, College Park",UMHOOsdp,32,1000,855,145,1.08695652173913,2.23076923076923
2009,"University of Maryland, College Park",UMHOOsdp,33,1000,925,75,1.04384133611691,2.27272727272727
2009,"University of Maryland, College Park",UMHOOsdp,34,1000,930,70,1.03734439834025,2.05882352941176
2009,"University of Maryland, College Park",UMHOOsdp,35,1000,743,257,1.17370892018779,2.35779816513761
2009,"University of Maryland, College Park",UMHOOsdp,36,1000,926,74,1.04275286757039,2.24242424242424
2009,"University of Maryland, College Park",UMHOOsdp,37,1000,839,161,1.11482720178372,2.77586206896552
2009,"University of Maryland, College Park",UMHOOsdp,38,1000,912,88,1.04712041884817,2.04651162790698
2009,"University of Maryland, College Park",UMHOOsdp,39,1000,840,160,1.10497237569061,2.46153846153846
2009,"University of Maryland, College Park",UMHOOsdp,40,132,120,12,1.04761904761905,2
2009,"University of Maryland, College Park",UMHOOsdp,41,1000,793,207,1.13895216400911,2.43529411764706
2009,"University of Maryland, College Park",UMHOOsdp,42,1000,840,160,1.1001100110011,2.31884057971015
2009,"University of Maryland, College Park",UMHOOsdp,43,1000,898,102,1.06157112526539,2.31818181818182
2009,"University of Maryland, College Park",UMHOOsdp,44,1000,797,203,1.16686114352392,3.38333333333333
2009,"University of Maryland, College Park",UMHOOsdp,45,1000,878,122,1.0752688172043,2.34615384615385
2009,"University of Maryland, College Park",UMHOOsdp,46,1000,855,145,1.10497237569061,2.9
2009,"University of Maryland, College Park",UMHOOsdp,47,1000,898,102,1.05932203389831,2.21739130434783
2009,"University of Maryland, College Park",UMHOOsdp,48,1000,889,111,1.07296137339056,2.58139534883721
2009,"University of Maryland, College Park",UMHOOsdp,49,1000,738,262,1.19760479041916,2.70103092783505
2009,"University of Maryland, College Park",UMHOOsdp,50,1000,926,74,1.04166666666667,2.17647058823529
2009,University of Amsterdam,UamsAw7an3,1,1000,745,255,1.18343195266272,2.55
2009,University of Amsterdam,UamsAw7an3,2,1000,968,32,1.01729399796541,2.13333333333333
2009,University of Amsterdam,UamsAw7an3,3,1000,952,48,1.02459016393443,2
2009,University of Amsterdam,UamsAw7an3,4,1000,899,101,1.05374077976818,2.02
2009,University of Amsterdam,UamsAw7an3,5,1000,940,60,1.03092783505155,2
2009,University of Amsterdam,UamsAw7an3,6,1000,844,156,1.09170305676856,2.16666666666667
2009,University of Amsterdam,UamsAw7an3,7,1000,951,49,1.02564102564103,2.04166666666667
2009,University of Amsterdam,UamsAw7an3,8,1000,863,137,1.07874865156419,2.140625
2009,University of Amsterdam,UamsAw7an3,9,1000,948,52,1.02669404517454,2
2009,University of Amsterdam,UamsAw7an3,10,1000,962,38,1.01936799184506,2
2009,University of Amsterdam,UamsAw7an3,11,1000,994,6,1.00300902708124,2
2009,University of Amsterdam,UamsAw7an3,12,1000,899,101,1.05596620908131,2.10416666666667
2009,University of Amsterdam,UamsAw7an3,13,1000,948,52,1.02880658436214,2.16666666666667
2009,University of Amsterdam,UamsAw7an3,14,1000,821,179,1.10987791342952,2.2375
2009,University of Amsterdam,UamsAw7an3,15,1000,921,79,1.04275286757039,2.07894736842105
2009,University of Amsterdam,UamsAw7an3,16,1000,976,24,1.01214574898785,2
2009,University of Amsterdam,UamsAw7an3,17,1000,976,24,1.01214574898785,2
2009,University of Amsterdam,UamsAw7an3,18,1000,783,217,1.13122171945701,2.14851485148515
2009,University of Amsterdam,UamsAw7an3,19,1000,898,102,1.05485232067511,2.04
2009,University of Amsterdam,UamsAw7an3,20,1000,827,173,1.10253583241455,2.1625
2009,University of Amsterdam,UamsAw7an3,21,1000,912,88,1.04712041884817,2.04651162790698
2009,University of Amsterdam,UamsAw7an3,22,1000,980,20,1.01010101010101,2
2009,University of Amsterdam,UamsAw7an3,23,1000,962,38,1.02040816326531,2.11111111111111
2009,University of Amsterdam,UamsAw7an3,24,1000,795,205,1.12233445566779,2.13541666666667
2009,University of Amsterdam,UamsAw7an3,25,1000,801,199,1.12739571589628,2.31395348837209
2009,University of Amsterdam,UamsAw7an3,26,1000,972,28,1.01419878296146,2
2009,University of Amsterdam,UamsAw7an3,27,1000,901,99,1.05374077976818,2.0625
2009,University of Amsterdam,UamsAw7an3,28,1000,908,92,1.05042016806723,2.09090909090909
2009,University of Amsterdam,UamsAw7an3,29,1000,965,35,1.0183299389002,2.05882352941176
2009,University of Amsterdam,UamsAw7an3,30,1000,962,38,1.01936799184506,2
2009,University of Amsterdam,UamsAw7an3,31,1000,870,130,1.07758620689655,2.24137931034483
2009,University of Amsterdam,UamsAw7an3,32,1000,947,53,1.02774922918808,2.03846153846154
2009,University of Amsterdam,UamsAw7an3,33,1000,898,102,1.05820105820106,2.17021276595745
2009,University of Amsterdam,UamsAw7an3,34,1000,961,39,1.02040816326531,2.05263157894737
2009,University of Amsterdam,UamsAw7an3,35,1000,869,131,1.07874865156419,2.25862068965517
2009,University of Amsterdam,UamsAw7an3,36,1000,870,130,1.0752688172043,2.16666666666667
2009,University of Amsterdam,UamsAw7an3,37,1000,789,211,1.12359550561798,2.08910891089109
2009,University of Amsterdam,UamsAw7an3,38,1000,972,28,1.01419878296146,2
2009,University of Amsterdam,UamsAw7an3,39,1000,972,28,1.01419878296146,2
2009,University of Amsterdam,UamsAw7an3,40,142,132,10,1.03649635036496,2
2009,University of Amsterdam,UamsAw7an3,41,1000,968,32,1.01626016260163,2
2009,University of Amsterdam,UamsAw7an3,42,1000,928,72,1.03734439834025,2
2009,University of Amsterdam,UamsAw7an3,43,1000,948,52,1.02669404517454,2
2009,University of Amsterdam,UamsAw7an3,44,1000,923,77,1.04058272632674,2.02631578947368
2009,University of Amsterdam,UamsAw7an3,45,1000,976,24,1.01214574898785,2
2009,University of Amsterdam,UamsAw7an3,46,1000,967,33,1.01729399796541,2.0625
2009,University of Amsterdam,UamsAw7an3,47,1000,792,208,1.12739571589628,2.18947368421053
2009,University of Amsterdam,UamsAw7an3,48,1000,979,21,1.01112234580384,2.1
2009,University of Amsterdam,UamsAw7an3,49,1000,974,26,1.01317122593718,2
2009,University of Amsterdam,UamsAw7an3,50,1000,966,34,1.01729399796541,2
2009,University of Amsterdam,UamsAwebQE10,1,1000,914,86,1.04493207941484,2
2009,University of Amsterdam,UamsAwebQE10,2,1000,953,47,1.02459016393443,2.04347826086957
2009,University of Amsterdam,UamsAwebQE10,3,1000,973,27,1.01419878296146,2.07692307692308
2009,University of Amsterdam,UamsAwebQE10,4,1000,950,50,1.02669404517454,2.08333333333333
2009,University of Amsterdam,UamsAwebQE10,5,1000,952,48,1.02459016393443,2
2009,University of Amsterdam,UamsAwebQE10,6,1000,744,256,1.16009280742459,2.16949152542373
2009,University of Amsterdam,UamsAwebQE10,7,1000,769,231,1.25,7.45161290322581
2009,University of Amsterdam,UamsAwebQE10,8,1000,943,57,1.02986611740474,2.03571428571429
2009,University of Amsterdam,UamsAwebQE10,9,1000,956,44,1.02354145342886,2.0952380952381
2009,University of Amsterdam,UamsAwebQE10,10,1000,932,68,1.03734439834025,2.125
2009,University of Amsterdam,UamsAwebQE10,11,1000,964,36,1.0183299389002,2
2009,University of Amsterdam,UamsAwebQE10,12,1000,787,213,1.13765642775882,2.31521739130435
2009,University of Amsterdam,UamsAwebQE10,13,1000,596,404,1.31061598951507,2.41916167664671
2009,University of Amsterdam,UamsAwebQE10,14,1000,926,74,1.03842159916926,2
2009,University of Amsterdam,UamsAwebQE10,15,1000,732,268,1.22549019607843,3.19047619047619
2009,University of Amsterdam,UamsAwebQE10,16,1000,956,44,1.02249488752556,2
2009,University of Amsterdam,UamsAwebQE10,17,1000,958,42,1.02145045965271,2
2009,University of Amsterdam,UamsAwebQE10,18,1000,817,183,1.10497237569061,2.07954545454545
2009,University of Amsterdam,UamsAwebQE10,19,1000,909,91,1.04931794333683,2.06818181818182
2009,University of Amsterdam,UamsAwebQE10,20,1000,898,102,1.05485232067511,2.04
2009,University of Amsterdam,UamsAwebQE10,21,1000,945,55,1.03199174406605,2.29166666666667
2009,University of Amsterdam,UamsAwebQE10,22,1000,984,16,1.00806451612903,2
2009,University of Amsterdam,UamsAwebQE10,23,1000,678,322,1.26422250316056,2.84955752212389
2009,University of Amsterdam,UamsAwebQE10,24,1000,833,167,1.10132158590308,2.22666666666667
2009,University of Amsterdam,UamsAwebQE10,25,1000,881,119,1.06496272630458,2.05172413793103
2009,University of Amsterdam,UamsAwebQE10,26,1000,963,37,1.01936799184506,2.05555555555556
2009,University of Amsterdam,UamsAwebQE10,27,1000,952,48,1.02564102564103,2.08695652173913
2009,University of Amsterdam,UamsAwebQE10,28,1000,874,126,1.07181136120043,2.13559322033898
2009,University of Amsterdam,UamsAwebQE10,29,1000,970,30,1.01522842639594,2
2009,University of Amsterdam,UamsAwebQE10,30,1000,876,124,1.06951871657754,2.10169491525424
2009,University of Amsterdam,UamsAwebQE10,31,1000,917,83,1.04493207941484,2.075
2009,University of Amsterdam,UamsAwebQE10,32,1000,958,42,1.02249488752556,2.1
2009,University of Amsterdam,UamsAwebQE10,33,1000,956,44,1.02354145342886,2.0952380952381
2009,University of Amsterdam,UamsAwebQE10,34,1000,826,174,1.11482720178372,2.45070422535211
2009,University of Amsterdam,UamsAwebQE10,35,1000,892,108,1.06044538706257,2.11764705882353
2009,University of Amsterdam,UamsAwebQE10,36,1000,954,46,1.02354145342886,2
2009,University of Amsterdam,UamsAwebQE10,37,1000,682,318,1.26103404791929,2.86486486486487
2009,University of Amsterdam,UamsAwebQE10,38,1000,966,34,1.01729399796541,2
2009,University of Amsterdam,UamsAwebQE10,39,1000,957,43,1.02249488752556,2.04761904761905
2009,University of Amsterdam,UamsAwebQE10,40,141,133,8,1.02919708029197,2
2009,University of Amsterdam,UamsAwebQE10,41,1000,889,111,1.07066381156317,2.46666666666667
2009,University of Amsterdam,UamsAwebQE10,42,1000,945,55,1.02880658436214,2.03703703703704
2009,University of Amsterdam,UamsAwebQE10,43,1000,975,25,1.01317122593718,2.08333333333333
2009,University of Amsterdam,UamsAwebQE10,44,1000,925,75,1.03950103950104,2.02702702702703
2009,University of Amsterdam,UamsAwebQE10,45,1000,946,54,1.02986611740474,2.16
2009,University of Amsterdam,UamsAwebQE10,46,1000,943,57,1.02986611740474,2.03571428571429
2009,University of Amsterdam,UamsAwebQE10,47,1000,535,465,1.4903129657228,3.41911764705882
2009,University of Amsterdam,UamsAwebQE10,48,1000,933,67,1.04058272632674,2.39285714285714
2009,University of Amsterdam,UamsAwebQE10,49,1000,923,77,1.04602510460251,2.33333333333333
2009,University of Amsterdam,UamsAwebQE10,50,1000,950,50,1.02986611740474,2.38095238095238
2009,University of Waterloo (Smucker),WatSdmrm3,1,1000,920,80,1.04275286757039,2.05128205128205
2009,University of Waterloo (Smucker),WatSdmrm3,2,1000,974,26,1.01317122593718,2
2009,University of Waterloo (Smucker),WatSdmrm3,3,1000,958,42,1.02145045965271,2
2009,University of Waterloo (Smucker),WatSdmrm3,4,1000,922,78,1.05374077976818,2.88888888888889
2009,University of Waterloo (Smucker),WatSdmrm3,5,1000,953,47,1.02459016393443,2.04347826086957
2009,University of Waterloo (Smucker),WatSdmrm3,6,1000,945,55,1.02880658436214,2.03703703703704
2009,University of Waterloo (Smucker),WatSdmrm3,7,1000,946,54,1.03305785123967,2.45454545454545
2009,University of Waterloo (Smucker),WatSdmrm3,8,1000,977,23,1.01214574898785,2.09090909090909
2009,University of Waterloo (Smucker),WatSdmrm3,9,1000,965,35,1.0183299389002,2.05882352941176
2009,University of Waterloo (Smucker),WatSdmrm3,10,1000,956,44,1.02249488752556,2
2009,University of Waterloo (Smucker),WatSdmrm3,11,1000,947,53,1.02774922918808,2.03846153846154
2009,University of Waterloo (Smucker),WatSdmrm3,12,1000,871,129,1.0989010989011,3.30769230769231
2009,University of Waterloo (Smucker),WatSdmrm3,13,1000,792,208,1.17508813160987,3.52542372881356
2009,University of Waterloo (Smucker),WatSdmrm3,14,1000,964,36,1.0183299389002,2
2009,University of Waterloo (Smucker),WatSdmrm3,15,1000,964,36,1.0183299389002,2
2009,University of Waterloo (Smucker),WatSdmrm3,16,1000,940,60,1.03305785123967,2.14285714285714
2009,University of Waterloo (Smucker),WatSdmrm3,17,1000,975,25,1.01317122593718,2.08333333333333
2009,University of Waterloo (Smucker),WatSdmrm3,18,1000,972,28,1.01419878296146,2
2009,University of Waterloo (Smucker),WatSdmrm3,19,1000,984,16,1.00806451612903,2
2009,University of Waterloo (Smucker),WatSdmrm3,20,1000,949,51,1.02774922918808,2.125
2009,University of Waterloo (Smucker),WatSdmrm3,21,1000,979,21,1.01112234580384,2.1
2009,University of Waterloo (Smucker),WatSdmrm3,22,1000,968,32,1.01626016260163,2
2009,University of Waterloo (Smucker),WatSdmrm3,23,1000,955,45,1.02459016393443,2.14285714285714
2009,University of Waterloo (Smucker),WatSdmrm3,24,1000,927,73,1.03950103950104,2.08571428571429
2009,University of Waterloo (Smucker),WatSdmrm3,25,1000,935,65,1.03626943005181,2.16666666666667
2009,University of Waterloo (Smucker),WatSdmrm3,26,1000,962,38,1.01936799184506,2
2009,University of Waterloo (Smucker),WatSdmrm3,27,1000,976,24,1.01214574898785,2
2009,University of Waterloo (Smucker),WatSdmrm3,28,1000,960,40,1.02354145342886,2.35294117647059
2009,University of Waterloo (Smucker),WatSdmrm3,29,1000,958,42,1.02145045965271,2
2009,University of Waterloo (Smucker),WatSdmrm3,30,1000,973,27,1.01419878296146,2.07692307692308
2009,University of Waterloo (Smucker),WatSdmrm3,31,1000,953,47,1.02459016393443,2.04347826086957
2009,University of Waterloo (Smucker),WatSdmrm3,32,1000,954,46,1.02459016393443,2.09090909090909
2009,University of Waterloo (Smucker),WatSdmrm3,33,1000,988,12,1.00603621730382,2
2009,University of Waterloo (Smucker),WatSdmrm3,34,1000,970,30,1.01522842639594,2
2009,University of Waterloo (Smucker),WatSdmrm3,35,1000,960,40,1.02459016393443,2.5
2009,University of Waterloo (Smucker),WatSdmrm3,36,1000,971,29,1.01522842639594,2.07142857142857
2009,University of Waterloo (Smucker),WatSdmrm3,37,1000,957,43,1.02249488752556,2.04761904761905
2009,University of Waterloo (Smucker),WatSdmrm3,38,1000,910,90,1.0482180293501,2.04545454545455
2009,University of Waterloo (Smucker),WatSdmrm3,39,1000,986,14,1.00704934541793,2
2009,University of Waterloo (Smucker),WatSdmrm3,40,1000,954,46,1.02459016393443,2.09090909090909
2009,University of Waterloo (Smucker),WatSdmrm3,41,1000,749,251,1.18623962040332,2.67021276595745
2009,University of Waterloo (Smucker),WatSdmrm3,42,1000,968,32,1.0183299389002,2.28571428571429
2009,University of Waterloo (Smucker),WatSdmrm3,43,1000,987,13,1.00704934541793,2.16666666666667
2009,University of Waterloo (Smucker),WatSdmrm3,44,1000,948,52,1.02880658436214,2.16666666666667
2009,University of Waterloo (Smucker),WatSdmrm3,45,1000,951,49,1.02564102564103,2.04166666666667
2009,University of Waterloo (Smucker),WatSdmrm3,46,1000,943,57,1.03199174406605,2.19230769230769
2009,University of Waterloo (Smucker),WatSdmrm3,47,1000,972,28,1.01419878296146,2
2009,University of Waterloo (Smucker),WatSdmrm3,48,1000,968,32,1.01626016260163,2
2009,University of Waterloo (Smucker),WatSdmrm3,49,1000,949,51,1.02880658436214,2.21739130434783
2009,University of Waterloo (Smucker),WatSdmrm3,50,1000,969,31,1.01626016260163,2.06666666666667
2009,University of Waterloo (Smucker),WatSdmrm3we,1,1000,946,54,1.02880658436214,2.07692307692308
2009,University of Waterloo (Smucker),WatSdmrm3we,2,1000,968,32,1.01626016260163,2
2009,University of Waterloo (Smucker),WatSdmrm3we,3,1000,962,38,1.01936799184506,2
2009,University of Waterloo (Smucker),WatSdmrm3we,4,1000,923,77,1.04712041884817,2.40625
2009,University of Waterloo (Smucker),WatSdmrm3we,5,1000,967,33,1.01729399796541,2.0625
2009,University of Waterloo (Smucker),WatSdmrm3we,6,1000,955,45,1.02354145342886,2.04545454545455
2009,University of Waterloo (Smucker),WatSdmrm3we,7,1000,894,106,1.07066381156317,2.65
2009,University of Waterloo (Smucker),WatSdmrm3we,8,1000,955,45,1.02354145342886,2.04545454545455
2009,University of Waterloo (Smucker),WatSdmrm3we,9,1000,966,34,1.01729399796541,2
2009,University of Waterloo (Smucker),WatSdmrm3we,10,1000,978,22,1.01112234580384,2
2009,University of Waterloo (Smucker),WatSdmrm3we,11,1000,978,22,1.01112234580384,2
2009,University of Waterloo (Smucker),WatSdmrm3we,12,1000,921,79,1.04275286757039,2.07894736842105
2009,University of Waterloo (Smucker),WatSdmrm3we,13,1000,845,155,1.10132158590308,2.46031746031746
2009,University of Waterloo (Smucker),WatSdmrm3we,14,1000,937,63,1.03412616339193,2.1
2009,University of Waterloo (Smucker),WatSdmrm3we,15,1000,988,12,1.00603621730382,2
2009,University of Waterloo (Smucker),WatSdmrm3we,16,1000,952,48,1.02459016393443,2
2009,University of Waterloo (Smucker),WatSdmrm3we,17,1000,970,30,1.01522842639594,2
2009,University of Waterloo (Smucker),WatSdmrm3we,18,1000,973,27,1.01419878296146,2.07692307692308
2009,University of Waterloo (Smucker),WatSdmrm3we,19,1000,950,50,1.02564102564103,2
2009,University of Waterloo (Smucker),WatSdmrm3we,20,1000,963,37,1.02040816326531,2.17647058823529
2009,University of Waterloo (Smucker),WatSdmrm3we,21,1000,982,18,1.00908173562059,2
2009,University of Waterloo (Smucker),WatSdmrm3we,22,1000,982,18,1.00908173562059,2
2009,University of Waterloo (Smucker),WatSdmrm3we,23,1000,901,99,1.05596620908131,2.15217391304348
2009,University of Waterloo (Smucker),WatSdmrm3we,24,1000,912,88,1.05042016806723,2.2
2009,University of Waterloo (Smucker),WatSdmrm3we,25,1000,934,66,1.0351966873706,2.0625
2009,University of Waterloo (Smucker),WatSdmrm3we,26,1000,971,29,1.01522842639594,2.07142857142857
2009,University of Waterloo (Smucker),WatSdmrm3we,27,1000,980,20,1.01010101010101,2
2009,University of Waterloo (Smucker),WatSdmrm3we,28,1000,805,195,1.18063754427391,4.64285714285714
2009,University of Waterloo (Smucker),WatSdmrm3we,29,1000,972,28,1.01419878296146,2
2009,University of Waterloo (Smucker),WatSdmrm3we,30,1000,972,28,1.01419878296146,2
2009,University of Waterloo (Smucker),WatSdmrm3we,31,1000,933,67,1.03626943005181,2.09375
2009,University of Waterloo (Smucker),WatSdmrm3we,32,1000,954,46,1.02564102564103,2.19047619047619
2009,University of Waterloo (Smucker),WatSdmrm3we,33,1000,988,12,1.00603621730382,2
2009,University of Waterloo (Smucker),WatSdmrm3we,34,1000,984,16,1.00806451612903,2
2009,University of Waterloo (Smucker),WatSdmrm3we,35,1000,964,36,1.0183299389002,2
2009,University of Waterloo (Smucker),WatSdmrm3we,36,1000,954,46,1.02354145342886,2
2009,University of Waterloo (Smucker),WatSdmrm3we,37,1000,984,16,1.00806451612903,2
2009,University of Waterloo (Smucker),WatSdmrm3we,38,1000,955,45,1.02354145342886,2.04545454545455
2009,University of Waterloo (Smucker),WatSdmrm3we,39,1000,968,32,1.01626016260163,2
2009,University of Waterloo (Smucker),WatSdmrm3we,40,1000,943,57,1.03092783505155,2.11111111111111
2009,University of Waterloo (Smucker),WatSdmrm3we,41,1000,758,242,1.16822429906542,2.46938775510204
2009,University of Waterloo (Smucker),WatSdmrm3we,42,1000,967,33,1.01936799184506,2.35714285714286
2009,University of Waterloo (Smucker),WatSdmrm3we,43,1000,952,48,1.02669404517454,2.18181818181818
2009,University of Waterloo (Smucker),WatSdmrm3we,44,1000,945,55,1.03092783505155,2.2
2009,University of Waterloo (Smucker),WatSdmrm3we,45,1000,978,22,1.01112234580384,2
2009,University of Waterloo (Smucker),WatSdmrm3we,46,1000,967,33,1.0183299389002,2.2
2009,University of Waterloo (Smucker),WatSdmrm3we,47,1000,983,17,1.00908173562059,2.125
2009,University of Waterloo (Smucker),WatSdmrm3we,48,1000,985,15,1.00806451612903,2.14285714285714
2009,University of Waterloo (Smucker),WatSdmrm3we,49,1000,931,69,1.04058272632674,2.3
2009,University of Waterloo (Smucker),WatSdmrm3we,50,1000,970,30,1.0183299389002,2.5
2009,University of Waterloo (Smucker),WatSql,1,1000,738,262,1.17508813160987,2.31858407079646
2009,University of Waterloo (Smucker),WatSql,2,1000,962,38,1.01936799184506,2
2009,University of Waterloo (Smucker),WatSql,3,1000,961,39,1.02145045965271,2.16666666666667
2009,University of Waterloo (Smucker),WatSql,4,1000,907,93,1.06269925611052,2.73529411764706
2009,University of Waterloo (Smucker),WatSql,5,1000,952,48,1.02564102564103,2.08695652173913
2009,University of Waterloo (Smucker),WatSql,6,1000,861,139,1.08108108108108,2.171875
2009,University of Waterloo (Smucker),WatSql,7,1000,924,76,1.04493207941484,2.3030303030303
2009,University of Waterloo (Smucker),WatSql,8,1000,948,52,1.02774922918808,2.08
2009,University of Waterloo (Smucker),WatSql,9,1000,957,43,1.02249488752556,2.04761904761905
2009,University of Waterloo (Smucker),WatSql,10,1000,965,35,1.0183299389002,2.05882352941176
2009,University of Waterloo (Smucker),WatSql,11,1000,924,76,1.04275286757039,2.17142857142857
2009,University of Waterloo (Smucker),WatSql,12,1000,754,246,1.16279069767442,2.32075471698113
2009,University of Waterloo (Smucker),WatSql,13,1000,735,265,1.23152709359606,3.44155844155844
2009,University of Waterloo (Smucker),WatSql,14,1000,942,58,1.03092783505155,2.07142857142857
2009,University of Waterloo (Smucker),WatSql,15,1000,964,36,1.0183299389002,2
2009,University of Waterloo (Smucker),WatSql,16,1000,946,54,1.02774922918808,2
2009,University of Waterloo (Smucker),WatSql,17,1000,970,30,1.01522842639594,2
2009,University of Waterloo (Smucker),WatSql,18,1000,963,37,1.01936799184506,2.05555555555556
2009,University of Waterloo (Smucker),WatSql,19,1000,948,52,1.02986611740474,2.26086956521739
2009,University of Waterloo (Smucker),WatSql,20,1000,941,59,1.03412616339193,2.26923076923077
2009,University of Waterloo (Smucker),WatSql,21,1000,873,127,1.07874865156419,2.35185185185185
2009,University of Waterloo (Smucker),WatSql,22,1000,980,20,1.01010101010101,2
2009,University of Waterloo (Smucker),WatSql,23,1000,848,152,1.08932461873638,2.17142857142857
2009,University of Waterloo (Smucker),WatSql,24,1000,939,61,1.03199174406605,2.03333333333333
2009,University of Waterloo (Smucker),WatSql,25,1000,937,63,1.03412616339193,2.1
2009,University of Waterloo (Smucker),WatSql,26,1000,960,40,1.02040816326531,2
2009,University of Waterloo (Smucker),WatSql,27,1000,937,63,1.03412616339193,2.1
2009,University of Waterloo (Smucker),WatSql,28,1000,932,68,1.04166666666667,2.42857142857143
2009,University of Waterloo (Smucker),WatSql,29,1000,965,35,1.0183299389002,2.05882352941176
2009,University of Waterloo (Smucker),WatSql,30,1000,961,39,1.02040816326531,2.05263157894737
2009,University of Waterloo (Smucker),WatSql,31,1000,927,73,1.03842159916926,2.02777777777778
2009,University of Waterloo (Smucker),WatSql,32,1000,878,122,1.06723585912487,2.06779661016949
2009,University of Waterloo (Smucker),WatSql,33,1000,976,24,1.01214574898785,2
2009,University of Waterloo (Smucker),WatSql,34,1000,949,51,1.02774922918808,2.125
2009,University of Waterloo (Smucker),WatSql,35,1000,917,83,1.04712041884817,2.18421052631579
2009,University of Waterloo (Smucker),WatSql,36,1000,916,84,1.0482180293501,2.21052631578947
2009,University of Waterloo (Smucker),WatSql,37,1000,955,45,1.02774922918808,2.5
2009,University of Waterloo (Smucker),WatSql,38,1000,904,96,1.05263157894737,2.08695652173913
2009,University of Waterloo (Smucker),WatSql,39,1000,967,33,1.01729399796541,2.0625
2009,University of Waterloo (Smucker),WatSql,40,1000,583,417,1.32802124833997,2.45294117647059
2009,University of Waterloo (Smucker),WatSql,41,1000,723,277,1.22399020807834,2.9468085106383
2009,University of Waterloo (Smucker),WatSql,42,1000,922,78,1.04602510460251,2.29411764705882
2009,University of Waterloo (Smucker),WatSql,43,1000,947,53,1.03092783505155,2.30434782608696
2009,University of Waterloo (Smucker),WatSql,44,1000,913,87,1.05485232067511,2.48571428571429
2009,University of Waterloo (Smucker),WatSql,45,1000,954,46,1.02459016393443,2.09090909090909
2009,University of Waterloo (Smucker),WatSql,46,1000,949,51,1.02774922918808,2.125
2009,University of Waterloo (Smucker),WatSql,47,1000,974,26,1.01317122593718,2
2009,University of Waterloo (Smucker),WatSql,48,1000,914,86,1.05932203389831,2.86666666666667
2009,University of Waterloo (Smucker),WatSql,49,1000,915,85,1.05263157894737,2.42857142857143
2009,University of Waterloo (Smucker),WatSql,50,1000,962,38,1.02040816326531,2.11111111111111
2009,"ARSC, Univ of Alaska Fairbanks",arsc09web,1,1000,348,652,1.92307692307692,3.7906976744186
2009,"ARSC, Univ of Alaska Fairbanks",arsc09web,2,1000,738,262,1.20772946859903,2.91111111111111
2009,"ARSC, Univ of Alaska Fairbanks",arsc09web,3,1000,72,928,6.5359477124183,11.4567901234568
2009,"ARSC, Univ of Alaska Fairbanks",arsc09web,4,1000,35,965,13.5135135135135,24.7435897435897
2009,"ARSC, Univ of Alaska Fairbanks",arsc09web,5,1000,252,748,2.5062656641604,5.08843537414966
2009,"ARSC, Univ of Alaska Fairbanks",arsc09web,6,123,15,108,4.73076923076923,9.81818181818182
2009,"ARSC, Univ of Alaska Fairbanks",arsc09web,7,1000,509,491,1.57728706624606,3.928
2009,"ARSC, Univ of Alaska Fairbanks",arsc09web,8,543,18,525,10.6470588235294,15.9090909090909
2009,"ARSC, Univ of Alaska Fairbanks",arsc09web,9,1000,709,291,1.25944584382872,3.42352941176471
2009,"ARSC, Univ of Alaska Fairbanks",arsc09web,10,1000,221,779,2.9585798816568,6.65811965811966
2009,"ARSC, Univ of Alaska Fairbanks",arsc09web,11,1000,166,834,3.7037037037037,8.01923076923077
2009,"ARSC, Univ of Alaska Fairbanks",arsc09web,12,1000,11,989,19.6078431372549,24.725
2009,"ARSC, Univ of Alaska Fairbanks",arsc09web,13,1000,51,949,8.69565217391304,14.828125
2009,"ARSC, Univ of Alaska Fairbanks",arsc09web,14,1000,26,974,14.7058823529412,23.1904761904762
2009,"ARSC, Univ of Alaska Fairbanks",arsc09web,15,1000,225,775,2.68096514745308,5.23648648648649
2009,"ARSC, Univ of Alaska Fairbanks",arsc09web,16,1000,725,275,1.20192307692308,2.57009345794393
2009,"ARSC, Univ of Alaska Fairbanks",arsc09web,17,1000,224,776,3.003003003003,7.11926605504587
2009,"ARSC, Univ of Alaska Fairbanks",arsc09web,18,1000,265,735,2.61780104712042,6.28205128205128
2009,"ARSC, Univ of Alaska Fairbanks",arsc09web,19,1000,282,718,2.24719101123596,4.40490797546012
2009,"ARSC, Univ of Alaska Fairbanks",arsc09web,20,1000,11,989,25.6410256410256,35.3214285714286
2009,"ARSC, Univ of Alaska Fairbanks",arsc09web,21,1000,34,966,14.2857142857143,26.8333333333333
2009,"ARSC, Univ of Alaska Fairbanks",arsc09web,22,1000,146,854,3.73134328358209,7
2009,"ARSC, Univ of Alaska Fairbanks",arsc09web,23,1000,47,953,8.84955752212389,14.4393939393939
2009,"ARSC, Univ of Alaska Fairbanks",arsc09web,24,1000,35,965,14.0845070422535,26.8055555555556
2009,"ARSC, Univ of Alaska Fairbanks",arsc09web,25,1000,13,987,19.6078431372549,25.9736842105263
2009,"ARSC, Univ of Alaska Fairbanks",arsc09web,26,1000,442,558,1.68918918918919,3.72
2009,"ARSC, Univ of Alaska Fairbanks",arsc09web,27,1000,19,981,37.037037037037,122.625
2009,"ARSC, Univ of Alaska Fairbanks",arsc09web,28,848,16,832,18.8444444444444,28.6896551724138
2009,"ARSC, Univ of Alaska Fairbanks",arsc09web,29,1000,142,858,4.0983606557377,8.41176470588235
2009,"ARSC, Univ of Alaska Fairbanks",arsc09web,30,1000,204,796,3.04878048780488,6.41935483870968
2009,"ARSC, Univ of Alaska Fairbanks",arsc09web,31,941,45,896,7.90756302521008,12.1081081081081
2009,"ARSC, Univ of Alaska Fairbanks",arsc09web,32,1000,412,588,1.99203187250996,6.53333333333333
2009,"ARSC, Univ of Alaska Fairbanks",arsc09web,33,1000,65,935,6.94444444444445,11.8354430379747
2009,"ARSC, Univ of Alaska Fairbanks",arsc09web,34,1000,289,711,2.6525198938992,8.07954545454546
2009,"ARSC, Univ of Alaska Fairbanks",arsc09web,35,518,11,507,11.0212765957447,14.0833333333333
2009,"ARSC, Univ of Alaska Fairbanks",arsc09web,36,1000,57,943,9.34579439252336,18.86
2009,"ARSC, Univ of Alaska Fairbanks",arsc09web,37,1000,56,944,7.57575757575758,12.4210526315789
2009,"ARSC, Univ of Alaska Fairbanks",arsc09web,38,1000,591,409,1.32275132275132,2.47878787878788
2009,"ARSC, Univ of Alaska Fairbanks",arsc09web,39,1000,179,821,3.18471337579618,6.08148148148148
2009,"ARSC, Univ of Alaska Fairbanks",arsc09web,40,1,1,0,1,
2009,"ARSC, Univ of Alaska Fairbanks",arsc09web,41,1000,649,351,1.2970168612192,2.87704918032787
2009,"ARSC, Univ of Alaska Fairbanks",arsc09web,42,1000,802,198,1.12612612612613,2.30232558139535
2009,"ARSC, Univ of Alaska Fairbanks",arsc09web,43,1000,586,414,1.37174211248285,2.8951048951049
2009,"ARSC, Univ of Alaska Fairbanks",arsc09web,44,1000,762,238,1.19189511323004,3.09090909090909
2009,"ARSC, Univ of Alaska Fairbanks",arsc09web,45,1000,179,821,3.2258064516129,6.26717557251908
2009,"ARSC, Univ of Alaska Fairbanks",arsc09web,46,1000,190,810,3.02114803625378,5.74468085106383
2009,"ARSC, Univ of Alaska Fairbanks",arsc09web,47,1000,31,969,10.4166666666667,14.9076923076923
2009,"ARSC, Univ of Alaska Fairbanks",arsc09web,48,1000,95,905,4.76190476190476,7.86956521739131
2009,"ARSC, Univ of Alaska Fairbanks",arsc09web,49,1000,75,925,5.91715976331361,9.84042553191489
2009,"ARSC, Univ of Alaska Fairbanks",arsc09web,50,990,157,833,3.21428571428571,5.51655629139073
2009,Mugla University,irra1a,1,1000,1000,0,1,
2009,Mugla University,irra1a,2,1000,1000,0,1,
2009,Mugla University,irra1a,3,1000,1000,0,1,
2009,Mugla University,irra1a,4,1000,1000,0,1,
2009,Mugla University,irra1a,5,1000,1000,0,1,
2009,Mugla University,irra1a,6,1000,1000,0,1,
2009,Mugla University,irra1a,7,1000,1000,0,1,
2009,Mugla University,irra1a,8,1000,1000,0,1,
2009,Mugla University,irra1a,9,1000,1000,0,1,
2009,Mugla University,irra1a,10,1000,1000,0,1,
2009,Mugla University,irra1a,11,1000,1000,0,1,
2009,Mugla University,irra1a,12,1000,1000,0,1,
2009,Mugla University,irra1a,13,1000,1000,0,1,
2009,Mugla University,irra1a,14,1000,1000,0,1,
2009,Mugla University,irra1a,15,1000,1000,0,1,
2009,Mugla University,irra1a,16,1000,1000,0,1,
2009,Mugla University,irra1a,17,1000,1000,0,1,
2009,Mugla University,irra1a,18,1000,1000,0,1,
2009,Mugla University,irra1a,19,1000,1000,0,1,
2009,Mugla University,irra1a,20,1000,1000,0,1,
2009,Mugla University,irra1a,21,1000,1000,0,1,
2009,Mugla University,irra1a,22,1000,1000,0,1,
2009,Mugla University,irra1a,23,1000,1000,0,1,
2009,Mugla University,irra1a,24,1000,1000,0,1,
2009,Mugla University,irra1a,25,1000,1000,0,1,
2009,Mugla University,irra1a,26,1000,1000,0,1,
2009,Mugla University,irra1a,27,1000,1000,0,1,
2009,Mugla University,irra1a,28,1000,1000,0,1,
2009,Mugla University,irra1a,29,1000,1000,0,1,
2009,Mugla University,irra1a,30,1000,1000,0,1,
2009,Mugla University,irra1a,31,1000,1000,0,1,
2009,Mugla University,irra1a,32,1000,1000,0,1,
2009,Mugla University,irra1a,33,1000,1000,0,1,
2009,Mugla University,irra1a,34,1000,1000,0,1,
2009,Mugla University,irra1a,35,1000,1000,0,1,
2009,Mugla University,irra1a,36,1000,1000,0,1,
2009,Mugla University,irra1a,37,1000,1000,0,1,
2009,Mugla University,irra1a,38,1000,1000,0,1,
2009,Mugla University,irra1a,39,1000,1000,0,1,
2009,Mugla University,irra1a,40,130,130,0,1,
2009,Mugla University,irra1a,41,1000,1000,0,1,
2009,Mugla University,irra1a,42,1000,1000,0,1,
2009,Mugla University,irra1a,43,1000,1000,0,1,
2009,Mugla University,irra1a,44,1000,1000,0,1,
2009,Mugla University,irra1a,45,1000,1000,0,1,
2009,Mugla University,irra1a,46,1000,1000,0,1,
2009,Mugla University,irra1a,47,1000,1000,0,1,
2009,Mugla University,irra1a,48,1000,1000,0,1,
2009,Mugla University,irra1a,49,1000,1000,0,1,
2009,Mugla University,irra1a,50,1000,1000,0,1,
2009,Mugla University,irra2a,1,1000,1000,0,1,
2009,Mugla University,irra2a,2,1000,1000,0,1,
2009,Mugla University,irra2a,3,1000,980,20,1.01010101010101,2
2009,Mugla University,irra2a,4,1000,992,8,1.00401606425703,2
2009,Mugla University,irra2a,5,1000,998,2,1.001001001001,2
2009,Mugla University,irra2a,6,1000,996,4,1.00200400801603,2
2009,Mugla University,irra2a,7,1000,998,2,1.001001001001,2
2009,Mugla University,irra2a,8,1000,994,6,1.00300902708124,2
2009,Mugla University,irra2a,9,1000,1000,0,1,
2009,Mugla University,irra2a,10,1000,1000,0,1,
2009,Mugla University,irra2a,11,1000,1000,0,1,
2009,Mugla University,irra2a,12,1000,994,6,1.00300902708124,2
2009,Mugla University,irra2a,13,1000,994,6,1.00300902708124,2
2009,Mugla University,irra2a,14,1000,992,8,1.00401606425703,2
2009,Mugla University,irra2a,15,1000,1000,0,1,
2009,Mugla University,irra2a,16,1000,1000,0,1,
2009,Mugla University,irra2a,17,1000,1000,0,1,
2009,Mugla University,irra2a,18,1000,1000,0,1,
2009,Mugla University,irra2a,19,1000,988,12,1.00603621730382,2
2009,Mugla University,irra2a,20,1000,988,12,1.00603621730382,2
2009,Mugla University,irra2a,21,1000,996,4,1.00200400801603,2
2009,Mugla University,irra2a,22,1000,998,2,1.001001001001,2
2009,Mugla University,irra2a,23,1000,996,4,1.00200400801603,2
2009,Mugla University,irra2a,24,1000,988,12,1.00603621730382,2
2009,Mugla University,irra2a,25,1000,992,8,1.00401606425703,2
2009,Mugla University,irra2a,26,1000,1000,0,1,
2009,Mugla University,irra2a,27,1000,990,10,1.00502512562814,2
2009,Mugla University,irra2a,28,1000,994,6,1.00300902708124,2
2009,Mugla University,irra2a,29,1000,1000,0,1,
2009,Mugla University,irra2a,30,1000,1000,0,1,
2009,Mugla University,irra2a,31,1000,992,8,1.00401606425703,2
2009,Mugla University,irra2a,32,1000,1000,0,1,
2009,Mugla University,irra2a,33,1000,1000,0,1,
2009,Mugla University,irra2a,34,1000,994,6,1.00300902708124,2
2009,Mugla University,irra2a,35,1000,990,10,1.00502512562814,2
2009,Mugla University,irra2a,36,1000,992,8,1.00401606425703,2
2009,Mugla University,irra2a,37,1000,998,2,1.001001001001,2
2009,Mugla University,irra2a,38,1000,1000,0,1,
2009,Mugla University,irra2a,39,1000,1000,0,1,
2009,Mugla University,irra2a,40,130,130,0,1,
2009,Mugla University,irra2a,41,1000,1000,0,1,
2009,Mugla University,irra2a,42,1000,994,6,1.00300902708124,2
2009,Mugla University,irra2a,43,1000,998,2,1.001001001001,2
2009,Mugla University,irra2a,44,1000,1000,0,1,
2009,Mugla University,irra2a,45,1000,998,2,1.001001001001,2
2009,Mugla University,irra2a,46,1000,1000,0,1,
2009,Mugla University,irra2a,47,1000,1000,0,1,
2009,Mugla University,irra2a,48,1000,1000,0,1,
2009,Mugla University,irra2a,49,1000,1000,0,1,
2009,Mugla University,irra2a,50,1000,1000,0,1,
2009,Mugla University,irra3a,1,1000,1000,0,1,
2009,Mugla University,irra3a,2,1000,1000,0,1,
2009,Mugla University,irra3a,3,1000,1000,0,1,
2009,Mugla University,irra3a,4,1000,1000,0,1,
2009,Mugla University,irra3a,5,1000,1000,0,1,
2009,Mugla University,irra3a,6,1000,1000,0,1,
2009,Mugla University,irra3a,7,1000,1000,0,1,
2009,Mugla University,irra3a,8,1000,1000,0,1,
2009,Mugla University,irra3a,9,1000,1000,0,1,
2009,Mugla University,irra3a,10,1000,1000,0,1,
2009,Mugla University,irra3a,11,1000,1000,0,1,
2009,Mugla University,irra3a,12,1000,1000,0,1,
2009,Mugla University,irra3a,13,1000,1000,0,1,
2009,Mugla University,irra3a,14,1000,1000,0,1,
2009,Mugla University,irra3a,15,1000,1000,0,1,
2009,Mugla University,irra3a,16,1000,1000,0,1,
2009,Mugla University,irra3a,17,1000,1000,0,1,
2009,Mugla University,irra3a,18,1000,1000,0,1,
2009,Mugla University,irra3a,19,1000,1000,0,1,
2009,Mugla University,irra3a,20,1000,1000,0,1,
2009,Mugla University,irra3a,21,1000,1000,0,1,
2009,Mugla University,irra3a,22,1000,1000,0,1,
2009,Mugla University,irra3a,23,1000,1000,0,1,
2009,Mugla University,irra3a,24,1000,1000,0,1,
2009,Mugla University,irra3a,25,1000,1000,0,1,
2009,Mugla University,irra3a,26,1000,1000,0,1,
2009,Mugla University,irra3a,27,1000,1000,0,1,
2009,Mugla University,irra3a,28,1000,1000,0,1,
2009,Mugla University,irra3a,29,1000,1000,0,1,
2009,Mugla University,irra3a,30,1000,1000,0,1,
2009,Mugla University,irra3a,31,1000,1000,0,1,
2009,Mugla University,irra3a,32,1000,1000,0,1,
2009,Mugla University,irra3a,33,1000,1000,0,1,
2009,Mugla University,irra3a,34,1000,1000,0,1,
2009,Mugla University,irra3a,35,1000,1000,0,1,
2009,Mugla University,irra3a,36,1000,1000,0,1,
2009,Mugla University,irra3a,37,1000,1000,0,1,
2009,Mugla University,irra3a,38,1000,1000,0,1,
2009,Mugla University,irra3a,39,1000,1000,0,1,
2009,Mugla University,irra3a,40,130,130,0,1,
2009,Mugla University,irra3a,41,1000,1000,0,1,
2009,Mugla University,irra3a,42,1000,1000,0,1,
2009,Mugla University,irra3a,43,1000,1000,0,1,
2009,Mugla University,irra3a,44,1000,1000,0,1,
2009,Mugla University,irra3a,45,1000,1000,0,1,
2009,Mugla University,irra3a,46,1000,1000,0,1,
2009,Mugla University,irra3a,47,1000,1000,0,1,
2009,Mugla University,irra3a,48,1000,1000,0,1,
2009,Mugla University,irra3a,49,1000,1000,0,1,
2009,Mugla University,irra3a,50,1000,1000,0,1,
2009,The University of Melbourne,muadanchor,1,1000,7,993,25.6410256410256,31.03125
2009,The University of Melbourne,muadanchor,2,1000,7,993,27.027027027027,33.1
2009,The University of Melbourne,muadanchor,3,1000,4,996,71.4285714285714,99.6
2009,The University of Melbourne,muadanchor,4,1000,0,1000,250,250
2009,The University of Melbourne,muadanchor,5,1000,8,992,58.8235294117647,110.222222222222
2009,The University of Melbourne,muadanchor,6,1000,0,1000,166.666666666667,166.666666666667
2009,The University of Melbourne,muadanchor,7,1000,11,989,22.2222222222222,29.0882352941177
2009,The University of Melbourne,muadanchor,8,1000,0,1000,200,200
2009,The University of Melbourne,muadanchor,9,1000,4,996,27.7777777777778,31.125
2009,The University of Melbourne,muadanchor,10,1000,4,996,29.4117647058824,33.2
2009,The University of Melbourne,muadanchor,11,1000,10,990,24.390243902439,31.9354838709677
2009,The University of Melbourne,muadanchor,12,1000,0,1000,333.333333333333,333.333333333333
2009,The University of Melbourne,muadanchor,13,1000,0,1000,500,500
2009,The University of Melbourne,muadanchor,14,1000,0,1000,333.333333333333,333.333333333333
2009,The University of Melbourne,muadanchor,15,1000,6,994,23.2558139534884,26.8648648648649
2009,The University of Melbourne,muadanchor,16,1000,11,989,18.1818181818182,22.4772727272727
2009,The University of Melbourne,muadanchor,17,1000,4,996,25.6410256410256,28.4571428571429
2009,The University of Melbourne,muadanchor,18,1000,12,988,23.2558139534884,31.8709677419355
2009,The University of Melbourne,muadanchor,19,1000,0,1000,1000,1000
2009,The University of Melbourne,muadanchor,20,1000,0,1000,166.666666666667,166.666666666667
2009,The University of Melbourne,muadanchor,21,1000,0,1000,166.666666666667,166.666666666667
2009,The University of Melbourne,muadanchor,22,1000,14,986,25.6410256410256,39.44
2009,The University of Melbourne,muadanchor,23,1000,0,1000,500,500
2009,The University of Melbourne,muadanchor,24,1000,0,1000,333.333333333333,333.333333333333
2009,The University of Melbourne,muadanchor,25,963,0,963,120.375,120.375
2009,The University of Melbourne,muadanchor,26,1000,6,994,26.3157894736842,31.0625
2009,The University of Melbourne,muadanchor,27,1000,0,1000,166.666666666667,166.666666666667
2009,The University of Melbourne,muadanchor,28,1000,0,1000,166.666666666667,166.666666666667
2009,The University of Melbourne,muadanchor,29,1000,5,995,22.2222222222222,24.875
2009,The University of Melbourne,muadanchor,30,1000,6,994,37.037037037037,47.3333333333333
2009,The University of Melbourne,muadanchor,31,1000,0,1000,166.666666666667,166.666666666667
2009,The University of Melbourne,muadanchor,32,1000,3,997,24.390243902439,26.2368421052632
2009,The University of Melbourne,muadanchor,33,1000,5,995,28.5714285714286,33.1666666666667
2009,The University of Melbourne,muadanchor,34,1000,2,998,71.4285714285714,83.1666666666667
2009,The University of Melbourne,muadanchor,35,759,0,759,108.428571428571,108.428571428571
2009,The University of Melbourne,muadanchor,36,1000,0,1000,500,500
2009,The University of Melbourne,muadanchor,37,1000,1,999,66.6666666666667,71.3571428571429
2009,The University of Melbourne,muadanchor,38,1000,7,993,35.7142857142857,47.2857142857143
2009,The University of Melbourne,muadanchor,39,1000,8,992,25,31
2009,The University of Melbourne,muadanchor,40,9,2,7,2.25,3.5
2009,The University of Melbourne,muadanchor,41,1000,9,991,23.2558139534884,29.1470588235294
2009,The University of Melbourne,muadanchor,42,1000,12,988,22.2222222222222,29.9393939393939
2009,The University of Melbourne,muadanchor,43,1000,3,997,32.258064516129,35.6071428571429
2009,The University of Melbourne,muadanchor,44,1000,8,992,19.6078431372549,23.0697674418605
2009,The University of Melbourne,muadanchor,45,1000,5,995,29.4117647058824,34.3103448275862
2009,The University of Melbourne,muadanchor,46,1000,9,991,50,90.0909090909091
2009,The University of Melbourne,muadanchor,47,1000,8,992,34.4827586206897,47.2380952380952
2009,The University of Melbourne,muadanchor,48,1000,10,990,58.8235294117647,141.428571428571
2009,The University of Melbourne,muadanchor,49,1000,0,1000,111.111111111111,111.111111111111
2009,The University of Melbourne,muadanchor,50,1000,9,991,55.5555555555556,110.111111111111
2009,The University of Melbourne,muadibm5,1,1000,61,939,5.4945054945055,7.7603305785124
2009,The University of Melbourne,muadibm5,2,1000,248,752,2.44498777506113,4.67080745341615
2009,The University of Melbourne,muadibm5,3,1000,0,1000,500,500
2009,The University of Melbourne,muadibm5,4,1000,0,1000,1000,1000
2009,The University of Melbourne,muadibm5,5,1000,2,998,40,43.3913043478261
2009,The University of Melbourne,muadibm5,6,1000,0,1000,1000,1000
2009,The University of Melbourne,muadibm5,7,1000,10,990,19.2307692307692,23.5714285714286
2009,The University of Melbourne,muadibm5,8,1000,0,1000,1000,1000
2009,The University of Melbourne,muadibm5,9,1000,0,1000,333.333333333333,333.333333333333
2009,The University of Melbourne,muadibm5,10,1000,0,1000,125,125
2009,The University of Melbourne,muadibm5,11,1000,29,971,10.8695652173913,15.4126984126984
2009,The University of Melbourne,muadibm5,12,1000,0,1000,1000,1000
2009,The University of Melbourne,muadibm5,13,1000,0,1000,1000,1000
2009,The University of Melbourne,muadibm5,14,1000,0,1000,1000,1000
2009,The University of Melbourne,muadibm5,15,1000,0,1000,500,500
2009,The University of Melbourne,muadibm5,16,1000,17,983,11.7647058823529,14.4558823529412
2009,The University of Melbourne,muadibm5,17,1000,0,1000,250,250
2009,The University of Melbourne,muadibm5,18,1000,49,951,7.14285714285714,10.4505494505495
2009,The University of Melbourne,muadibm5,19,1000,1,999,500,999
2009,The University of Melbourne,muadibm5,20,1000,0,1000,1000,1000
2009,The University of Melbourne,muadibm5,21,1000,0,1000,1000,1000
2009,The University of Melbourne,muadibm5,22,1000,0,1000,250,250
2009,The University of Melbourne,muadibm5,23,1000,0,1000,1000,1000
2009,The University of Melbourne,muadibm5,24,1000,0,1000,1000,1000
2009,The University of Melbourne,muadibm5,25,1000,0,1000,1000,1000
2009,The University of Melbourne,muadibm5,26,1000,8,992,21.2765957446809,25.4358974358974
2009,The University of Melbourne,muadibm5,27,1000,0,1000,1000,1000
2009,The University of Melbourne,muadibm5,28,1000,0,1000,1000,1000
2009,The University of Melbourne,muadibm5,29,1000,0,1000,50,50
2009,The University of Melbourne,muadibm5,30,1000,0,1000,250,250
2009,The University of Melbourne,muadibm5,31,1000,0,1000,1000,1000
2009,The University of Melbourne,muadibm5,32,1000,3,997,38.4615384615385,43.3478260869565
2009,The University of Melbourne,muadibm5,33,1000,0,1000,166.666666666667,166.666666666667
2009,The University of Melbourne,muadibm5,34,1000,0,1000,333.333333333333,333.333333333333
2009,The University of Melbourne,muadibm5,35,1000,0,1000,1000,1000
2009,The University of Melbourne,muadibm5,36,1000,0,1000,1000,1000
2009,The University of Melbourne,muadibm5,37,1000,0,1000,76.9230769230769,76.9230769230769
2009,The University of Melbourne,muadibm5,38,1000,3,997,90.9090909090909,124.625
2009,The University of Melbourne,muadibm5,39,1000,0,1000,333.333333333333,333.333333333333
2009,The University of Melbourne,muadibm5,40,1000,0,1000,142.857142857143,142.857142857143
2009,The University of Melbourne,muadibm5,41,1000,229,771,2.37529691211401,4.015625
2009,The University of Melbourne,muadibm5,42,1000,0,1000,111.111111111111,111.111111111111
2009,The University of Melbourne,muadibm5,43,1000,0,1000,125,125
2009,The University of Melbourne,muadibm5,44,1000,7,993,40,55.1666666666667
2009,The University of Melbourne,muadibm5,45,1000,0,1000,250,250
2009,The University of Melbourne,muadibm5,46,1000,40,960,8.40336134453782,12.1518987341772
2009,The University of Melbourne,muadibm5,47,1000,0,1000,111.111111111111,111.111111111111
2009,The University of Melbourne,muadibm5,48,1000,0,1000,83.3333333333333,83.3333333333333
2009,The University of Melbourne,muadibm5,49,1000,0,1000,125,125
2009,The University of Melbourne,muadibm5,50,1000,0,1000,250,250
2009,The University of Melbourne,muadimp,1,1000,3,997,31.25,34.3793103448276
2009,The University of Melbourne,muadimp,2,1000,6,994,15.3846153846154,16.8474576271186
2009,The University of Melbourne,muadimp,3,1000,0,1000,500,500
2009,The University of Melbourne,muadimp,4,1000,0,1000,1000,1000
2009,The University of Melbourne,muadimp,5,1000,1,999,62.5,66.6
2009,The University of Melbourne,muadimp,6,1000,0,1000,1000,1000
2009,The University of Melbourne,muadimp,7,1000,1,999,66.6666666666667,71.3571428571429
2009,The University of Melbourne,muadimp,8,1000,0,1000,1000,1000
2009,The University of Melbourne,muadimp,9,1000,0,1000,333.333333333333,333.333333333333
2009,The University of Melbourne,muadimp,10,1000,0,1000,166.666666666667,166.666666666667
2009,The University of Melbourne,muadimp,11,1000,5,995,35.7142857142857,43.2608695652174
2009,The University of Melbourne,muadimp,12,1000,0,1000,1000,1000
2009,The University of Melbourne,muadimp,13,1000,0,1000,1000,1000
2009,The University of Melbourne,muadimp,14,1000,0,1000,1000,1000
2009,The University of Melbourne,muadimp,15,1000,0,1000,500,500
2009,The University of Melbourne,muadimp,16,1000,2,998,41.6666666666667,45.3636363636364
2009,The University of Melbourne,muadimp,17,1000,0,1000,333.333333333333,333.333333333333
2009,The University of Melbourne,muadimp,18,1000,5,995,22.2222222222222,24.875
2009,The University of Melbourne,muadimp,19,1000,0,1000,1000,1000
2009,The University of Melbourne,muadimp,20,1000,0,1000,1000,1000
2009,The University of Melbourne,muadimp,21,1000,0,1000,1000,1000
2009,The University of Melbourne,muadimp,22,1000,0,1000,250,250
2009,The University of Melbourne,muadimp,23,1000,0,1000,1000,1000
2009,The University of Melbourne,muadimp,24,1000,0,1000,1000,1000
2009,The University of Melbourne,muadimp,25,1000,0,1000,1000,1000
2009,The University of Melbourne,muadimp,26,1000,3,997,38.4615384615385,43.3478260869565
2009,The University of Melbourne,muadimp,27,1000,0,1000,1000,1000
2009,The University of Melbourne,muadimp,28,1000,0,1000,1000,1000
2009,The University of Melbourne,muadimp,29,1000,0,1000,111.111111111111,111.111111111111
2009,The University of Melbourne,muadimp,30,1000,0,1000,333.333333333333,333.333333333333
2009,The University of Melbourne,muadimp,31,1000,0,1000,1000,1000
2009,The University of Melbourne,muadimp,32,1000,2,998,83.3333333333333,99.8
2009,The University of Melbourne,muadimp,33,1000,0,1000,200,200
2009,The University of Melbourne,muadimp,34,1000,0,1000,333.333333333333,333.333333333333
2009,The University of Melbourne,muadimp,35,1000,0,1000,1000,1000
2009,The University of Melbourne,muadimp,36,1000,0,1000,1000,1000
2009,The University of Melbourne,muadimp,37,1000,0,1000,111.111111111111,111.111111111111
2009,The University of Melbourne,muadimp,38,1000,2,998,125,166.333333333333
2009,The University of Melbourne,muadimp,39,1000,0,1000,333.333333333333,333.333333333333
2009,The University of Melbourne,muadimp,40,1000,0,1000,142.857142857143,142.857142857143
2009,The University of Melbourne,muadimp,41,1000,8,992,20.4081632653061,24.1951219512195
2009,The University of Melbourne,muadimp,42,1000,0,1000,142.857142857143,142.857142857143
2009,The University of Melbourne,muadimp,43,1000,0,1000,166.666666666667,166.666666666667
2009,The University of Melbourne,muadimp,44,1000,3,997,76.9230769230769,99.7
2009,The University of Melbourne,muadimp,45,1000,0,1000,333.333333333333,333.333333333333
2009,The University of Melbourne,muadimp,46,1000,2,998,28.5714285714286,30.2424242424242
2009,The University of Melbourne,muadimp,47,1000,0,1000,125,125
2009,The University of Melbourne,muadimp,48,1000,0,1000,111.111111111111,111.111111111111
2009,The University of Melbourne,muadimp,49,1000,0,1000,125,125
2009,The University of Melbourne,muadimp,50,1000,0,1000,250,250
2009,Peking University,pkuLink,1,1000,905,95,1.06723585912487,2.96875
2009,Peking University,pkuLink,2,1000,958,42,1.02459016393443,2.33333333333333
2009,Peking University,pkuLink,3,1000,816,184,1.10619469026549,2.09090909090909
2009,Peking University,pkuLink,4,1000,736,264,1.20048019207683,2.72164948453608
2009,Peking University,pkuLink,5,1000,890,110,1.05932203389831,2.03703703703704
2009,Peking University,pkuLink,6,1000,912,88,1.04931794333683,2.14634146341463
2009,Peking University,pkuLink,7,1000,853,147,1.08342361863489,2.1
2009,Peking University,pkuLink,8,1000,562,438,1.31752305665349,2.22335025380711
2009,Peking University,pkuLink,9,1000,679,321,1.21359223300971,2.21379310344828
2009,Peking University,pkuLink,10,1000,890,110,1.05932203389831,2.03703703703704
2009,Peking University,pkuLink,11,1000,849,151,1.11111111111111,2.96078431372549
2009,Peking University,pkuLink,12,1000,766,234,1.14155251141553,2.12727272727273
2009,Peking University,pkuLink,13,1000,857,143,1.07991360691145,2.07246376811594
2009,Peking University,pkuLink,14,1000,818,182,1.10253583241455,2.04494382022472
2009,Peking University,pkuLink,15,1000,917,83,1.05042016806723,2.37142857142857
2009,Peking University,pkuLink,16,1000,942,58,1.03199174406605,2.14814814814815
2009,Peking University,pkuLink,17,1000,837,163,1.09051254089422,2.0375
2009,Peking University,pkuLink,18,1000,945,55,1.03092783505155,2.2
2009,Peking University,pkuLink,19,1000,799,201,1.15740740740741,3.09230769230769
2009,Peking University,pkuLink,20,1000,694,306,1.20048019207683,2.20143884892086
2009,Peking University,pkuLink,21,1000,737,263,1.16279069767442,2.13821138211382
2009,Peking University,pkuLink,22,1000,918,82,1.04384133611691,2.05
2009,Peking University,pkuLink,23,1000,462,538,1.48148148148148,2.52582159624413
2009,Peking University,pkuLink,24,1000,628,372,1.26103404791929,2.25454545454545
2009,Peking University,pkuLink,25,1000,859,141,1.09051254089422,2.43103448275862
2009,Peking University,pkuLink,26,1000,900,100,1.05708245243129,2.17391304347826
2009,Peking University,pkuLink,27,1000,811,189,1.10987791342952,2.1
2009,Peking University,pkuLink,28,1000,861,139,1.07758620689655,2.07462686567164
2009,Peking University,pkuLink,29,1000,750,250,1.14810562571757,2.06611570247934
2009,Peking University,pkuLink,30,1000,874,126,1.06951871657754,2.0655737704918
2009,Peking University,pkuLink,31,1000,827,173,1.11234705228031,2.40277777777778
2009,Peking University,pkuLink,32,1000,799,201,1.11856823266219,2.11578947368421
2009,Peking University,pkuLink,33,1000,918,82,1.04384133611691,2.05
2009,Peking University,pkuLink,34,1000,615,385,1.27226463104326,2.25146198830409
2009,Peking University,pkuLink,35,1000,904,96,1.05485232067511,2.18181818181818
2009,Peking University,pkuLink,36,1000,628,372,1.25944584382872,2.24096385542169
2009,Peking University,pkuLink,37,1000,945,55,1.02880658436214,2.03703703703704
2009,Peking University,pkuLink,38,1000,886,114,1.06609808102345,2.19230769230769
2009,Peking University,pkuLink,39,1000,904,96,1.05263157894737,2.08695652173913
2009,Peking University,pkuLink,40,1000,878,122,1.09289617486339,3.2972972972973
2009,Peking University,pkuLink,41,1000,964,36,1.0183299389002,2
2009,Peking University,pkuLink,42,1000,852,148,1.09769484083425,2.50847457627119
2009,Peking University,pkuLink,43,1000,889,111,1.06609808102345,2.26530612244898
2009,Peking University,pkuLink,44,1000,800,200,1.16144018583043,3.27868852459016
2009,Peking University,pkuLink,45,1000,855,145,1.07874865156419,2.01388888888889
2009,Peking University,pkuLink,46,1000,973,27,1.0183299389002,3
2009,Peking University,pkuLink,47,1000,926,74,1.04384133611691,2.3125
2009,Peking University,pkuLink,48,1000,933,67,1.03626943005181,2.09375
2009,Peking University,pkuLink,49,1000,880,120,1.06837606837607,2.14285714285714
2009,Peking University,pkuLink,50,1000,935,65,1.0351966873706,2.09677419354839
2009,Peking University,pkuSewmTp,1,1000,912,88,1.04602510460251,2
2009,Peking University,pkuSewmTp,2,1000,947,53,1.03199174406605,2.40909090909091
2009,Peking University,pkuSewmTp,3,1000,604,396,1.29533678756477,2.35714285714286
2009,Peking University,pkuSewmTp,4,1000,424,576,1.57728706624606,2.74285714285714
2009,Peking University,pkuSewmTp,5,1000,868,132,1.07296137339056,2.0625
2009,Peking University,pkuSewmTp,6,1000,878,122,1.07066381156317,2.17857142857143
2009,Peking University,pkuSewmTp,7,1000,729,271,1.17785630153121,2.25833333333333
2009,Peking University,pkuSewmTp,8,1000,266,734,1.91204588910134,2.85603112840467
2009,Peking University,pkuSewmTp,9,1000,290,710,1.88323917137476,2.94605809128631
2009,Peking University,pkuSewmTp,10,1000,698,302,1.20481927710843,2.28787878787879
2009,Peking University,pkuSewmTp,11,1000,879,121,1.07991360691145,2.57446808510638
2009,Peking University,pkuSewmTp,12,1000,165,835,2.82485875706215,4.41798941798942
2009,Peking University,pkuSewmTp,13,1000,236,764,2.16450216450216,3.38053097345133
2009,Peking University,pkuSewmTp,14,1000,471,529,1.45560407569141,2.44907407407407
2009,Peking University,pkuSewmTp,15,1000,827,173,1.10497237569061,2.21794871794872
2009,Peking University,pkuSewmTp,16,1000,894,106,1.05820105820106,2.07843137254902
2009,Peking University,pkuSewmTp,17,1000,725,275,1.17370892018779,2.16535433070866
2009,Peking University,pkuSewmTp,18,1000,913,87,1.05042016806723,2.23076923076923
2009,Peking University,pkuSewmTp,19,1000,644,356,1.25470514429109,2.32679738562092
2009,Peking University,pkuSewmTp,20,1000,856,144,1.08342361863489,2.14925373134328
2009,Peking University,pkuSewmTp,21,1000,323,677,1.75131348511384,2.72983870967742
2009,Peking University,pkuSewmTp,22,1000,871,129,1.07066381156317,2.04761904761905
2009,Peking University,pkuSewmTp,23,1000,665,335,1.23762376237624,2.34265734265734
2009,Peking University,pkuSewmTp,24,1000,778,222,1.16279069767442,2.70731707317073
2009,Peking University,pkuSewmTp,25,1000,778,222,1.14025085518814,2.24242424242424
2009,Peking University,pkuSewmTp,26,1000,881,119,1.06723585912487,2.125
2009,Peking University,pkuSewmTp,27,1000,561,439,1.33155792276964,2.31052631578947
2009,Peking University,pkuSewmTp,28,1000,544,456,1.36798905608755,2.43850267379679
2009,Peking University,pkuSewmTp,29,1000,553,447,1.34770889487871,2.36507936507937
2009,Peking University,pkuSewmTp,30,1000,731,269,1.16414435389988,2.1015625
2009,Peking University,pkuSewmTp,31,1000,561,439,1.32275132275132,2.25128205128205
2009,Peking University,pkuSewmTp,32,1000,589,411,1.30718954248366,2.33522727272727
2009,Peking University,pkuSewmTp,33,1000,840,160,1.09289617486339,2.13333333333333
2009,Peking University,pkuSewmTp,34,1000,262,738,1.85528756957328,2.66425992779783
2009,Peking University,pkuSewmTp,35,1000,710,290,1.18906064209275,2.21374045801527
2009,Peking University,pkuSewmTp,36,1000,744,256,1.16279069767442,2.20689655172414
2009,Peking University,pkuSewmTp,37,1000,865,135,1.0752688172043,2.07692307692308
2009,Peking University,pkuSewmTp,38,1000,599,401,1.29533678756477,2.31791907514451
2009,Peking University,pkuSewmTp,39,1000,787,213,1.12359550561798,2.06796116504854
2009,Peking University,pkuSewmTp,40,1000,777,223,1.16009280742459,2.62352941176471
2009,Peking University,pkuSewmTp,41,1000,878,122,1.07874865156419,2.48979591836735
2009,Peking University,pkuSewmTp,42,1000,228,772,2.24719101123596,3.55760368663595
2009,Peking University,pkuSewmTp,43,1000,832,168,1.10497237569061,2.3013698630137
2009,Peking University,pkuSewmTp,44,1000,795,205,1.14285714285714,2.5625
2009,Peking University,pkuSewmTp,45,1000,641,359,1.24843945068664,2.24375
2009,Peking University,pkuSewmTp,46,1000,935,65,1.03842159916926,2.32142857142857
2009,Peking University,pkuSewmTp,47,1000,887,113,1.06496272630458,2.17307692307692
2009,Peking University,pkuSewmTp,48,1000,880,120,1.06951871657754,2.18181818181818
2009,Peking University,pkuSewmTp,49,1000,848,152,1.08932461873638,2.17142857142857
2009,Peking University,pkuSewmTp,50,1000,871,129,1.07874865156419,2.30357142857143
2009,Peking University,pkuStruct,1,1000,926,74,1.03950103950104,2.05555555555556
2009,Peking University,pkuStruct,2,1000,945,55,1.03305785123967,2.39130434782609
2009,Peking University,pkuStruct,3,1000,564,436,1.33689839572193,2.3695652173913
2009,Peking University,pkuStruct,4,1000,453,547,1.51975683890578,2.66829268292683
2009,Peking University,pkuStruct,5,1000,852,148,1.08108108108108,2.02739726027397
2009,Peking University,pkuStruct,6,1000,877,123,1.07066381156317,2.15789473684211
2009,Peking University,pkuStruct,7,1000,737,263,1.16144018583043,2.12096774193548
2009,Peking University,pkuStruct,8,1000,306,694,1.82149362477231,2.8559670781893
2009,Peking University,pkuStruct,9,1000,231,769,2.12765957446809,3.21757322175732
2009,Peking University,pkuStruct,10,1000,711,289,1.18623962040332,2.18939393939394
2009,Peking University,pkuStruct,11,1000,883,117,1.07758620689655,2.6
2009,Peking University,pkuStruct,12,1000,180,820,2.68096514745308,4.24870466321244
2009,Peking University,pkuStruct,13,1000,240,760,2.14132762312634,3.34801762114537
2009,Peking University,pkuStruct,14,1000,492,508,1.42045454545455,2.39622641509434
2009,Peking University,pkuStruct,15,1000,839,161,1.09649122807018,2.20547945205479
2009,Peking University,pkuStruct,16,1000,884,116,1.06382978723404,2.07142857142857
2009,Peking University,pkuStruct,17,1000,728,272,1.16550116550117,2.09230769230769
2009,Peking University,pkuStruct,18,1000,909,91,1.0515247108307,2.16666666666667
2009,Peking University,pkuStruct,19,1000,626,374,1.27388535031847,2.35220125786164
2009,Peking University,pkuStruct,20,1000,854,146,1.085776330076,2.17910447761194
2009,Peking University,pkuStruct,21,1000,336,664,1.69491525423729,2.61417322834646
2009,Peking University,pkuStruct,22,1000,886,114,1.06269925611052,2.07272727272727
2009,Peking University,pkuStruct,23,1000,712,288,1.20336943441637,2.42016806722689
2009,Peking University,pkuStruct,24,1000,797,203,1.14942528735632,2.78082191780822
2009,Peking University,pkuStruct,25,1000,789,211,1.13122171945701,2.22105263157895
2009,Peking University,pkuStruct,26,1000,879,121,1.06609808102345,2.05084745762712
2009,Peking University,pkuStruct,27,1000,601,399,1.2970168612192,2.34705882352941
2009,Peking University,pkuStruct,28,1000,574,426,1.32802124833997,2.37988826815642
2009,Peking University,pkuStruct,29,1000,589,411,1.29366106080207,2.23369565217391
2009,Peking University,pkuStruct,30,1000,762,238,1.14285714285714,2.10619469026549
2009,Peking University,pkuStruct,31,1000,581,419,1.30378096479791,2.25268817204301
2009,Peking University,pkuStruct,32,1000,608,392,1.29198966408269,2.36144578313253
2009,Peking University,pkuStruct,33,1000,837,163,1.09409190371991,2.11688311688312
2009,Peking University,pkuStruct,34,1000,277,723,1.8018018018018,2.60071942446043
2009,Peking University,pkuStruct,35,1000,739,261,1.17096018735363,2.2695652173913
2009,Peking University,pkuStruct,36,1000,203,797,2.15982721382289,3.06538461538462
2009,Peking University,pkuStruct,37,1000,885,115,1.06269925611052,2.05357142857143
2009,Peking University,pkuStruct,38,1000,583,417,1.31752305665349,2.36931818181818
2009,Peking University,pkuStruct,39,1000,792,208,1.12359550561798,2.12244897959184
2009,Peking University,pkuStruct,40,1000,779,221,1.15874855156431,2.63095238095238
2009,Peking University,pkuStruct,41,1000,868,132,1.08342361863489,2.4
2009,Peking University,pkuStruct,42,1000,182,818,2.5974025974026,4.02955665024631
2009,Peking University,pkuStruct,43,1000,852,148,1.09170305676856,2.3125
2009,Peking University,pkuStruct,44,1000,759,241,1.16959064327485,2.51041666666667
2009,Peking University,pkuStruct,45,1000,649,351,1.22850122850123,2.12727272727273
2009,Peking University,pkuStruct,46,1000,930,70,1.04166666666667,2.33333333333333
2009,Peking University,pkuStruct,47,1000,904,96,1.05485232067511,2.18181818181818
2009,Peking University,pkuStruct,48,1000,882,118,1.06723585912487,2.14545454545455
2009,Peking University,pkuStruct,49,1000,825,175,1.10253583241455,2.13414634146341
2009,Peking University,pkuStruct,50,1000,872,128,1.07758620689655,2.28571428571429
2009,South China Unviersity of Tehcnology,scutrun1,1,1000,836,164,1.12612612612613,3.15384615384615
2009,South China Unviersity of Tehcnology,scutrun1,2,1000,843,157,1.1454753722795,5.23333333333333
2009,South China Unviersity of Tehcnology,scutrun1,3,1000,847,153,1.12485939257593,3.64285714285714
2009,South China Unviersity of Tehcnology,scutrun1,4,1000,820,180,1.14025085518814,3.15789473684211
2009,South China Unviersity of Tehcnology,scutrun1,5,1000,831,169,1.11111111111111,2.44927536231884
2009,South China Unviersity of Tehcnology,scutrun1,6,1000,506,494,1.76991150442478,8.3728813559322
2009,South China Unviersity of Tehcnology,scutrun1,7,1000,979,21,1.01317122593718,2.625
2009,South China Unviersity of Tehcnology,scutrun1,8,1000,856,144,1.11358574610245,3.42857142857143
2009,South China Unviersity of Tehcnology,scutrun1,9,1000,927,73,1.04602510460251,2.51724137931035
2009,South China Unviersity of Tehcnology,scutrun1,10,1000,617,383,1.50829562594268,8.32608695652174
2009,South China Unviersity of Tehcnology,scutrun1,11,1000,941,59,1.03412616339193,2.26923076923077
2009,South China Unviersity of Tehcnology,scutrun1,12,1000,432,568,2.04081632653061,9.79310344827586
2009,South China Unviersity of Tehcnology,scutrun1,13,1000,828,172,1.14025085518814,3.51020408163265
2009,South China Unviersity of Tehcnology,scutrun1,14,1000,898,102,1.06951871657754,2.75675675675676
2009,South China Unviersity of Tehcnology,scutrun1,15,1000,799,201,1.13507377979569,2.45121951219512
2009,South China Unviersity of Tehcnology,scutrun1,16,1000,856,144,1.08932461873638,2.32258064516129
2009,South China Unviersity of Tehcnology,scutrun1,17,1000,937,63,1.05042016806723,4.2
2009,South China Unviersity of Tehcnology,scutrun1,18,1000,901,99,1.07296137339056,3.19354838709677
2009,South China Unviersity of Tehcnology,scutrun1,19,1000,762,238,1.19047619047619,3.05128205128205
2009,South China Unviersity of Tehcnology,scutrun1,20,1000,795,205,1.17508813160987,3.66071428571429
2009,South China Unviersity of Tehcnology,scutrun1,21,1000,908,92,1.05820105820106,2.48648648648649
2009,South China Unviersity of Tehcnology,scutrun1,22,1000,909,91,1.06496272630458,3.03333333333333
2009,South China Unviersity of Tehcnology,scutrun1,23,1000,626,374,1.42045454545455,4.7948717948718
2009,South China Unviersity of Tehcnology,scutrun1,24,1000,894,106,1.06837606837607,2.52380952380952
2009,South China Unviersity of Tehcnology,scutrun1,25,1000,680,320,1.30208333333333,3.63636363636364
2009,South China Unviersity of Tehcnology,scutrun1,26,1000,885,115,1.0752688172043,2.55555555555556
2009,South China Unviersity of Tehcnology,scutrun1,27,1000,906,94,1.06044538706257,2.54054054054054
2009,South China Unviersity of Tehcnology,scutrun1,28,1000,672,328,1.35869565217391,5.125
2009,South China Unviersity of Tehcnology,scutrun1,29,1000,908,92,1.06044538706257,2.62857142857143
2009,South China Unviersity of Tehcnology,scutrun1,30,1000,968,32,1.01626016260163,2
2009,South China Unviersity of Tehcnology,scutrun1,31,1000,757,243,1.19331742243437,3
2009,South China Unviersity of Tehcnology,scutrun1,32,1000,941,59,1.03626943005181,2.45833333333333
2009,South China Unviersity of Tehcnology,scutrun1,33,1000,925,75,1.0482180293501,2.58620689655172
2009,South China Unviersity of Tehcnology,scutrun1,34,1000,946,54,1.0351966873706,2.7
2009,South China Unviersity of Tehcnology,scutrun1,35,1000,673,327,1.30039011703511,3.40625
2009,South China Unviersity of Tehcnology,scutrun1,36,1000,947,53,1.0351966873706,2.78947368421053
2009,South China Unviersity of Tehcnology,scutrun1,37,1000,655,345,1.39082058414465,5.390625
2009,South China Unviersity of Tehcnology,scutrun1,38,1000,929,71,1.0482180293501,2.84
2009,South China Unviersity of Tehcnology,scutrun1,39,1000,916,84,1.05596620908131,2.70967741935484
2009,South China Unviersity of Tehcnology,scutrun1,40,130,74,56,1.56626506024096,6.22222222222222
2009,South China Unviersity of Tehcnology,scutrun1,41,1000,907,93,1.06609808102345,3
2009,South China Unviersity of Tehcnology,scutrun1,42,1000,908,92,1.05932203389831,2.55555555555556
2009,South China Unviersity of Tehcnology,scutrun1,43,1000,841,159,1.11482720178372,2.83928571428571
2009,South China Unviersity of Tehcnology,scutrun1,44,1000,726,274,1.29198966408269,5.70833333333333
2009,South China Unviersity of Tehcnology,scutrun1,45,1000,891,109,1.09170305676856,4.36
2009,South China Unviersity of Tehcnology,scutrun1,46,1000,758,242,1.21212121212121,3.61194029850746
2009,South China Unviersity of Tehcnology,scutrun1,47,1000,875,125,1.08813928182807,2.84090909090909
2009,South China Unviersity of Tehcnology,scutrun1,48,1000,868,132,1.10987791342952,4
2009,South China Unviersity of Tehcnology,scutrun1,49,1000,814,186,1.14678899082569,3.20689655172414
2009,South China Unviersity of Tehcnology,scutrun1,50,1000,952,48,1.02669404517454,2.18181818181818
2009,South China Unviersity of Tehcnology,scutrun2,1,1000,836,164,1.12612612612613,3.15384615384615
2009,South China Unviersity of Tehcnology,scutrun2,2,1000,841,159,1.14678899082569,5.12903225806452
2009,South China Unviersity of Tehcnology,scutrun2,3,1000,847,153,1.12485939257593,3.64285714285714
2009,South China Unviersity of Tehcnology,scutrun2,4,1000,818,182,1.14155251141553,3.13793103448276
2009,South China Unviersity of Tehcnology,scutrun2,5,1000,831,169,1.11111111111111,2.44927536231884
2009,South China Unviersity of Tehcnology,scutrun2,6,1000,506,494,1.76991150442478,8.3728813559322
2009,South China Unviersity of Tehcnology,scutrun2,7,1000,979,21,1.01317122593718,2.625
2009,South China Unviersity of Tehcnology,scutrun2,8,1000,855,145,1.11482720178372,3.45238095238095
2009,South China Unviersity of Tehcnology,scutrun2,9,1000,927,73,1.04712041884817,2.60714285714286
2009,South China Unviersity of Tehcnology,scutrun2,10,1000,617,383,1.50829562594268,8.32608695652174
2009,South China Unviersity of Tehcnology,scutrun2,11,1000,941,59,1.03412616339193,2.26923076923077
2009,South China Unviersity of Tehcnology,scutrun2,12,1000,432,568,2.04081632653061,9.79310344827586
2009,South China Unviersity of Tehcnology,scutrun2,13,1000,830,170,1.13895216400911,3.54166666666667
2009,South China Unviersity of Tehcnology,scutrun2,14,1000,898,102,1.06951871657754,2.75675675675676
2009,South China Unviersity of Tehcnology,scutrun2,15,1000,801,199,1.13378684807256,2.45679012345679
2009,South China Unviersity of Tehcnology,scutrun2,16,1000,858,142,1.08813928182807,2.32786885245902
2009,South China Unviersity of Tehcnology,scutrun2,17,1000,935,65,1.0515247108307,4.0625
2009,South China Unviersity of Tehcnology,scutrun2,18,1000,901,99,1.07296137339056,3.19354838709677
2009,South China Unviersity of Tehcnology,scutrun2,19,1000,761,239,1.19047619047619,3.0253164556962
2009,South China Unviersity of Tehcnology,scutrun2,20,1000,795,205,1.17508813160987,3.66071428571429
2009,South China Unviersity of Tehcnology,scutrun2,21,1000,907,93,1.05932203389831,2.51351351351351
2009,South China Unviersity of Tehcnology,scutrun2,22,1000,909,91,1.06496272630458,3.03333333333333
2009,South China Unviersity of Tehcnology,scutrun2,23,1000,624,376,1.42247510668563,4.75949367088608
2009,South China Unviersity of Tehcnology,scutrun2,24,1000,894,106,1.06837606837607,2.52380952380952
2009,South China Unviersity of Tehcnology,scutrun2,25,1000,678,322,1.30378096479791,3.61797752808989
2009,South China Unviersity of Tehcnology,scutrun2,26,1000,885,115,1.0752688172043,2.55555555555556
2009,South China Unviersity of Tehcnology,scutrun2,27,1000,906,94,1.06044538706257,2.54054054054054
2009,South China Unviersity of Tehcnology,scutrun2,28,1000,672,328,1.35869565217391,5.125
2009,South China Unviersity of Tehcnology,scutrun2,29,1000,908,92,1.06044538706257,2.62857142857143
2009,South China Unviersity of Tehcnology,scutrun2,30,1000,968,32,1.01626016260163,2
2009,South China Unviersity of Tehcnology,scutrun2,31,1000,757,243,1.19331742243437,3
2009,South China Unviersity of Tehcnology,scutrun2,32,1000,939,61,1.03734439834025,2.44
2009,South China Unviersity of Tehcnology,scutrun2,33,1000,927,73,1.04712041884817,2.60714285714286
2009,South China Unviersity of Tehcnology,scutrun2,34,1000,946,54,1.0351966873706,2.7
2009,South China Unviersity of Tehcnology,scutrun2,35,1000,674,326,1.30039011703511,3.43157894736842
2009,South China Unviersity of Tehcnology,scutrun2,36,1000,945,55,1.03626943005181,2.75
2009,South China Unviersity of Tehcnology,scutrun2,37,1000,655,345,1.39082058414465,5.390625
2009,South China Unviersity of Tehcnology,scutrun2,38,1000,931,69,1.04712041884817,2.875
2009,South China Unviersity of Tehcnology,scutrun2,39,1000,916,84,1.05596620908131,2.70967741935484
2009,South China Unviersity of Tehcnology,scutrun2,40,130,74,56,1.56626506024096,6.22222222222222
2009,South China Unviersity of Tehcnology,scutrun2,41,1000,907,93,1.06609808102345,3
2009,South China Unviersity of Tehcnology,scutrun2,42,1000,908,92,1.05932203389831,2.55555555555556
2009,South China Unviersity of Tehcnology,scutrun2,43,1000,841,159,1.11482720178372,2.83928571428571
2009,South China Unviersity of Tehcnology,scutrun2,44,1000,726,274,1.29032258064516,5.59183673469388
2009,South China Unviersity of Tehcnology,scutrun2,45,1000,891,109,1.09170305676856,4.36
2009,South China Unviersity of Tehcnology,scutrun2,46,1000,758,242,1.21212121212121,3.61194029850746
2009,South China Unviersity of Tehcnology,scutrun2,47,1000,875,125,1.08813928182807,2.84090909090909
2009,South China Unviersity of Tehcnology,scutrun2,48,1000,868,132,1.10987791342952,4
2009,South China Unviersity of Tehcnology,scutrun2,49,1000,813,187,1.14810562571757,3.22413793103448
2009,South China Unviersity of Tehcnology,scutrun2,50,1000,950,50,1.02880658436214,2.27272727272727
2009,South China Unviersity of Tehcnology,scutrun3,1,1000,836,164,1.12612612612613,3.15384615384615
2009,South China Unviersity of Tehcnology,scutrun3,2,1000,843,157,1.1454753722795,5.23333333333333
2009,South China Unviersity of Tehcnology,scutrun3,3,1000,847,153,1.12485939257593,3.64285714285714
2009,South China Unviersity of Tehcnology,scutrun3,4,1000,820,180,1.14025085518814,3.15789473684211
2009,South China Unviersity of Tehcnology,scutrun3,5,1000,831,169,1.11111111111111,2.44927536231884
2009,South China Unviersity of Tehcnology,scutrun3,6,1000,506,494,1.76991150442478,8.3728813559322
2009,South China Unviersity of Tehcnology,scutrun3,7,1000,979,21,1.01317122593718,2.625
2009,South China Unviersity of Tehcnology,scutrun3,8,1000,855,145,1.11482720178372,3.45238095238095
2009,South China Unviersity of Tehcnology,scutrun3,9,1000,927,73,1.04602510460251,2.51724137931035
2009,South China Unviersity of Tehcnology,scutrun3,10,1000,617,383,1.50829562594268,8.32608695652174
2009,South China Unviersity of Tehcnology,scutrun3,11,1000,941,59,1.03412616339193,2.26923076923077
2009,South China Unviersity of Tehcnology,scutrun3,12,1000,432,568,2.04081632653061,9.79310344827586
2009,South China Unviersity of Tehcnology,scutrun3,13,1000,830,170,1.13895216400911,3.54166666666667
2009,South China Unviersity of Tehcnology,scutrun3,14,1000,896,104,1.07066381156317,2.73684210526316
2009,South China Unviersity of Tehcnology,scutrun3,15,1000,801,199,1.13378684807256,2.45679012345679
2009,South China Unviersity of Tehcnology,scutrun3,16,1000,854,146,1.09051254089422,2.31746031746032
2009,South China Unviersity of Tehcnology,scutrun3,17,1000,937,63,1.05042016806723,4.2
2009,South China Unviersity of Tehcnology,scutrun3,18,1000,901,99,1.07296137339056,3.19354838709677
2009,South China Unviersity of Tehcnology,scutrun3,19,1000,761,239,1.19047619047619,3.0253164556962
2009,South China Unviersity of Tehcnology,scutrun3,20,1000,793,207,1.17647058823529,3.63157894736842
2009,South China Unviersity of Tehcnology,scutrun3,21,1000,910,90,1.05708245243129,2.5
2009,South China Unviersity of Tehcnology,scutrun3,22,1000,909,91,1.06496272630458,3.03333333333333
2009,South China Unviersity of Tehcnology,scutrun3,23,1000,626,374,1.42045454545455,4.7948717948718
2009,South China Unviersity of Tehcnology,scutrun3,24,1000,892,108,1.06951871657754,2.51162790697674
2009,South China Unviersity of Tehcnology,scutrun3,25,1000,682,318,1.30039011703511,3.6551724137931
2009,South China Unviersity of Tehcnology,scutrun3,26,1000,885,115,1.0752688172043,2.55555555555556
2009,South China Unviersity of Tehcnology,scutrun3,27,1000,906,94,1.06044538706257,2.54054054054054
2009,South China Unviersity of Tehcnology,scutrun3,28,1000,670,330,1.36054421768707,5.07692307692308
2009,South China Unviersity of Tehcnology,scutrun3,29,1000,908,92,1.06044538706257,2.62857142857143
2009,South China Unviersity of Tehcnology,scutrun3,30,1000,970,30,1.01522842639594,2
2009,South China Unviersity of Tehcnology,scutrun3,31,1000,756,244,1.194743130227,3.01234567901235
2009,South China Unviersity of Tehcnology,scutrun3,32,1000,941,59,1.03626943005181,2.45833333333333
2009,South China Unviersity of Tehcnology,scutrun3,33,1000,927,73,1.04712041884817,2.60714285714286
2009,South China Unviersity of Tehcnology,scutrun3,34,1000,944,56,1.03626943005181,2.66666666666667
2009,South China Unviersity of Tehcnology,scutrun3,35,1000,670,330,1.30378096479791,3.4020618556701
2009,South China Unviersity of Tehcnology,scutrun3,36,1000,947,53,1.0351966873706,2.78947368421053
2009,South China Unviersity of Tehcnology,scutrun3,37,1000,655,345,1.39082058414465,5.390625
2009,South China Unviersity of Tehcnology,scutrun3,38,1000,929,71,1.0482180293501,2.84
2009,South China Unviersity of Tehcnology,scutrun3,39,1000,914,86,1.05708245243129,2.6875
2009,South China Unviersity of Tehcnology,scutrun3,40,130,74,56,1.56626506024096,6.22222222222222
2009,South China Unviersity of Tehcnology,scutrun3,41,1000,907,93,1.06609808102345,3
2009,South China Unviersity of Tehcnology,scutrun3,42,1000,908,92,1.05932203389831,2.55555555555556
2009,South China Unviersity of Tehcnology,scutrun3,43,1000,841,159,1.11482720178372,2.83928571428571
2009,South China Unviersity of Tehcnology,scutrun3,44,1000,726,274,1.29198966408269,5.70833333333333
2009,South China Unviersity of Tehcnology,scutrun3,45,1000,891,109,1.09170305676856,4.36
2009,South China Unviersity of Tehcnology,scutrun3,46,1000,758,242,1.21212121212121,3.61194029850746
2009,South China Unviersity of Tehcnology,scutrun3,47,1000,875,125,1.08813928182807,2.84090909090909
2009,South China Unviersity of Tehcnology,scutrun3,48,1000,868,132,1.10987791342952,4
2009,South China Unviersity of Tehcnology,scutrun3,49,1000,814,186,1.14678899082569,3.20689655172414
2009,South China Unviersity of Tehcnology,scutrun3,50,1000,950,50,1.02774922918808,2.17391304347826
2009,University of Twente,twCSrs9N,1,999,840,159,1.11,2.65
2009,University of Twente,twCSrs9N,2,999,954,45,1.02566735112936,2.25
2009,University of Twente,twCSrs9N,3,999,942,57,1.03523316062176,2.47826086956522
2009,University of Twente,twCSrs9N,4,999,960,39,1.02251791197544,2.29411764705882
2009,University of Twente,twCSrs9N,5,999,921,78,1.04826862539349,2.4375
2009,University of Twente,twCSrs9N,6,999,903,96,1.06959314775161,3.09677419354839
2009,University of Twente,twCSrs9N,7,999,882,117,1.07650862068966,2.54347826086957
2009,University of Twente,twCSrs9N,8,999,981,18,1.00909090909091,2
2009,University of Twente,twCSrs9N,9,999,562,437,1.66222961730449,11.2051282051282
2009,University of Twente,twCSrs9N,10,999,919,80,1.06050955414013,3.47826086956522
2009,University of Twente,twCSrs9N,11,999,945,54,1.03202479338843,2.34782608695652
2009,University of Twente,twCSrs9N,12,999,896,103,1.07766990291262,3.32258064516129
2009,University of Twente,twCSrs9N,13,999,768,231,1.15893271461717,2.45744680851064
2009,University of Twente,twCSrs9N,14,999,973,26,1.0131845841785,2
2009,University of Twente,twCSrs9N,15,999,959,40,1.02251791197544,2.22222222222222
2009,University of Twente,twCSrs9N,16,999,909,90,1.06616862326574,3.21428571428571
2009,University of Twente,twCSrs9N,17,999,904,95,1.06844919786096,3.06451612903226
2009,University of Twente,twCSrs9N,18,999,969,30,1.01627670396745,2.14285714285714
2009,University of Twente,twCSrs9N,19,999,835,164,1.11744966442953,2.77966101694915
2009,University of Twente,twCSrs9N,20,999,919,80,1.05047318611987,2.5
2009,University of Twente,twCSrs9N,21,999,863,136,1.09539473684211,2.77551020408163
2009,University of Twente,twCSrs9N,22,999,976,23,1.01215805471125,2.09090909090909
2009,University of Twente,twCSrs9N,23,999,942,57,1.03523316062176,2.47826086956522
2009,University of Twente,twCSrs9N,24,999,977,22,1.01113360323887,2
2009,University of Twente,twCSrs9N,25,999,841,158,1.11870100783875,3.03846153846154
2009,University of Twente,twCSrs9N,26,999,954,45,1.02989690721649,2.8125
2009,University of Twente,twCSrs9N,27,999,981,18,1.01113360323887,2.57142857142857
2009,University of Twente,twCSrs9N,28,999,904,95,1.07073954983923,3.27586206896552
2009,University of Twente,twCSrs9N,29,999,905,94,1.07303974221267,3.61538461538462
2009,University of Twente,twCSrs9N,30,999,968,31,1.01627670396745,2.06666666666667
2009,University of Twente,twCSrs9N,31,999,959,40,1.02147239263804,2.10526315789474
2009,University of Twente,twCSrs9N,32,999,690,309,1.34817813765182,6.05882352941176
2009,University of Twente,twCSrs9N,33,999,995,4,1.00200601805416,2
2009,University of Twente,twCSrs9N,34,999,853,146,1.10143329658214,2.7037037037037
2009,University of Twente,twCSrs9N,35,999,970,29,1.01627670396745,2.23076923076923
2009,University of Twente,twCSrs9N,36,999,953,46,1.02461538461538,2.09090909090909
2009,University of Twente,twCSrs9N,37,999,967,32,1.0173116089613,2.13333333333333
2009,University of Twente,twCSrs9N,38,999,900,99,1.05714285714286,2.2
2009,University of Twente,twCSrs9N,39,999,940,59,1.040625,2.95
2009,University of Twente,twCSrs9N,40,999,786,213,1.14302059496568,2.42045454545455
2009,University of Twente,twCSrs9N,41,999,964,35,1.01834862385321,2.05882352941176
2009,University of Twente,twCSrs9N,42,999,756,243,1.22127139364303,3.91935483870968
2009,University of Twente,twCSrs9N,43,999,950,49,1.02672147995889,2.1304347826087
2009,University of Twente,twCSrs9N,44,999,810,189,1.14827586206897,3.15
2009,University of Twente,twCSrs9N,45,999,963,36,1.02042900919305,2.25
2009,University of Twente,twCSrs9N,46,999,979,20,1.01113360323887,2.22222222222222
2009,University of Twente,twCSrs9N,47,999,985,14,1.0070564516129,2
2009,University of Twente,twCSrs9N,48,999,979,20,1.01011122345804,2
2009,University of Twente,twCSrs9N,49,999,919,80,1.04716981132075,2.28571428571429
2009,University of Twente,twCSrs9N,50,999,884,115,1.08469055374593,3.10810810810811
2009,University of Twente,twCSrsR,1,999,999,0,1,
2009,University of Twente,twCSrsR,2,999,999,0,1,
2009,University of Twente,twCSrsR,3,999,999,0,1,
2009,University of Twente,twCSrsR,4,999,999,0,1,
2009,University of Twente,twCSrsR,5,999,999,0,1,
2009,University of Twente,twCSrsR,6,999,999,0,1,
2009,University of Twente,twCSrsR,7,999,999,0,1,
2009,University of Twente,twCSrsR,8,999,999,0,1,
2009,University of Twente,twCSrsR,9,999,999,0,1,
2009,University of Twente,twCSrsR,10,999,999,0,1,
2009,University of Twente,twCSrsR,11,999,999,0,1,
2009,University of Twente,twCSrsR,12,999,999,0,1,
2009,University of Twente,twCSrsR,13,999,999,0,1,
2009,University of Twente,twCSrsR,14,999,999,0,1,
2009,University of Twente,twCSrsR,15,999,999,0,1,
2009,University of Twente,twCSrsR,16,999,999,0,1,
2009,University of Twente,twCSrsR,17,999,999,0,1,
2009,University of Twente,twCSrsR,18,999,999,0,1,
2009,University of Twente,twCSrsR,19,999,999,0,1,
2009,University of Twente,twCSrsR,20,999,999,0,1,
2009,University of Twente,twCSrsR,21,999,999,0,1,
2009,University of Twente,twCSrsR,22,999,999,0,1,
2009,University of Twente,twCSrsR,23,999,999,0,1,
2009,University of Twente,twCSrsR,24,999,999,0,1,
2009,University of Twente,twCSrsR,25,999,999,0,1,
2009,University of Twente,twCSrsR,26,999,999,0,1,
2009,University of Twente,twCSrsR,27,999,999,0,1,
2009,University of Twente,twCSrsR,28,999,999,0,1,
2009,University of Twente,twCSrsR,29,999,999,0,1,
2009,University of Twente,twCSrsR,30,999,999,0,1,
2009,University of Twente,twCSrsR,31,999,999,0,1,
2009,University of Twente,twCSrsR,32,999,999,0,1,
2009,University of Twente,twCSrsR,33,999,999,0,1,
2009,University of Twente,twCSrsR,34,999,999,0,1,
2009,University of Twente,twCSrsR,35,999,999,0,1,
2009,University of Twente,twCSrsR,36,999,999,0,1,
2009,University of Twente,twCSrsR,37,999,999,0,1,
2009,University of Twente,twCSrsR,38,999,999,0,1,
2009,University of Twente,twCSrsR,39,999,999,0,1,
2009,University of Twente,twCSrsR,40,999,999,0,1,
2009,University of Twente,twCSrsR,41,999,999,0,1,
2009,University of Twente,twCSrsR,42,999,999,0,1,
2009,University of Twente,twCSrsR,43,999,999,0,1,
2009,University of Twente,twCSrsR,44,999,999,0,1,
2009,University of Twente,twCSrsR,45,999,999,0,1,
2009,University of Twente,twCSrsR,46,999,999,0,1,
2009,University of Twente,twCSrsR,47,999,999,0,1,
2009,University of Twente,twCSrsR,48,999,999,0,1,
2009,University of Twente,twCSrsR,49,999,999,0,1,
2009,University of Twente,twCSrsR,50,999,999,0,1,
2009,University of Twente,twJ48rsU,1,999,767,232,1.18364928909953,3.01298701298701
2009,University of Twente,twJ48rsU,2,999,850,149,1.08823529411765,2.19117647058824
2009,University of Twente,twJ48rsU,3,999,886,113,1.0741935483871,2.56818181818182
2009,University of Twente,twJ48rsU,4,999,983,16,1.00807265388496,2
2009,University of Twente,twJ48rsU,5,999,975,24,1.01215805471125,2
2009,University of Twente,twJ48rsU,6,999,939,60,1.03202479338843,2.06896551724138
2009,University of Twente,twJ48rsU,7,999,855,144,1.10143329658214,2.76923076923077
2009,University of Twente,twJ48rsU,8,999,977,22,1.01113360323887,2
2009,University of Twente,twJ48rsU,9,999,538,461,1.77758007117438,19.2083333333333
2009,University of Twente,twJ48rsU,10,999,741,258,1.26937738246506,5.60869565217391
2009,University of Twente,twJ48rsU,11,999,950,49,1.02883625128733,2.33333333333333
2009,University of Twente,twJ48rsU,12,999,936,63,1.03630705394191,2.25
2009,University of Twente,twJ48rsU,13,999,856,143,1.09061135371179,2.38333333333333
2009,University of Twente,twJ48rsU,14,999,983,16,1.00807265388496,2
2009,University of Twente,twJ48rsU,15,999,809,190,1.13009049773756,2.53333333333333
2009,University of Twente,twJ48rsU,16,999,843,156,1.12881355932203,3.71428571428571
2009,University of Twente,twJ48rsU,17,999,970,29,1.01834862385321,2.63636363636364
2009,University of Twente,twJ48rsU,18,999,943,56,1.02883625128733,2
2009,University of Twente,twJ48rsU,19,999,825,174,1.10876803551609,2.28947368421053
2009,University of Twente,twJ48rsU,20,999,765,234,1.21532846715328,4.10526315789474
2009,University of Twente,twJ48rsU,21,999,930,69,1.04388714733542,2.55555555555556
2009,University of Twente,twJ48rsU,22,999,963,36,1.01938775510204,2.11764705882353
2009,University of Twente,twJ48rsU,23,999,915,84,1.05268703898841,2.47058823529412
2009,University of Twente,twJ48rsU,24,999,933,66,1.03630705394191,2.12903225806452
2009,University of Twente,twJ48rsU,25,999,979,20,1.01011122345804,2
2009,University of Twente,twJ48rsU,26,999,946,53,1.03309203722854,2.52380952380952
2009,University of Twente,twJ48rsU,27,999,983,16,1.01011122345804,2.66666666666667
2009,University of Twente,twJ48rsU,28,999,959,40,1.02251791197544,2.22222222222222
2009,University of Twente,twJ48rsU,29,999,908,91,1.07073954983923,3.64
2009,University of Twente,twJ48rsU,30,999,970,29,1.01524390243902,2.07142857142857
2009,University of Twente,twJ48rsU,31,999,935,64,1.03738317757009,2.28571428571429
2009,University of Twente,twJ48rsU,32,999,803,196,1.19497607655502,5.93939393939394
2009,University of Twente,twJ48rsU,33,999,972,27,1.01421319796954,2.07692307692308
2009,University of Twente,twJ48rsU,34,999,826,173,1.13265306122449,3.08928571428571
2009,University of Twente,twJ48rsU,35,999,976,23,1.0131845841785,2.3
2009,University of Twente,twJ48rsU,36,999,965,34,1.01834862385321,2.125
2009,University of Twente,twJ48rsU,37,999,979,20,1.01011122345804,2
2009,University of Twente,twJ48rsU,38,999,610,389,1.3355614973262,2.81884057971015
2009,University of Twente,twJ48rsU,39,999,970,29,1.01524390243902,2.07142857142857
2009,University of Twente,twJ48rsU,40,999,647,352,1.31447368421053,3.11504424778761
2009,University of Twente,twJ48rsU,41,999,956,43,1.02461538461538,2.26315789473684
2009,University of Twente,twJ48rsU,42,999,595,404,1.45626822157434,4.43956043956044
2009,University of Twente,twJ48rsU,43,999,848,151,1.11995515695067,3.43181818181818
2009,University of Twente,twJ48rsU,44,999,644,355,1.33734939759036,3.44660194174757
2009,University of Twente,twJ48rsU,45,999,971,28,1.01627670396745,2.33333333333333
2009,University of Twente,twJ48rsU,46,999,964,35,1.01834862385321,2.05882352941176
2009,University of Twente,twJ48rsU,47,999,974,25,1.0131845841785,2.08333333333333
2009,University of Twente,twJ48rsU,48,999,972,27,1.01421319796954,2.07692307692308
2009,University of Twente,twJ48rsU,49,999,954,45,1.02566735112936,2.25
2009,University of Twente,twJ48rsU,50,999,955,44,1.02989690721649,2.93333333333333
2009,University of Delaware,udelIndDMRM,1,1000,911,89,1.0482180293501,2.06976744186047
2009,University of Delaware,udelIndDMRM,2,1000,962,38,1.02040816326531,2.11111111111111
2009,University of Delaware,udelIndDMRM,3,1000,938,62,1.03626943005181,2.2962962962963
2009,University of Delaware,udelIndDMRM,4,1000,982,18,1.00908173562059,2
2009,University of Delaware,udelIndDMRM,5,1000,962,38,1.01936799184506,2
2009,University of Delaware,udelIndDMRM,6,1000,946,54,1.02774922918808,2
2009,University of Delaware,udelIndDMRM,7,1000,969,31,1.01729399796541,2.21428571428571
2009,University of Delaware,udelIndDMRM,8,1000,963,37,1.01936799184506,2.05555555555556
2009,University of Delaware,udelIndDMRM,9,1000,940,60,1.03842159916926,2.60869565217391
2009,University of Delaware,udelIndDMRM,10,1000,867,133,1.09051254089422,2.66
2009,University of Delaware,udelIndDMRM,11,1000,976,24,1.01214574898785,2
2009,University of Delaware,udelIndDMRM,12,1000,931,69,1.04384133611691,2.55555555555556
2009,University of Delaware,udelIndDMRM,13,1000,856,144,1.08813928182807,2.28571428571429
2009,University of Delaware,udelIndDMRM,14,1000,974,26,1.01317122593718,2
2009,University of Delaware,udelIndDMRM,15,1000,930,70,1.03626943005181,2
2009,University of Delaware,udelIndDMRM,16,1000,969,31,1.01626016260163,2.06666666666667
2009,University of Delaware,udelIndDMRM,17,1000,978,22,1.01112234580384,2
2009,University of Delaware,udelIndDMRM,18,1000,974,26,1.01317122593718,2
2009,University of Delaware,udelIndDMRM,19,1000,947,53,1.02880658436214,2.12
2009,University of Delaware,udelIndDMRM,20,1000,966,34,1.01729399796541,2
2009,University of Delaware,udelIndDMRM,21,1000,963,37,1.02145045965271,2.3125
2009,University of Delaware,udelIndDMRM,22,1000,946,54,1.03412616339193,2.57142857142857
2009,University of Delaware,udelIndDMRM,23,1000,769,231,1.16279069767442,2.53846153846154
2009,University of Delaware,udelIndDMRM,24,1000,952,48,1.02564102564103,2.08695652173913
2009,University of Delaware,udelIndDMRM,25,1000,911,89,1.04712041884817,2.02272727272727
2009,University of Delaware,udelIndDMRM,26,1000,981,19,1.01010101010101,2.11111111111111
2009,University of Delaware,udelIndDMRM,27,1000,984,16,1.00806451612903,2
2009,University of Delaware,udelIndDMRM,28,1000,916,84,1.04602510460251,2.1
2009,University of Delaware,udelIndDMRM,29,1000,982,18,1.00908173562059,2
2009,University of Delaware,udelIndDMRM,30,1000,966,34,1.01729399796541,2
2009,University of Delaware,udelIndDMRM,31,1000,934,66,1.0351966873706,2.0625
2009,University of Delaware,udelIndDMRM,32,1000,959,41,1.02145045965271,2.05
2009,University of Delaware,udelIndDMRM,33,1000,982,18,1.00908173562059,2
2009,University of Delaware,udelIndDMRM,34,1000,884,116,1.06951871657754,2.27450980392157
2009,University of Delaware,udelIndDMRM,35,1000,954,46,1.02459016393443,2.09090909090909
2009,University of Delaware,udelIndDMRM,36,1000,960,40,1.02040816326531,2
2009,University of Delaware,udelIndDMRM,37,1000,990,10,1.00502512562814,2
2009,University of Delaware,udelIndDMRM,38,1000,966,34,1.01729399796541,2
2009,University of Delaware,udelIndDMRM,39,1000,943,57,1.03092783505155,2.11111111111111
2009,University of Delaware,udelIndDMRM,40,1000,406,594,1.66944908180301,3.07772020725389
2009,University of Delaware,udelIndDMRM,41,1000,981,19,1.01010101010101,2.11111111111111
2009,University of Delaware,udelIndDMRM,42,1000,864,136,1.10864745011086,3.57894736842105
2009,University of Delaware,udelIndDMRM,43,1000,968,32,1.01626016260163,2
2009,University of Delaware,udelIndDMRM,44,1000,931,69,1.03734439834025,2.09090909090909
2009,University of Delaware,udelIndDMRM,45,1000,970,30,1.01626016260163,2.14285714285714
2009,University of Delaware,udelIndDMRM,46,1000,959,41,1.02145045965271,2.05
2009,University of Delaware,udelIndDMRM,47,1000,977,23,1.01214574898785,2.09090909090909
2009,University of Delaware,udelIndDMRM,48,1000,969,31,1.01729399796541,2.21428571428571
2009,University of Delaware,udelIndDMRM,49,1000,964,36,1.01936799184506,2.11764705882353
2009,University of Delaware,udelIndDMRM,50,1000,972,28,1.01419878296146,2
2009,University of Delaware,udelIndDRPR,1,1000,728,272,1.17647058823529,2.22950819672131
2009,University of Delaware,udelIndDRPR,2,1000,745,255,1.16009280742459,2.17948717948718
2009,University of Delaware,udelIndDRPR,3,1000,953,47,1.02459016393443,2.04347826086957
2009,University of Delaware,udelIndDRPR,4,1000,908,92,1.0515247108307,2.13953488372093
2009,University of Delaware,udelIndDRPR,5,1000,816,184,1.10864745011086,2.13953488372093
2009,University of Delaware,udelIndDRPR,6,1000,812,188,1.10741971207087,2.06593406593407
2009,University of Delaware,udelIndDRPR,7,1000,629,371,1.26262626262626,2.2760736196319
2009,University of Delaware,udelIndDRPR,8,1000,939,61,1.03412616339193,2.17857142857143
2009,University of Delaware,udelIndDRPR,9,1000,960,40,1.02040816326531,2
2009,University of Delaware,udelIndDRPR,10,1000,903,97,1.05932203389831,2.36585365853659
2009,University of Delaware,udelIndDRPR,11,1000,822,178,1.10132158590308,2.06976744186047
2009,University of Delaware,udelIndDRPR,12,1000,949,51,1.02774922918808,2.125
2009,University of Delaware,udelIndDRPR,13,1000,957,43,1.02459016393443,2.26315789473684
2009,University of Delaware,udelIndDRPR,14,1000,864,136,1.07642626480086,2.09230769230769
2009,University of Delaware,udelIndDRPR,15,1000,761,239,1.14942528735632,2.19266055045872
2009,University of Delaware,udelIndDRPR,16,1000,829,171,1.1001100110011,2.1375
2009,University of Delaware,udelIndDRPR,17,1000,976,24,1.01214574898785,2
2009,University of Delaware,udelIndDRPR,18,1000,753,247,1.15207373271889,2.14782608695652
2009,University of Delaware,udelIndDRPR,19,1000,961,39,1.02040816326531,2.05263157894737
2009,University of Delaware,udelIndDRPR,20,1000,699,301,1.20918984280532,2.3515625
2009,University of Delaware,udelIndDRPR,21,1000,978,22,1.01112234580384,2
2009,University of Delaware,udelIndDRPR,22,1000,822,178,1.10253583241455,2.09411764705882
2009,University of Delaware,udelIndDRPR,23,1000,846,154,1.10253583241455,2.52459016393443
2009,University of Delaware,udelIndDRPR,24,1000,745,255,1.15473441108545,2.10743801652893
2009,University of Delaware,udelIndDRPR,25,1000,748,252,1.15740740740741,2.17241379310345
2009,University of Delaware,udelIndDRPR,26,1000,725,275,1.17508813160987,2.18253968253968
2009,University of Delaware,udelIndDRPR,27,1000,808,192,1.11358574610245,2.13333333333333
2009,University of Delaware,udelIndDRPR,28,1000,797,203,1.12233445566779,2.15957446808511
2009,University of Delaware,udelIndDRPR,29,1000,597,403,1.29366106080207,2.28977272727273
2009,University of Delaware,udelIndDRPR,30,1000,781,219,1.13378684807256,2.16831683168317
2009,University of Delaware,udelIndDRPR,31,1000,708,292,1.18623962040332,2.16296296296296
2009,University of Delaware,udelIndDRPR,32,1000,972,28,1.01419878296146,2
2009,University of Delaware,udelIndDRPR,33,1000,921,79,1.04275286757039,2.07894736842105
2009,University of Delaware,udelIndDRPR,34,1000,976,24,1.01214574898785,2
2009,University of Delaware,udelIndDRPR,35,1000,842,158,1.09170305676856,2.13513513513514
2009,University of Delaware,udelIndDRPR,36,1000,976,24,1.01214574898785,2
2009,University of Delaware,udelIndDRPR,37,1000,827,173,1.10497237569061,2.21794871794872
2009,University of Delaware,udelIndDRPR,38,1000,979,21,1.01112234580384,2.1
2009,University of Delaware,udelIndDRPR,39,1000,834,166,1.09649122807018,2.12820512820513
2009,University of Delaware,udelIndDRPR,40,1000,638,362,1.25156445556946,2.24844720496894
2009,University of Delaware,udelIndDRPR,41,1000,584,416,1.30039011703511,2.24864864864865
2009,University of Delaware,udelIndDRPR,42,1000,953,47,1.02459016393443,2.04347826086957
2009,University of Delaware,udelIndDRPR,43,1000,686,314,1.20481927710843,2.18055555555556
2009,University of Delaware,udelIndDRPR,44,1000,940,60,1.03092783505155,2
2009,University of Delaware,udelIndDRPR,45,1000,948,52,1.02774922918808,2.08
2009,University of Delaware,udelIndDRPR,46,1000,905,95,1.0515247108307,2.06521739130435
2009,University of Delaware,udelIndDRPR,47,1000,864,136,1.07642626480086,2.09230769230769
2009,University of Delaware,udelIndDRPR,48,1000,890,110,1.06044538706257,2.07547169811321
2009,University of Delaware,udelIndDRPR,49,1000,767,233,1.1441647597254,2.17757009345794
2009,University of Delaware,udelIndDRPR,50,1000,783,217,1.12866817155756,2.10679611650485
2009,University of Delaware,udelIndDRSP,1,1000,906,94,1.05042016806723,2.04347826086957
2009,University of Delaware,udelIndDRSP,2,1000,966,34,1.0183299389002,2.125
2009,University of Delaware,udelIndDRSP,3,1000,936,64,1.03412616339193,2.06451612903226
2009,University of Delaware,udelIndDRSP,4,1000,973,27,1.01419878296146,2.07692307692308
2009,University of Delaware,udelIndDRSP,5,1000,933,67,1.03626943005181,2.09375
2009,University of Delaware,udelIndDRSP,6,1000,752,248,1.15874855156431,2.23423423423423
2009,University of Delaware,udelIndDRSP,7,1000,969,31,1.01729399796541,2.21428571428571
2009,University of Delaware,udelIndDRSP,8,1000,953,47,1.02459016393443,2.04347826086957
2009,University of Delaware,udelIndDRSP,9,1000,969,31,1.01626016260163,2.06666666666667
2009,University of Delaware,udelIndDRSP,10,1000,932,68,1.04166666666667,2.42857142857143
2009,University of Delaware,udelIndDRSP,11,1000,856,144,1.08108108108108,2.08695652173913
2009,University of Delaware,udelIndDRSP,12,1000,933,67,1.04384133611691,2.68
2009,University of Delaware,udelIndDRSP,13,1000,787,213,1.13895216400911,2.34065934065934
2009,University of Delaware,udelIndDRSP,14,1000,964,36,1.0183299389002,2
2009,University of Delaware,udelIndDRSP,15,1000,926,74,1.03842159916926,2
2009,University of Delaware,udelIndDRSP,16,1000,959,41,1.02145045965271,2.05
2009,University of Delaware,udelIndDRSP,17,1000,970,30,1.01522842639594,2
2009,University of Delaware,udelIndDRSP,18,1000,898,102,1.05596620908131,2.08163265306122
2009,University of Delaware,udelIndDRSP,19,1000,879,121,1.06609808102345,2.05084745762712
2009,University of Delaware,udelIndDRSP,20,1000,952,48,1.02459016393443,2
2009,University of Delaware,udelIndDRSP,21,1000,945,55,1.03092783505155,2.2
2009,University of Delaware,udelIndDRSP,22,1000,950,50,1.03199174406605,2.63157894736842
2009,University of Delaware,udelIndDRSP,23,1000,782,218,1.15207373271889,2.53488372093023
2009,University of Delaware,udelIndDRSP,24,1000,962,38,1.01936799184506,2
2009,University of Delaware,udelIndDRSP,25,1000,881,119,1.06382978723404,2.01694915254237
2009,University of Delaware,udelIndDRSP,26,1000,969,31,1.01626016260163,2.06666666666667
2009,University of Delaware,udelIndDRSP,27,1000,980,20,1.01010101010101,2
2009,University of Delaware,udelIndDRSP,28,1000,914,86,1.04602510460251,2.04761904761905
2009,University of Delaware,udelIndDRSP,29,1000,976,24,1.01214574898785,2
2009,University of Delaware,udelIndDRSP,30,1000,962,38,1.01936799184506,2
2009,University of Delaware,udelIndDRSP,31,1000,920,80,1.04275286757039,2.05128205128205
2009,University of Delaware,udelIndDRSP,32,1000,961,39,1.02040816326531,2.05263157894737
2009,University of Delaware,udelIndDRSP,33,1000,978,22,1.01112234580384,2
2009,University of Delaware,udelIndDRSP,34,1000,962,38,1.02669404517454,3.16666666666667
2009,University of Delaware,udelIndDRSP,35,1000,904,96,1.05596620908131,2.23255813953488
2009,University of Delaware,udelIndDRSP,36,1000,981,19,1.01010101010101,2.11111111111111
2009,University of Delaware,udelIndDRSP,37,1000,741,259,1.16959064327485,2.2719298245614
2009,University of Delaware,udelIndDRSP,38,1000,959,41,1.02145045965271,2.05
2009,University of Delaware,udelIndDRSP,39,1000,933,67,1.0351966873706,2.03030303030303
2009,University of Delaware,udelIndDRSP,40,1000,410,590,1.6260162601626,2.87804878048781
2009,University of Delaware,udelIndDRSP,41,1000,972,28,1.01419878296146,2
2009,University of Delaware,udelIndDRSP,42,1000,871,129,1.09051254089422,2.80434782608696
2009,University of Delaware,udelIndDRSP,43,1000,956,44,1.02249488752556,2
2009,University of Delaware,udelIndDRSP,44,1000,919,81,1.04384133611691,2.07692307692308
2009,University of Delaware,udelIndDRSP,45,1000,949,51,1.02669404517454,2.04
2009,University of Delaware,udelIndDRSP,46,1000,905,95,1.0515247108307,2.06521739130435
2009,University of Delaware,udelIndDRSP,47,1000,987,13,1.00704934541793,2.16666666666667
2009,University of Delaware,udelIndDRSP,48,1000,876,124,1.06951871657754,2.10169491525424
2009,University of Delaware,udelIndDRSP,49,1000,885,115,1.06723585912487,2.21153846153846
2009,University of Delaware,udelIndDRSP,50,1000,933,67,1.0351966873706,2.03030303030303
2009,University of Glasgow Terrier Team,uogTrdphA,1,1000,759,241,1.16414435389988,2.41
2009,University of Glasgow Terrier Team,uogTrdphA,2,1000,846,154,1.09409190371991,2.26470588235294
2009,University of Glasgow Terrier Team,uogTrdphA,3,1000,854,146,1.08459869848156,2.14705882352941
2009,University of Glasgow Terrier Team,uogTrdphA,4,1000,818,182,1.12359550561798,2.52777777777778
2009,University of Glasgow Terrier Team,uogTrdphA,5,1000,834,166,1.09769484083425,2.15584415584416
2009,University of Glasgow Terrier Team,uogTrdphA,6,1000,724,276,1.19904076738609,2.50909090909091
2009,University of Glasgow Terrier Team,uogTrdphA,7,1000,926,74,1.04602510460251,2.46666666666667
2009,University of Glasgow Terrier Team,uogTrdphA,8,1000,888,112,1.06496272630458,2.19607843137255
2009,University of Glasgow Terrier Team,uogTrdphA,9,1000,919,81,1.05932203389831,3.24
2009,University of Glasgow Terrier Team,uogTrdphA,10,1000,833,167,1.10864745011086,2.42028985507246
2009,University of Glasgow Terrier Team,uogTrdphA,11,1000,860,140,1.08108108108108,2.15384615384615
2009,University of Glasgow Terrier Team,uogTrdphA,12,1000,887,113,1.06157112526539,2.05454545454545
2009,University of Glasgow Terrier Team,uogTrdphA,13,1000,887,113,1.06157112526539,2.05454545454545
2009,University of Glasgow Terrier Team,uogTrdphA,14,1000,866,134,1.07758620689655,2.16129032258065
2009,University of Glasgow Terrier Team,uogTrdphA,15,1000,783,217,1.16009280742459,2.74683544303797
2009,University of Glasgow Terrier Team,uogTrdphA,16,1000,735,265,1.15606936416185,2.03846153846154
2009,University of Glasgow Terrier Team,uogTrdphA,17,1000,943,57,1.03092783505155,2.11111111111111
2009,University of Glasgow Terrier Team,uogTrdphA,18,1000,937,63,1.0351966873706,2.17241379310345
2009,University of Glasgow Terrier Team,uogTrdphA,19,1000,848,152,1.08932461873638,2.17142857142857
2009,University of Glasgow Terrier Team,uogTrdphA,20,1000,875,125,1.0752688172043,2.27272727272727
2009,University of Glasgow Terrier Team,uogTrdphA,21,1000,904,96,1.06269925611052,2.59459459459459
2009,University of Glasgow Terrier Team,uogTrdphA,22,1000,958,42,1.02249488752556,2.1
2009,University of Glasgow Terrier Team,uogTrdphA,23,1000,554,446,1.68634064080944,11.4358974358974
2009,University of Glasgow Terrier Team,uogTrdphA,24,1000,846,154,1.08813928182807,2.10958904109589
2009,University of Glasgow Terrier Team,uogTrdphA,25,1000,738,262,1.18483412322275,2.47169811320755
2009,University of Glasgow Terrier Team,uogTrdphA,26,1000,921,79,1.04493207941484,2.19444444444444
2009,University of Glasgow Terrier Team,uogTrdphA,27,1000,905,95,1.05596620908131,2.26190476190476
2009,University of Glasgow Terrier Team,uogTrdphA,28,1000,736,264,1.21951219512195,3.14285714285714
2009,University of Glasgow Terrier Team,uogTrdphA,29,1000,917,83,1.05596620908131,2.76666666666667
2009,University of Glasgow Terrier Team,uogTrdphA,30,1000,853,147,1.08225108225108,2.07042253521127
2009,University of Glasgow Terrier Team,uogTrdphA,31,1000,791,209,1.14155251141553,2.45882352941177
2009,University of Glasgow Terrier Team,uogTrdphA,32,1000,799,201,1.12612612612613,2.25842696629214
2009,University of Glasgow Terrier Team,uogTrdphA,33,1000,930,70,1.03950103950104,2.1875
2009,University of Glasgow Terrier Team,uogTrdphA,34,1000,962,38,1.01936799184506,2
2009,University of Glasgow Terrier Team,uogTrdphA,35,1000,760,240,1.16009280742459,2.35294117647059
2009,University of Glasgow Terrier Team,uogTrdphA,36,1000,930,70,1.03842159916926,2.12121212121212
2009,University of Glasgow Terrier Team,uogTrdphA,37,1000,923,77,1.04493207941484,2.26470588235294
2009,University of Glasgow Terrier Team,uogTrdphA,38,1000,879,121,1.06951871657754,2.16071428571429
2009,University of Glasgow Terrier Team,uogTrdphA,39,1000,896,104,1.06496272630458,2.41860465116279
2009,University of Glasgow Terrier Team,uogTrdphA,40,171,157,14,1.04268292682927,2
2009,University of Glasgow Terrier Team,uogTrdphA,41,1000,839,161,1.10497237569061,2.43939393939394
2009,University of Glasgow Terrier Team,uogTrdphA,42,1000,930,70,1.03842159916926,2.12121212121212
2009,University of Glasgow Terrier Team,uogTrdphA,43,1000,912,88,1.05042016806723,2.2
2009,University of Glasgow Terrier Team,uogTrdphA,44,1000,863,137,1.08813928182807,2.44642857142857
2009,University of Glasgow Terrier Team,uogTrdphA,45,1000,892,108,1.06269925611052,2.20408163265306
2009,University of Glasgow Terrier Team,uogTrdphA,46,1000,859,141,1.10741971207087,3.20454545454545
2009,University of Glasgow Terrier Team,uogTrdphA,47,1000,924,76,1.04275286757039,2.17142857142857
2009,University of Glasgow Terrier Team,uogTrdphA,48,1000,863,137,1.09170305676856,2.58490566037736
2009,University of Glasgow Terrier Team,uogTrdphA,49,1000,852,148,1.09051254089422,2.27692307692308
2009,University of Glasgow Terrier Team,uogTrdphA,50,1000,952,48,1.02459016393443,2
2009,University of Glasgow Terrier Team,uogTrdphCEwP,1,1000,901,99,1.06044538706257,2.35714285714286
2009,University of Glasgow Terrier Team,uogTrdphCEwP,2,1000,850,150,1.08695652173913,2.14285714285714
2009,University of Glasgow Terrier Team,uogTrdphCEwP,3,1000,794,206,1.13765642775882,2.42352941176471
2009,University of Glasgow Terrier Team,uogTrdphCEwP,4,1000,857,143,1.09409190371991,2.50877192982456
2009,University of Glasgow Terrier Team,uogTrdphCEwP,5,1000,799,201,1.13250283125708,2.39285714285714
2009,University of Glasgow Terrier Team,uogTrdphCEwP,6,1000,670,330,1.24843945068664,2.51908396946565
2009,University of Glasgow Terrier Team,uogTrdphCEwP,7,1000,899,101,1.06496272630458,2.525
2009,University of Glasgow Terrier Team,uogTrdphCEwP,8,1000,771,229,1.15740740740741,2.46236559139785
2009,University of Glasgow Terrier Team,uogTrdphCEwP,9,1000,843,157,1.12739571589628,3.56818181818182
2009,University of Glasgow Terrier Team,uogTrdphCEwP,10,1000,916,84,1.04602510460251,2.1
2009,University of Glasgow Terrier Team,uogTrdphCEwP,11,1000,858,142,1.08342361863489,2.18461538461538
2009,University of Glasgow Terrier Team,uogTrdphCEwP,12,1000,960,40,1.02040816326531,2
2009,University of Glasgow Terrier Team,uogTrdphCEwP,13,1000,750,250,1.20772946859903,3.20512820512821
2009,University of Glasgow Terrier Team,uogTrdphCEwP,14,1000,820,180,1.11482720178372,2.33766233766234
2009,University of Glasgow Terrier Team,uogTrdphCEwP,15,1000,817,183,1.11731843575419,2.34615384615385
2009,University of Glasgow Terrier Team,uogTrdphCEwP,16,1000,752,248,1.14678899082569,2.06666666666667
2009,University of Glasgow Terrier Team,uogTrdphCEwP,17,1000,962,38,1.02040816326531,2.11111111111111
2009,University of Glasgow Terrier Team,uogTrdphCEwP,18,1000,892,108,1.06269925611052,2.20408163265306
2009,University of Glasgow Terrier Team,uogTrdphCEwP,19,1000,801,199,1.12866817155756,2.34117647058824
2009,University of Glasgow Terrier Team,uogTrdphCEwP,20,1000,878,122,1.07066381156317,2.17857142857143
2009,University of Glasgow Terrier Team,uogTrdphCEwP,21,1000,912,88,1.06044538706257,2.83870967741936
2009,University of Glasgow Terrier Team,uogTrdphCEwP,22,1000,951,49,1.02774922918808,2.22727272727273
2009,University of Glasgow Terrier Team,uogTrdphCEwP,23,1000,807,193,1.16009280742459,3.50909090909091
2009,University of Glasgow Terrier Team,uogTrdphCEwP,24,1000,869,131,1.07642626480086,2.18333333333333
2009,University of Glasgow Terrier Team,uogTrdphCEwP,25,1000,718,282,1.19904076738609,2.43103448275862
2009,University of Glasgow Terrier Team,uogTrdphCEwP,26,1000,876,124,1.07181136120043,2.17543859649123
2009,University of Glasgow Terrier Team,uogTrdphCEwP,27,1000,883,117,1.07642626480086,2.54347826086957
2009,University of Glasgow Terrier Team,uogTrdphCEwP,28,1000,700,300,1.25470514429109,3.09278350515464
2009,University of Glasgow Terrier Team,uogTrdphCEwP,29,1000,842,158,1.11482720178372,2.87272727272727
2009,University of Glasgow Terrier Team,uogTrdphCEwP,30,1000,832,168,1.09649122807018,2.1
2009,University of Glasgow Terrier Team,uogTrdphCEwP,31,1000,798,202,1.13765642775882,2.49382716049383
2009,University of Glasgow Terrier Team,uogTrdphCEwP,32,1000,781,219,1.1454753722795,2.3804347826087
2009,University of Glasgow Terrier Team,uogTrdphCEwP,33,1000,955,45,1.02459016393443,2.14285714285714
2009,University of Glasgow Terrier Team,uogTrdphCEwP,34,1000,960,40,1.02459016393443,2.5
2009,University of Glasgow Terrier Team,uogTrdphCEwP,35,1000,746,254,1.17096018735363,2.35185185185185
2009,University of Glasgow Terrier Team,uogTrdphCEwP,36,1000,913,87,1.05042016806723,2.23076923076923
2009,University of Glasgow Terrier Team,uogTrdphCEwP,37,1000,858,142,1.09649122807018,2.62962962962963
2009,University of Glasgow Terrier Team,uogTrdphCEwP,38,1000,871,129,1.0752688172043,2.1864406779661
2009,University of Glasgow Terrier Team,uogTrdphCEwP,39,1000,867,133,1.08342361863489,2.375
2009,University of Glasgow Terrier Team,uogTrdphCEwP,40,171,150,21,1.06875,2.1
2009,University of Glasgow Terrier Team,uogTrdphCEwP,41,1000,792,208,1.15473441108545,2.81081081081081
2009,University of Glasgow Terrier Team,uogTrdphCEwP,42,1000,913,87,1.0482180293501,2.1219512195122
2009,University of Glasgow Terrier Team,uogTrdphCEwP,43,1000,879,121,1.07066381156317,2.2
2009,University of Glasgow Terrier Team,uogTrdphCEwP,44,1000,857,143,1.09529025191676,2.55357142857143
2009,University of Glasgow Terrier Team,uogTrdphCEwP,45,1000,861,139,1.08813928182807,2.39655172413793
2009,University of Glasgow Terrier Team,uogTrdphCEwP,46,1000,864,136,1.09289617486339,2.66666666666667
2009,University of Glasgow Terrier Team,uogTrdphCEwP,47,1000,933,67,1.03734439834025,2.16129032258065
2009,University of Glasgow Terrier Team,uogTrdphCEwP,48,1000,773,227,1.16414435389988,2.63953488372093
2009,University of Glasgow Terrier Team,uogTrdphCEwP,49,1000,772,228,1.15473441108545,2.42553191489362
2009,University of Glasgow Terrier Team,uogTrdphCEwP,50,1000,926,74,1.04712041884817,2.55172413793103
2009,University of Glasgow Terrier Team,uogTrdphP,1,1000,737,263,1.18623962040332,2.4811320754717
2009,University of Glasgow Terrier Team,uogTrdphP,2,1000,846,154,1.0989010989011,2.40625
2009,University of Glasgow Terrier Team,uogTrdphP,3,1000,897,103,1.05932203389831,2.19148936170213
2009,University of Glasgow Terrier Team,uogTrdphP,4,1000,897,103,1.06044538706257,2.23913043478261
2009,University of Glasgow Terrier Team,uogTrdphP,5,1000,827,173,1.11358574610245,2.43661971830986
2009,University of Glasgow Terrier Team,uogTrdphP,6,1000,674,326,1.21802679658953,2.21768707482993
2009,University of Glasgow Terrier Team,uogTrdphP,7,1000,479,521,1.65016501650165,4.10236220472441
2009,University of Glasgow Terrier Team,uogTrdphP,8,1000,919,81,1.04602510460251,2.18918918918919
2009,University of Glasgow Terrier Team,uogTrdphP,9,1000,930,70,1.04493207941484,2.59259259259259
2009,University of Glasgow Terrier Team,uogTrdphP,10,1000,916,84,1.04602510460251,2.1
2009,University of Glasgow Terrier Team,uogTrdphP,11,1000,832,168,1.10987791342952,2.43478260869565
2009,University of Glasgow Terrier Team,uogTrdphP,12,1000,679,321,1.21654501216545,2.24475524475524
2009,University of Glasgow Terrier Team,uogTrdphP,13,1000,895,105,1.06157112526539,2.23404255319149
2009,University of Glasgow Terrier Team,uogTrdphP,14,1000,795,205,1.1454753722795,2.62820512820513
2009,University of Glasgow Terrier Team,uogTrdphP,15,1000,864,136,1.08932461873638,2.51851851851852
2009,University of Glasgow Terrier Team,uogTrdphP,16,1000,743,257,1.18063754427391,2.47115384615385
2009,University of Glasgow Terrier Team,uogTrdphP,17,1000,960,40,1.02564102564103,2.66666666666667
2009,University of Glasgow Terrier Team,uogTrdphP,18,1000,839,161,1.1001100110011,2.3
2009,University of Glasgow Terrier Team,uogTrdphP,19,1000,734,266,1.20918984280532,2.86021505376344
2009,University of Glasgow Terrier Team,uogTrdphP,20,1000,866,134,1.08225108225108,2.31034482758621
2009,University of Glasgow Terrier Team,uogTrdphP,21,1000,929,71,1.04058272632674,2.21875
2009,University of Glasgow Terrier Team,uogTrdphP,22,1000,932,68,1.03626943005181,2.06060606060606
2009,University of Glasgow Terrier Team,uogTrdphP,23,1000,938,62,1.03305785123967,2.06666666666667
2009,University of Glasgow Terrier Team,uogTrdphP,24,1000,773,227,1.14810562571757,2.31632653061225
2009,University of Glasgow Terrier Team,uogTrdphP,25,1000,748,252,1.19047619047619,2.73913043478261
2009,University of Glasgow Terrier Team,uogTrdphP,26,1000,834,166,1.10253583241455,2.27397260273973
2009,University of Glasgow Terrier Team,uogTrdphP,27,1000,881,119,1.06951871657754,2.2037037037037
2009,University of Glasgow Terrier Team,uogTrdphP,28,1000,614,386,1.50375939849624,7.56862745098039
2009,University of Glasgow Terrier Team,uogTrdphP,29,1000,886,114,1.07181136120043,2.42553191489362
2009,University of Glasgow Terrier Team,uogTrdphP,30,1000,769,231,1.14942528735632,2.28712871287129
2009,University of Glasgow Terrier Team,uogTrdphP,31,1000,792,208,1.13895216400911,2.41860465116279
2009,University of Glasgow Terrier Team,uogTrdphP,32,1000,822,178,1.12994350282486,2.82539682539683
2009,University of Glasgow Terrier Team,uogTrdphP,33,1000,955,45,1.02669404517454,2.36842105263158
2009,University of Glasgow Terrier Team,uogTrdphP,34,1000,944,56,1.04058272632674,3.29411764705882
2009,University of Glasgow Terrier Team,uogTrdphP,35,1000,675,325,1.25156445556946,2.62096774193548
2009,University of Glasgow Terrier Team,uogTrdphP,36,1000,875,125,1.09170305676856,3.04878048780488
2009,University of Glasgow Terrier Team,uogTrdphP,37,1000,863,137,1.08695652173913,2.40350877192982
2009,University of Glasgow Terrier Team,uogTrdphP,38,1000,890,110,1.06951871657754,2.44444444444444
2009,University of Glasgow Terrier Team,uogTrdphP,39,1000,940,60,1.03305785123967,2.14285714285714
2009,University of Glasgow Terrier Team,uogTrdphP,40,1000,309,691,2.63157894736842,9.73239436619718
2009,University of Glasgow Terrier Team,uogTrdphP,41,1000,761,239,1.16550116550117,2.4639175257732
2009,University of Glasgow Terrier Team,uogTrdphP,42,1000,901,99,1.06723585912487,2.75
2009,University of Glasgow Terrier Team,uogTrdphP,43,1000,889,111,1.06723585912487,2.3125
2009,University of Glasgow Terrier Team,uogTrdphP,44,1000,784,216,1.19331742243437,4
2009,University of Glasgow Terrier Team,uogTrdphP,45,1000,896,104,1.06157112526539,2.26086956521739
2009,University of Glasgow Terrier Team,uogTrdphP,46,1000,680,320,1.21506682867558,2.23776223776224
2009,University of Glasgow Terrier Team,uogTrdphP,47,1000,874,126,1.08342361863489,2.57142857142857
2009,University of Glasgow Terrier Team,uogTrdphP,48,1000,878,122,1.07411385606874,2.30188679245283
2009,University of Glasgow Terrier Team,uogTrdphP,49,1000,817,183,1.11731843575419,2.34615384615385
2009,University of Glasgow Terrier Team,uogTrdphP,50,1000,854,146,1.10132158590308,2.7037037037037
2009,University of Amsterdam (De Rijke),uvaee,1,1000,852,148,1.10619469026549,2.84615384615385
2009,University of Amsterdam (De Rijke),uvaee,2,1000,942,58,1.03626943005181,2.52173913043478
2009,University of Amsterdam (De Rijke),uvaee,3,1000,906,94,1.05596620908131,2.29268292682927
2009,University of Amsterdam (De Rijke),uvaee,4,1000,851,149,1.12612612612613,4.02702702702703
2009,University of Amsterdam (De Rijke),uvaee,5,1000,897,103,1.05932203389831,2.19148936170213
2009,University of Amsterdam (De Rijke),uvaee,6,1000,827,173,1.10619469026549,2.24675324675325
2009,University of Amsterdam (De Rijke),uvaee,7,1000,867,133,1.09170305676856,2.71428571428571
2009,University of Amsterdam (De Rijke),uvaee,8,1000,906,94,1.05932203389831,2.47368421052632
2009,University of Amsterdam (De Rijke),uvaee,9,1000,939,61,1.03842159916926,2.54166666666667
2009,University of Amsterdam (De Rijke),uvaee,10,1000,888,112,1.06269925611052,2.11320754716981
2009,University of Amsterdam (De Rijke),uvaee,11,1000,856,144,1.10253583241455,2.82352941176471
2009,University of Amsterdam (De Rijke),uvaee,12,1000,914,86,1.05042016806723,2.26315789473684
2009,University of Amsterdam (De Rijke),uvaee,13,1000,747,253,1.26262626262626,5.62222222222222
2009,University of Amsterdam (De Rijke),uvaee,14,1000,817,183,1.15340253748558,3.66
2009,University of Amsterdam (De Rijke),uvaee,15,1000,901,99,1.05708245243129,2.2
2009,University of Amsterdam (De Rijke),uvaee,16,1000,921,79,1.04275286757039,2.07894736842105
2009,University of Amsterdam (De Rijke),uvaee,17,1000,966,34,1.01936799184506,2.26666666666667
2009,University of Amsterdam (De Rijke),uvaee,18,1000,934,66,1.0351966873706,2.0625
2009,University of Amsterdam (De Rijke),uvaee,19,1000,908,92,1.06044538706257,2.62857142857143
2009,University of Amsterdam (De Rijke),uvaee,20,1000,909,91,1.06382978723404,2.93548387096774
2009,University of Amsterdam (De Rijke),uvaee,21,1000,938,62,1.04166666666667,2.81818181818182
2009,University of Amsterdam (De Rijke),uvaee,22,1000,936,64,1.0351966873706,2.13333333333333
2009,University of Amsterdam (De Rijke),uvaee,23,1000,929,71,1.04166666666667,2.29032258064516
2009,University of Amsterdam (De Rijke),uvaee,24,1000,863,137,1.08108108108108,2.20967741935484
2009,University of Amsterdam (De Rijke),uvaee,25,1000,881,119,1.085776330076,2.975
2009,University of Amsterdam (De Rijke),uvaee,26,1000,894,106,1.06269925611052,2.25531914893617
2009,University of Amsterdam (De Rijke),uvaee,27,1000,953,47,1.02669404517454,2.23809523809524
2009,University of Amsterdam (De Rijke),uvaee,28,1000,611,389,1.46842878120411,5.55714285714286
2009,University of Amsterdam (De Rijke),uvaee,29,1000,911,89,1.05932203389831,2.6969696969697
2009,University of Amsterdam (De Rijke),uvaee,30,1000,935,65,1.03734439834025,2.24137931034483
2009,University of Amsterdam (De Rijke),uvaee,31,1000,891,109,1.07066381156317,2.53488372093023
2009,University of Amsterdam (De Rijke),uvaee,32,1000,853,147,1.08695652173913,2.19402985074627
2009,University of Amsterdam (De Rijke),uvaee,33,1000,971,29,1.01626016260163,2.23076923076923
2009,University of Amsterdam (De Rijke),uvaee,34,1000,924,76,1.04384133611691,2.23529411764706
2009,University of Amsterdam (De Rijke),uvaee,35,1000,869,131,1.07991360691145,2.29824561403509
2009,University of Amsterdam (De Rijke),uvaee,36,1000,932,68,1.03950103950104,2.26666666666667
2009,University of Amsterdam (De Rijke),uvaee,37,1000,890,110,1.06723585912487,2.34042553191489
2009,University of Amsterdam (De Rijke),uvaee,38,1000,922,78,1.04275286757039,2.10810810810811
2009,University of Amsterdam (De Rijke),uvaee,39,1000,924,76,1.03950103950104,2
2009,University of Amsterdam (De Rijke),uvaee,40,1000,529,471,1.46627565982405,3.07843137254902
2009,University of Amsterdam (De Rijke),uvaee,41,1000,898,102,1.06723585912487,2.61538461538462
2009,University of Amsterdam (De Rijke),uvaee,42,1000,905,95,1.06382978723404,2.71428571428571
2009,University of Amsterdam (De Rijke),uvaee,43,1000,934,66,1.04166666666667,2.53846153846154
2009,University of Amsterdam (De Rijke),uvaee,44,1000,841,159,1.13250283125708,3.78571428571429
2009,University of Amsterdam (De Rijke),uvaee,45,1000,959,41,1.02564102564103,2.5625
2009,University of Amsterdam (De Rijke),uvaee,46,1000,803,197,1.11982082866741,2.18888888888889
2009,University of Amsterdam (De Rijke),uvaee,47,1000,935,65,1.04275286757039,2.70833333333333
2009,University of Amsterdam (De Rijke),uvaee,48,1000,874,126,1.08225108225108,2.52
2009,University of Amsterdam (De Rijke),uvaee,49,1000,891,109,1.06837606837607,2.42222222222222
2009,University of Amsterdam (De Rijke),uvaee,50,1000,932,68,1.04166666666667,2.42857142857143
2009,University of Amsterdam (De Rijke),uvamrf,1,1000,669,331,1.27713920817369,2.90350877192982
2009,University of Amsterdam (De Rijke),uvamrf,2,1000,927,73,1.04493207941484,2.43333333333333
2009,University of Amsterdam (De Rijke),uvamrf,3,1000,778,222,1.16550116550117,2.775
2009,University of Amsterdam (De Rijke),uvamrf,4,1000,866,134,1.11607142857143,4.46666666666667
2009,University of Amsterdam (De Rijke),uvamrf,5,1000,811,189,1.12612612612613,2.45454545454545
2009,University of Amsterdam (De Rijke),uvamrf,6,1000,813,187,1.11731843575419,2.28048780487805
2009,University of Amsterdam (De Rijke),uvamrf,7,1000,620,380,1.36612021857924,3.39285714285714
2009,University of Amsterdam (De Rijke),uvamrf,8,1000,831,169,1.12739571589628,3.01785714285714
2009,University of Amsterdam (De Rijke),uvamrf,9,1000,929,71,1.0482180293501,2.84
2009,University of Amsterdam (De Rijke),uvamrf,10,1000,917,83,1.04493207941484,2.075
2009,University of Amsterdam (De Rijke),uvamrf,11,1000,811,189,1.15074798619102,3.25862068965517
2009,University of Amsterdam (De Rijke),uvamrf,12,1000,748,252,1.16550116550117,2.29090909090909
2009,University of Amsterdam (De Rijke),uvamrf,13,1000,735,265,1.27226463104326,5.19607843137255
2009,University of Amsterdam (De Rijke),uvamrf,14,1000,825,175,1.12612612612613,2.77777777777778
2009,University of Amsterdam (De Rijke),uvamrf,15,1000,936,64,1.03950103950104,2.46153846153846
2009,University of Amsterdam (De Rijke),uvamrf,16,1000,872,128,1.08225108225108,2.46153846153846
2009,University of Amsterdam (De Rijke),uvamrf,17,1000,968,32,1.0183299389002,2.28571428571429
2009,University of Amsterdam (De Rijke),uvamrf,18,1000,920,80,1.04712041884817,2.28571428571429
2009,University of Amsterdam (De Rijke),uvamrf,19,1000,907,93,1.05932203389831,2.51351351351351
2009,University of Amsterdam (De Rijke),uvamrf,20,1000,904,96,1.06723585912487,2.90909090909091
2009,University of Amsterdam (De Rijke),uvamrf,21,1000,882,118,1.07411385606874,2.40816326530612
2009,University of Amsterdam (De Rijke),uvamrf,22,1000,957,43,1.02354145342886,2.15
2009,University of Amsterdam (De Rijke),uvamrf,23,1000,840,160,1.09769484083425,2.25352112676056
2009,University of Amsterdam (De Rijke),uvamrf,24,1000,859,141,1.08813928182807,2.35
2009,University of Amsterdam (De Rijke),uvamrf,25,1000,841,159,1.11111111111111,2.69491525423729
2009,University of Amsterdam (De Rijke),uvamrf,26,1000,912,88,1.05042016806723,2.2
2009,University of Amsterdam (De Rijke),uvamrf,27,1000,936,64,1.03626943005181,2.20689655172414
2009,University of Amsterdam (De Rijke),uvamrf,28,1000,897,103,1.06496272630458,2.45238095238095
2009,University of Amsterdam (De Rijke),uvamrf,29,1000,930,70,1.03734439834025,2.05882352941176
2009,University of Amsterdam (De Rijke),uvamrf,30,1000,890,110,1.06609808102345,2.29166666666667
2009,University of Amsterdam (De Rijke),uvamrf,31,1000,851,149,1.09529025191676,2.40322580645161
2009,University of Amsterdam (De Rijke),uvamrf,32,1000,765,235,1.16686114352392,2.55434782608696
2009,University of Amsterdam (De Rijke),uvamrf,33,1000,955,45,1.02669404517454,2.36842105263158
2009,University of Amsterdam (De Rijke),uvamrf,34,1000,972,28,1.01522842639594,2.15384615384615
2009,University of Amsterdam (De Rijke),uvamrf,35,1000,864,136,1.08932461873638,2.51851851851852
2009,University of Amsterdam (De Rijke),uvamrf,36,1000,940,60,1.03412616339193,2.22222222222222
2009,University of Amsterdam (De Rijke),uvamrf,37,1000,875,125,1.07642626480086,2.31481481481482
2009,University of Amsterdam (De Rijke),uvamrf,38,1000,930,70,1.04275286757039,2.41379310344828
2009,University of Amsterdam (De Rijke),uvamrf,39,1000,954,46,1.02354145342886,2
2009,University of Amsterdam (De Rijke),uvamrf,40,1000,529,471,1.46627565982405,3.07843137254902
2009,University of Amsterdam (De Rijke),uvamrf,41,1000,587,413,1.38888888888889,3.10526315789474
2009,University of Amsterdam (De Rijke),uvamrf,42,1000,907,93,1.06157112526539,2.65714285714286
2009,University of Amsterdam (De Rijke),uvamrf,43,1000,931,69,1.04712041884817,2.875
2009,University of Amsterdam (De Rijke),uvamrf,44,1000,778,222,1.19760479041916,3.89473684210526
2009,University of Amsterdam (De Rijke),uvamrf,45,1000,943,57,1.03305785123967,2.28
2009,University of Amsterdam (De Rijke),uvamrf,46,1000,721,279,1.17508813160987,2.14615384615385
2009,University of Amsterdam (De Rijke),uvamrf,47,1000,930,70,1.04602510460251,2.69230769230769
2009,University of Amsterdam (De Rijke),uvamrf,48,1000,907,93,1.06609808102345,3
2009,University of Amsterdam (De Rijke),uvamrf,49,1000,911,89,1.06044538706257,2.78125
2009,University of Amsterdam (De Rijke),uvamrf,50,1000,937,63,1.04384133611691,3
2009,University of Amsterdam (De Rijke),uvamrftop,1,1000,1000,0,1,
2009,University of Amsterdam (De Rijke),uvamrftop,2,1000,1000,0,1,
2009,University of Amsterdam (De Rijke),uvamrftop,3,1000,1000,0,1,
2009,University of Amsterdam (De Rijke),uvamrftop,4,1000,1000,0,1,
2009,University of Amsterdam (De Rijke),uvamrftop,5,1000,1000,0,1,
2009,University of Amsterdam (De Rijke),uvamrftop,6,1000,1000,0,1,
2009,University of Amsterdam (De Rijke),uvamrftop,7,1000,1000,0,1,
2009,University of Amsterdam (De Rijke),uvamrftop,8,1000,1000,0,1,
2009,University of Amsterdam (De Rijke),uvamrftop,9,1000,1000,0,1,
2009,University of Amsterdam (De Rijke),uvamrftop,10,1000,1000,0,1,
2009,University of Amsterdam (De Rijke),uvamrftop,11,1000,1000,0,1,
2009,University of Amsterdam (De Rijke),uvamrftop,12,1000,1000,0,1,
2009,University of Amsterdam (De Rijke),uvamrftop,13,1000,1000,0,1,
2009,University of Amsterdam (De Rijke),uvamrftop,14,1000,1000,0,1,
2009,University of Amsterdam (De Rijke),uvamrftop,15,1000,1000,0,1,
2009,University of Amsterdam (De Rijke),uvamrftop,16,1000,1000,0,1,
2009,University of Amsterdam (De Rijke),uvamrftop,17,1000,1000,0,1,
2009,University of Amsterdam (De Rijke),uvamrftop,18,1000,1000,0,1,
2009,University of Amsterdam (De Rijke),uvamrftop,19,1000,1000,0,1,
2009,University of Amsterdam (De Rijke),uvamrftop,20,1000,1000,0,1,
2009,University of Amsterdam (De Rijke),uvamrftop,21,1000,1000,0,1,
2009,University of Amsterdam (De Rijke),uvamrftop,22,1000,1000,0,1,
2009,University of Amsterdam (De Rijke),uvamrftop,23,1000,1000,0,1,
2009,University of Amsterdam (De Rijke),uvamrftop,24,1000,1000,0,1,
2009,University of Amsterdam (De Rijke),uvamrftop,25,1000,1000,0,1,
2009,University of Amsterdam (De Rijke),uvamrftop,26,1000,1000,0,1,
2009,University of Amsterdam (De Rijke),uvamrftop,27,1000,1000,0,1,
2009,University of Amsterdam (De Rijke),uvamrftop,28,1000,1000,0,1,
2009,University of Amsterdam (De Rijke),uvamrftop,29,1000,1000,0,1,
2009,University of Amsterdam (De Rijke),uvamrftop,30,1000,1000,0,1,
2009,University of Amsterdam (De Rijke),uvamrftop,31,1000,1000,0,1,
2009,University of Amsterdam (De Rijke),uvamrftop,32,1000,1000,0,1,
2009,University of Amsterdam (De Rijke),uvamrftop,33,1000,1000,0,1,
2009,University of Amsterdam (De Rijke),uvamrftop,34,1000,1000,0,1,
2009,University of Amsterdam (De Rijke),uvamrftop,35,1000,1000,0,1,
2009,University of Amsterdam (De Rijke),uvamrftop,36,1000,1000,0,1,
2009,University of Amsterdam (De Rijke),uvamrftop,37,1000,1000,0,1,
2009,University of Amsterdam (De Rijke),uvamrftop,38,1000,1000,0,1,
2009,University of Amsterdam (De Rijke),uvamrftop,39,1000,1000,0,1,
2009,University of Amsterdam (De Rijke),uvamrftop,40,1000,1000,0,1,
2009,University of Amsterdam (De Rijke),uvamrftop,41,1000,1000,0,1,
2009,University of Amsterdam (De Rijke),uvamrftop,42,1000,1000,0,1,
2009,University of Amsterdam (De Rijke),uvamrftop,43,1000,1000,0,1,
2009,University of Amsterdam (De Rijke),uvamrftop,44,1000,1000,0,1,
2009,University of Amsterdam (De Rijke),uvamrftop,45,1000,1000,0,1,
2009,University of Amsterdam (De Rijke),uvamrftop,46,1000,1000,0,1,
2009,University of Amsterdam (De Rijke),uvamrftop,47,1000,1000,0,1,
2009,University of Amsterdam (De Rijke),uvamrftop,48,1000,1000,0,1,
2009,University of Amsterdam (De Rijke),uvamrftop,49,1000,1000,0,1,
2009,University of Amsterdam (De Rijke),uvamrftop,50,1000,1000,0,1,
2009,University of Waterloo,watprf,1,1000,646,354,1.36798905608755,4.16470588235294
2009,University of Waterloo,watprf,2,1000,729,271,1.23456790123457,3.34567901234568
2009,University of Waterloo,watprf,3,1000,550,450,1.47058823529412,3.46153846153846
2009,University of Waterloo,watprf,4,1000,718,282,1.23152709359606,3
2009,University of Waterloo,watprf,5,1000,644,356,1.34048257372654,3.49019607843137
2009,University of Waterloo,watprf,6,1000,503,497,1.54083204930663,3.4041095890411
2009,University of Waterloo,watprf,7,1000,665,335,1.34408602150538,4.24050632911392
2009,University of Waterloo,watprf,8,1000,569,431,1.3986013986014,2.95205479452055
2009,University of Waterloo,watprf,9,1000,493,507,1.67785234899329,4.92233009708738
2009,University of Waterloo,watprf,10,1000,580,420,1.44717800289436,3.78378378378378
2009,University of Waterloo,watprf,11,1000,653,347,1.27064803049555,2.58955223880597
2009,University of Waterloo,watprf,12,1000,773,227,1.15207373271889,2.38947368421053
2009,University of Waterloo,watprf,13,1000,902,98,1.05263157894737,2.04166666666667
2009,University of Waterloo,watprf,14,1000,807,193,1.11856823266219,2.2183908045977
2009,University of Waterloo,watprf,15,1000,889,111,1.06609808102345,2.26530612244898
2009,University of Waterloo,watprf,16,1000,522,478,1.47275405007364,3.04458598726115
2009,University of Waterloo,watprf,17,1000,521,479,1.48809523809524,3.17218543046358
2009,University of Waterloo,watprf,18,1000,603,397,1.33155792276964,2.68243243243243
2009,University of Waterloo,watprf,19,1000,559,441,1.48809523809524,3.90265486725664
2009,University of Waterloo,watprf,20,1000,851,149,1.085776330076,2.12857142857143
2009,University of Waterloo,watprf,21,1000,704,296,1.22100122100122,2.57391304347826
2009,University of Waterloo,watprf,22,1000,828,172,1.11358574610245,2.45714285714286
2009,University of Waterloo,watprf,23,1000,715,285,1.21212121212121,2.59090909090909
2009,University of Waterloo,watprf,24,1000,710,290,1.24223602484472,3.05263157894737
2009,University of Waterloo,watprf,25,1000,566,434,1.42045454545455,3.14492753623188
2009,University of Waterloo,watprf,26,1000,382,618,2.01207243460765,5.37391304347826
2009,University of Waterloo,watprf,27,1000,599,401,1.43266475644699,4.05050505050505
2009,University of Waterloo,watprf,28,1000,829,171,1.11607142857143,2.55223880597015
2009,University of Waterloo,watprf,29,1000,717,283,1.23304562268804,3.01063829787234
2009,University of Waterloo,watprf,30,1000,625,375,1.31233595800525,2.73722627737226
2009,University of Waterloo,watprf,31,1000,827,173,1.11482720178372,2.47142857142857
2009,University of Waterloo,watprf,32,1000,615,385,1.3531799729364,3.10483870967742
2009,University of Waterloo,watprf,33,1000,732,268,1.23609394313968,3.48051948051948
2009,University of Waterloo,watprf,34,1000,616,384,1.40646976090014,4.0421052631579
2009,University of Waterloo,watprf,35,1000,617,383,1.40252454417952,3.98958333333333
2009,University of Waterloo,watprf,36,1000,617,383,1.3351134846462,2.90151515151515
2009,University of Waterloo,watprf,37,1000,743,257,1.18764845605701,2.5959595959596
2009,University of Waterloo,watprf,38,1000,793,207,1.13378684807256,2.32584269662921
2009,University of Waterloo,watprf,39,1000,614,386,1.32978723404255,2.79710144927536
2009,University of Waterloo,watprf,40,1000,741,259,1.19331742243437,2.67010309278351
2009,University of Waterloo,watprf,41,1000,658,342,1.28369704749679,2.82644628099174
2009,University of Waterloo,watprf,42,1000,713,287,1.22850122850123,2.84158415841584
2009,University of Waterloo,watprf,43,1000,839,161,1.10741971207087,2.515625
2009,University of Waterloo,watprf,44,1000,337,663,2.10526315789474,4.80434782608696
2009,University of Waterloo,watprf,45,1000,736,264,1.194743130227,2.61386138613861
2009,University of Waterloo,watprf,46,1000,809,191,1.1454753722795,2.984375
2009,University of Waterloo,watprf,47,1000,700,300,1.27713920817369,3.6144578313253
2009,University of Waterloo,watprf,48,1000,734,266,1.19760479041916,2.63366336633663
2009,University of Waterloo,watprf,49,1000,589,411,1.40252454417952,3.31451612903226
2009,University of Waterloo,watprf,50,1000,419,581,1.78571428571429,4.12056737588653
2009,University of Waterloo,watrrfw,1,1000,998,2,1.001001001001,2
2009,University of Waterloo,watrrfw,2,1000,1000,0,1,
2009,University of Waterloo,watrrfw,3,1000,1000,0,1,
2009,University of Waterloo,watrrfw,4,1000,1000,0,1,
2009,University of Waterloo,watrrfw,5,1000,998,2,1.001001001001,2
2009,University of Waterloo,watrrfw,6,1000,1000,0,1,
2009,University of Waterloo,watrrfw,7,1000,1000,0,1,
2009,University of Waterloo,watrrfw,8,1000,1000,0,1,
2009,University of Waterloo,watrrfw,9,1000,996,4,1.00200400801603,2
2009,University of Waterloo,watrrfw,10,1000,996,4,1.00200400801603,2
2009,University of Waterloo,watrrfw,11,1000,998,2,1.001001001001,2
2009,University of Waterloo,watrrfw,12,1000,1000,0,1,
2009,University of Waterloo,watrrfw,13,1000,1000,0,1,
2009,University of Waterloo,watrrfw,14,1000,996,4,1.00200400801603,2
2009,University of Waterloo,watrrfw,15,1000,998,2,1.001001001001,2
2009,University of Waterloo,watrrfw,16,1000,998,2,1.001001001001,2
2009,University of Waterloo,watrrfw,17,1000,996,4,1.00200400801603,2
2009,University of Waterloo,watrrfw,18,1000,1000,0,1,
2009,University of Waterloo,watrrfw,19,1000,998,2,1.001001001001,2
2009,University of Waterloo,watrrfw,20,1000,998,2,1.001001001001,2
2009,University of Waterloo,watrrfw,21,1000,994,6,1.00300902708124,2
2009,University of Waterloo,watrrfw,22,1000,1000,0,1,
2009,University of Waterloo,watrrfw,23,1000,1000,0,1,
2009,University of Waterloo,watrrfw,24,1000,998,2,1.001001001001,2
2009,University of Waterloo,watrrfw,25,1000,998,2,1.001001001001,2
2009,University of Waterloo,watrrfw,26,1000,998,2,1.001001001001,2
2009,University of Waterloo,watrrfw,27,1000,1000,0,1,
2009,University of Waterloo,watrrfw,28,1000,996,4,1.00200400801603,2
2009,University of Waterloo,watrrfw,29,1000,1000,0,1,
2009,University of Waterloo,watrrfw,30,1000,1000,0,1,
2009,University of Waterloo,watrrfw,31,1000,998,2,1.001001001001,2
2009,University of Waterloo,watrrfw,32,1000,1000,0,1,
2009,University of Waterloo,watrrfw,33,1000,998,2,1.001001001001,2
2009,University of Waterloo,watrrfw,34,1000,996,4,1.00200400801603,2
2009,University of Waterloo,watrrfw,35,1000,998,2,1.001001001001,2
2009,University of Waterloo,watrrfw,36,1000,998,2,1.001001001001,2
2009,University of Waterloo,watrrfw,37,1000,996,4,1.00200400801603,2
2009,University of Waterloo,watrrfw,38,1000,1000,0,1,
2009,University of Waterloo,watrrfw,39,1000,1000,0,1,
2009,University of Waterloo,watrrfw,40,1000,1000,0,1,
2009,University of Waterloo,watrrfw,41,1000,1000,0,1,
2009,University of Waterloo,watrrfw,42,1000,998,2,1.001001001001,2
2009,University of Waterloo,watrrfw,43,1000,1000,0,1,
2009,University of Waterloo,watrrfw,44,1000,1000,0,1,
2009,University of Waterloo,watrrfw,45,1000,1000,0,1,
2009,University of Waterloo,watrrfw,46,1000,1000,0,1,
2009,University of Waterloo,watrrfw,47,1000,998,2,1.001001001001,2
2009,University of Waterloo,watrrfw,48,1000,1000,0,1,
2009,University of Waterloo,watrrfw,49,1000,1000,0,1,
2009,University of Waterloo,watrrfw,50,1000,998,2,1.001001001001,2
2009,University of Waterloo,watwp,1,1000,621,379,1.31061598951507,2.66901408450704
2009,University of Waterloo,watwp,2,1000,849,151,1.08813928182807,2.15714285714286
2009,University of Waterloo,watwp,3,1000,779,221,1.13378684807256,2.14563106796117
2009,University of Waterloo,watwp,4,1000,641,359,1.2853470437018,2.62043795620438
2009,University of Waterloo,watwp,5,1000,811,189,1.11111111111111,2.12359550561798
2009,University of Waterloo,watwp,6,1000,760,240,1.14678899082569,2.14285714285714
2009,University of Waterloo,watwp,7,1000,789,211,1.13122171945701,2.22105263157895
2009,University of Waterloo,watwp,8,1000,767,233,1.15074798619102,2.2843137254902
2009,University of Waterloo,watwp,9,1000,685,315,1.23915737298637,2.58196721311475
2009,University of Waterloo,watwp,10,1000,734,266,1.17233294255569,2.23529411764706
2009,University of Waterloo,watwp,11,1000,657,343,1.27713920817369,2.72222222222222
2009,University of Waterloo,watwp,12,1000,743,257,1.15473441108545,2.08943089430894
2009,University of Waterloo,watwp,13,1000,288,712,1.89035916824197,2.95435684647303
2009,University of Waterloo,watwp,14,1000,573,427,1.31926121372032,2.30810810810811
2009,University of Waterloo,watwp,15,1000,824,176,1.10132158590308,2.0952380952381
2009,University of Waterloo,watwp,16,1000,810,190,1.11358574610245,2.15909090909091
2009,University of Waterloo,watwp,17,1000,783,217,1.15606936416185,2.64634146341463
2009,University of Waterloo,watwp,18,1000,657,343,1.24843945068664,2.38194444444444
2009,University of Waterloo,watwp,19,1000,701,299,1.20481927710843,2.31782945736434
2009,University of Waterloo,watwp,20,1000,517,483,1.41442715700141,2.5421052631579
2009,University of Waterloo,watwp,21,1000,718,282,1.19760479041916,2.41025641025641
2009,University of Waterloo,watwp,22,1000,860,140,1.07758620689655,2.05882352941176
2009,University of Waterloo,watwp,23,1000,633,367,1.28865979381443,2.56643356643357
2009,University of Waterloo,watwp,24,1000,681,319,1.21654501216545,2.26241134751773
2009,University of Waterloo,watwp,25,1000,710,290,1.18764845605701,2.1969696969697
2009,University of Waterloo,watwp,26,1000,726,274,1.18203309692671,2.28333333333333
2009,University of Waterloo,watwp,27,1000,736,264,1.16959064327485,2.21848739495798
2009,University of Waterloo,watwp,28,1000,540,460,1.48809523809524,3.48484848484849
2009,University of Waterloo,watwp,29,1000,778,222,1.13636363636364,2.17647058823529
2009,University of Waterloo,watwp,30,1000,812,188,1.11111111111111,2.13636363636364
2009,University of Waterloo,watwp,31,1000,433,567,1.51975683890578,2.52
2009,University of Waterloo,watwp,32,1000,668,332,1.23915737298637,2.38848920863309
2009,University of Waterloo,watwp,33,1000,678,322,1.21802679658953,2.25174825174825
2009,University of Waterloo,watwp,34,1000,783,217,1.13636363636364,2.23711340206186
2009,University of Waterloo,watwp,35,1000,721,279,1.22249388753056,2.87628865979381
2009,University of Waterloo,watwp,36,1000,713,287,1.18343195266272,2.17424242424242
2009,University of Waterloo,watwp,37,1000,709,291,1.18906064209275,2.20454545454545
2009,University of Waterloo,watwp,38,1000,714,286,1.18906064209275,2.25196850393701
2009,University of Waterloo,watwp,39,1000,782,218,1.12739571589628,2.07619047619048
2009,University of Waterloo,watwp,40,1000,5,995,25.6410256410256,29.2647058823529
2009,University of Waterloo,watwp,41,1000,811,189,1.10987791342952,2.1
2009,University of Waterloo,watwp,42,1000,834,166,1.09529025191676,2.10126582278481
2009,University of Waterloo,watwp,43,1000,826,174,1.10497237569061,2.20253164556962
2009,University of Waterloo,watwp,44,1000,633,367,1.28700128700129,2.54861111111111
2009,University of Waterloo,watwp,45,1000,815,185,1.10864745011086,2.1264367816092
2009,University of Waterloo,watwp,46,1000,617,383,1.34228187919463,2.9921875
2009,University of Waterloo,watwp,47,1000,738,262,1.16959064327485,2.23931623931624
2009,University of Waterloo,watwp,48,1000,782,218,1.14025085518814,2.29473684210526
2009,University of Waterloo,watwp,49,1000,637,363,1.2853470437018,2.57446808510638
2009,University of Waterloo,watwp,50,1000,731,269,1.17508813160987,2.24166666666667
2009,Yahoo! Research,yhooumd09BFM,1,1000,967,33,1.01729399796541,2.0625
2009,Yahoo! Research,yhooumd09BFM,2,1000,977,23,1.01317122593718,2.3
2009,Yahoo! Research,yhooumd09BFM,3,1000,896,104,1.07066381156317,2.73684210526316
2009,Yahoo! Research,yhooumd09BFM,4,1000,898,102,1.08813928182807,4.85714285714286
2009,Yahoo! Research,yhooumd09BFM,5,1000,966,34,1.01729399796541,2
2009,Yahoo! Research,yhooumd09BFM,6,1000,957,43,1.02249488752556,2.04761904761905
2009,Yahoo! Research,yhooumd09BFM,7,1000,903,97,1.06837606837607,2.93939393939394
2009,Yahoo! Research,yhooumd09BFM,8,1000,970,30,1.01626016260163,2.14285714285714
2009,Yahoo! Research,yhooumd09BFM,9,1000,967,33,1.02145045965271,2.75
2009,Yahoo! Research,yhooumd09BFM,10,1000,986,14,1.00806451612903,2.33333333333333
2009,Yahoo! Research,yhooumd09BFM,11,1000,966,34,1.01936799184506,2.26666666666667
2009,Yahoo! Research,yhooumd09BFM,12,1000,867,133,1.12107623318386,5.32
2009,Yahoo! Research,yhooumd09BFM,13,1000,821,179,1.16279069767442,4.58974358974359
2009,Yahoo! Research,yhooumd09BFM,14,1000,955,45,1.02354145342886,2.04545454545455
2009,Yahoo! Research,yhooumd09BFM,15,1000,957,43,1.02774922918808,2.6875
2009,Yahoo! Research,yhooumd09BFM,16,1000,982,18,1.00908173562059,2
2009,Yahoo! Research,yhooumd09BFM,17,1000,981,19,1.01010101010101,2.11111111111111
2009,Yahoo! Research,yhooumd09BFM,18,1000,982,18,1.00908173562059,2
2009,Yahoo! Research,yhooumd09BFM,19,1000,967,33,1.02145045965271,2.75
2009,Yahoo! Research,yhooumd09BFM,20,1000,986,14,1.00704934541793,2
2009,Yahoo! Research,yhooumd09BFM,21,1000,962,38,1.01936799184506,2
2009,Yahoo! Research,yhooumd09BFM,22,1000,982,18,1.01010101010101,2.25
2009,Yahoo! Research,yhooumd09BFM,23,1000,931,69,1.04384133611691,2.55555555555556
2009,Yahoo! Research,yhooumd09BFM,24,1000,871,129,1.09409190371991,3
2009,Yahoo! Research,yhooumd09BFM,25,1000,954,46,1.02669404517454,2.3
2009,Yahoo! Research,yhooumd09BFM,26,1000,979,21,1.01112234580384,2.1
2009,Yahoo! Research,yhooumd09BFM,27,1000,971,29,1.01626016260163,2.23076923076923
2009,Yahoo! Research,yhooumd09BFM,28,1000,916,84,1.05820105820106,2.89655172413793
2009,Yahoo! Research,yhooumd09BFM,29,1000,983,17,1.00908173562059,2.125
2009,Yahoo! Research,yhooumd09BFM,30,1000,984,16,1.00806451612903,2
2009,Yahoo! Research,yhooumd09BFM,31,1000,920,80,1.04602510460251,2.22222222222222
2009,Yahoo! Research,yhooumd09BFM,32,1000,926,74,1.04493207941484,2.38709677419355
2009,Yahoo! Research,yhooumd09BFM,33,1000,973,27,1.01522842639594,2.25
2009,Yahoo! Research,yhooumd09BFM,34,1000,933,67,1.04058272632674,2.39285714285714
2009,Yahoo! Research,yhooumd09BFM,35,1000,970,30,1.01626016260163,2.14285714285714
2009,Yahoo! Research,yhooumd09BFM,36,1000,950,50,1.03412616339193,2.94117647058824
2009,Yahoo! Research,yhooumd09BFM,37,1000,976,24,1.01317122593718,2.18181818181818
2009,Yahoo! Research,yhooumd09BFM,38,1000,966,34,1.01936799184506,2.26666666666667
2009,Yahoo! Research,yhooumd09BFM,39,1000,969,31,1.01729399796541,2.21428571428571
2009,Yahoo! Research,yhooumd09BFM,40,1000,806,194,1.13895216400911,2.69444444444444
2009,Yahoo! Research,yhooumd09BFM,41,1000,963,37,1.02354145342886,2.64285714285714
2009,Yahoo! Research,yhooumd09BFM,42,1000,959,41,1.02669404517454,2.73333333333333
2009,Yahoo! Research,yhooumd09BFM,43,1000,971,29,1.01936799184506,2.9
2009,Yahoo! Research,yhooumd09BFM,44,1000,844,156,1.11856823266219,3.12
2009,Yahoo! Research,yhooumd09BFM,45,1000,978,22,1.01112234580384,2
2009,Yahoo! Research,yhooumd09BFM,46,1000,967,33,1.02249488752556,3
2009,Yahoo! Research,yhooumd09BFM,47,1000,982,18,1.01010101010101,2.25
2009,Yahoo! Research,yhooumd09BFM,48,1000,962,38,1.02354145342886,2.53333333333333
2009,Yahoo! Research,yhooumd09BFM,49,1000,926,74,1.0482180293501,2.64285714285714
2009,Yahoo! Research,yhooumd09BFM,50,1000,954,46,1.02669404517454,2.3
2009,Yahoo! Research,yhooumd09BGC,1,1000,966,34,1.0183299389002,2.125
2009,Yahoo! Research,yhooumd09BGC,2,1000,927,73,1.04384133611691,2.35483870967742
2009,Yahoo! Research,yhooumd09BGC,3,1000,811,189,1.15874855156431,3.63461538461538
2009,Yahoo! Research,yhooumd09BGC,4,1000,847,153,1.12485939257593,3.64285714285714
2009,Yahoo! Research,yhooumd09BGC,5,1000,879,121,1.07296137339056,2.28301886792453
2009,Yahoo! Research,yhooumd09BGC,6,1000,790,210,1.13507377979569,2.30769230769231
2009,Yahoo! Research,yhooumd09BGC,7,1000,750,250,1.21212121212121,3.33333333333333
2009,Yahoo! Research,yhooumd09BGC,8,1000,944,56,1.03092783505155,2.15384615384615
2009,Yahoo! Research,yhooumd09BGC,9,1000,962,38,1.02249488752556,2.375
2009,Yahoo! Research,yhooumd09BGC,10,1000,572,428,1.53374233128834,5.35
2009,Yahoo! Research,yhooumd09BGC,11,1000,912,88,1.0515247108307,2.25641025641026
2009,Yahoo! Research,yhooumd09BGC,12,1000,902,98,1.07066381156317,3.0625
2009,Yahoo! Research,yhooumd09BGC,13,1000,744,256,1.24843945068664,4.49122807017544
2009,Yahoo! Research,yhooumd09BGC,14,1000,850,150,1.10619469026549,2.77777777777778
2009,Yahoo! Research,yhooumd09BGC,15,1000,918,82,1.0482180293501,2.27777777777778
2009,Yahoo! Research,yhooumd09BGC,16,1000,881,119,1.06837606837607,2.16363636363636
2009,Yahoo! Research,yhooumd09BGC,17,1000,938,62,1.03842159916926,2.48
2009,Yahoo! Research,yhooumd09BGC,18,1000,926,74,1.04275286757039,2.24242424242424
2009,Yahoo! Research,yhooumd09BGC,19,1000,922,78,1.05042016806723,2.6
2009,Yahoo! Research,yhooumd09BGC,20,1000,962,38,1.02040816326531,2.11111111111111
2009,Yahoo! Research,yhooumd09BGC,21,1000,901,99,1.06044538706257,2.35714285714286
2009,Yahoo! Research,yhooumd09BGC,22,1000,968,32,1.01729399796541,2.13333333333333
2009,Yahoo! Research,yhooumd09BGC,23,1000,882,118,1.085776330076,3.02564102564103
2009,Yahoo! Research,yhooumd09BGC,24,1000,769,231,1.17647058823529,2.85185185185185
2009,Yahoo! Research,yhooumd09BGC,25,1000,765,235,1.15874855156431,2.39795918367347
2009,Yahoo! Research,yhooumd09BGC,26,1000,897,103,1.06269925611052,2.34090909090909
2009,Yahoo! Research,yhooumd09BGC,27,1000,933,67,1.03842159916926,2.23333333333333
2009,Yahoo! Research,yhooumd09BGC,28,1000,811,189,1.16414435389988,3.9375
2009,Yahoo! Research,yhooumd09BGC,29,1000,945,55,1.03199174406605,2.29166666666667
2009,Yahoo! Research,yhooumd09BGC,30,1000,789,211,1.12233445566779,2.06862745098039
2009,Yahoo! Research,yhooumd09BGC,31,1000,781,219,1.14810562571757,2.43333333333333
2009,Yahoo! Research,yhooumd09BGC,32,1000,877,123,1.07991360691145,2.51020408163265
2009,Yahoo! Research,yhooumd09BGC,33,1000,956,44,1.02669404517454,2.44444444444444
2009,Yahoo! Research,yhooumd09BGC,34,1000,945,55,1.03626943005181,2.75
2009,Yahoo! Research,yhooumd09BGC,35,1000,874,126,1.07758620689655,2.33333333333333
2009,Yahoo! Research,yhooumd09BGC,36,1000,908,92,1.07066381156317,3.53846153846154
2009,Yahoo! Research,yhooumd09BGC,37,1000,896,104,1.07066381156317,2.73684210526316
2009,Yahoo! Research,yhooumd09BGC,38,1000,919,81,1.0482180293501,2.31428571428571
2009,Yahoo! Research,yhooumd09BGC,39,1000,929,71,1.04384133611691,2.44827586206897
2009,Yahoo! Research,yhooumd09BGC,40,1000,556,444,1.4367816091954,3.17142857142857
2009,Yahoo! Research,yhooumd09BGC,41,1000,887,113,1.06837606837607,2.30612244897959
2009,Yahoo! Research,yhooumd09BGC,42,1000,931,69,1.0482180293501,3
2009,Yahoo! Research,yhooumd09BGC,43,1000,903,97,1.06269925611052,2.55263157894737
2009,Yahoo! Research,yhooumd09BGC,44,1000,676,324,1.31233595800525,3.76744186046512
2009,Yahoo! Research,yhooumd09BGC,45,1000,936,64,1.03734439834025,2.28571428571429
2009,Yahoo! Research,yhooumd09BGC,46,1000,832,168,1.11111111111111,2.47058823529412
2009,Yahoo! Research,yhooumd09BGC,47,1000,926,74,1.04384133611691,2.3125
2009,Yahoo! Research,yhooumd09BGC,48,1000,922,78,1.04493207941484,2.22857142857143
2009,Yahoo! Research,yhooumd09BGC,49,1000,863,137,1.10741971207087,3.425
2009,Yahoo! Research,yhooumd09BGC,50,1000,859,141,1.09769484083425,2.71153846153846
2009,Yahoo! Research,yhooumd09BGM,1,1000,970,30,1.01626016260163,2.14285714285714
2009,Yahoo! Research,yhooumd09BGM,2,1000,926,74,1.04712041884817,2.55172413793103
2009,Yahoo! Research,yhooumd09BGM,3,1000,811,189,1.15874855156431,3.63461538461538
2009,Yahoo! Research,yhooumd09BGM,4,1000,847,153,1.12485939257593,3.64285714285714
2009,Yahoo! Research,yhooumd09BGM,5,1000,877,123,1.07411385606874,2.27777777777778
2009,Yahoo! Research,yhooumd09BGM,6,1000,790,210,1.13507377979569,2.30769230769231
2009,Yahoo! Research,yhooumd09BGM,7,1000,750,250,1.21212121212121,3.33333333333333
2009,Yahoo! Research,yhooumd09BGM,8,1000,944,56,1.03092783505155,2.15384615384615
2009,Yahoo! Research,yhooumd09BGM,9,1000,962,38,1.02249488752556,2.375
2009,Yahoo! Research,yhooumd09BGM,10,1000,567,433,1.54320987654321,5.34567901234568
2009,Yahoo! Research,yhooumd09BGM,11,1000,914,86,1.05042016806723,2.26315789473684
2009,Yahoo! Research,yhooumd09BGM,12,1000,900,100,1.07181136120043,3.03030303030303
2009,Yahoo! Research,yhooumd09BGM,13,1000,744,256,1.24843945068664,4.49122807017544
2009,Yahoo! Research,yhooumd09BGM,14,1000,850,150,1.10619469026549,2.77777777777778
2009,Yahoo! Research,yhooumd09BGM,15,1000,918,82,1.0482180293501,2.27777777777778
2009,Yahoo! Research,yhooumd09BGM,16,1000,871,129,1.07642626480086,2.22413793103448
2009,Yahoo! Research,yhooumd09BGM,17,1000,938,62,1.03842159916926,2.48
2009,Yahoo! Research,yhooumd09BGM,18,1000,924,76,1.04384133611691,2.23529411764706
2009,Yahoo! Research,yhooumd09BGM,19,1000,922,78,1.05042016806723,2.6
2009,Yahoo! Research,yhooumd09BGM,20,1000,962,38,1.02040816326531,2.11111111111111
2009,Yahoo! Research,yhooumd09BGM,21,1000,901,99,1.06044538706257,2.35714285714286
2009,Yahoo! Research,yhooumd09BGM,22,1000,962,38,1.02145045965271,2.23529411764706
2009,Yahoo! Research,yhooumd09BGM,23,1000,882,118,1.085776330076,3.02564102564103
2009,Yahoo! Research,yhooumd09BGM,24,1000,769,231,1.17647058823529,2.85185185185185
2009,Yahoo! Research,yhooumd09BGM,25,1000,767,233,1.15740740740741,2.4020618556701
2009,Yahoo! Research,yhooumd09BGM,26,1000,893,107,1.06496272630458,2.32608695652174
2009,Yahoo! Research,yhooumd09BGM,27,1000,933,67,1.03842159916926,2.23333333333333
2009,Yahoo! Research,yhooumd09BGM,28,1000,811,189,1.16414435389988,3.9375
2009,Yahoo! Research,yhooumd09BGM,29,1000,945,55,1.03199174406605,2.29166666666667
2009,Yahoo! Research,yhooumd09BGM,30,1000,785,215,1.12485939257593,2.06730769230769
2009,Yahoo! Research,yhooumd09BGM,31,1000,781,219,1.14810562571757,2.43333333333333
2009,Yahoo! Research,yhooumd09BGM,32,1000,877,123,1.07991360691145,2.51020408163265
2009,Yahoo! Research,yhooumd09BGM,33,1000,956,44,1.02669404517454,2.44444444444444
2009,Yahoo! Research,yhooumd09BGM,34,1000,945,55,1.03626943005181,2.75
2009,Yahoo! Research,yhooumd09BGM,35,1000,874,126,1.07758620689655,2.33333333333333
2009,Yahoo! Research,yhooumd09BGM,36,1000,908,92,1.07066381156317,3.53846153846154
2009,Yahoo! Research,yhooumd09BGM,37,1000,892,108,1.07296137339056,2.7
2009,Yahoo! Research,yhooumd09BGM,38,1000,917,83,1.04931794333683,2.30555555555556
2009,Yahoo! Research,yhooumd09BGM,39,1000,929,71,1.04384133611691,2.44827586206897
2009,Yahoo! Research,yhooumd09BGM,40,1000,463,537,1.5748031496063,3.12209302325581
2009,Yahoo! Research,yhooumd09BGM,41,1000,885,115,1.06837606837607,2.25490196078431
2009,Yahoo! Research,yhooumd09BGM,42,1000,931,69,1.0482180293501,3
2009,Yahoo! Research,yhooumd09BGM,43,1000,903,97,1.06269925611052,2.55263157894737
2009,Yahoo! Research,yhooumd09BGM,44,1000,676,324,1.31233595800525,3.76744186046512
2009,Yahoo! Research,yhooumd09BGM,45,1000,936,64,1.03734439834025,2.28571428571429
2009,Yahoo! Research,yhooumd09BGM,46,1000,860,140,1.09289617486339,2.54545454545455
2009,Yahoo! Research,yhooumd09BGM,47,1000,926,74,1.04384133611691,2.3125
2009,Yahoo! Research,yhooumd09BGM,48,1000,920,80,1.04602510460251,2.22222222222222
2009,Yahoo! Research,yhooumd09BGM,49,1000,863,137,1.10741971207087,3.425
2009,Yahoo! Research,yhooumd09BGM,50,1000,859,141,1.09769484083425,2.71153846153846
