year,group,sys,topic,n,n_u,n_t,avg,avg_t
2010,University of Ottawa,DFalah2010,51,121,59,62,1.47560975609756,2.69565217391304
2010,University of Ottawa,DFalah2010,52,521,25,496,7.44285714285714,11.0222222222222
2010,University of Ottawa,DFalah2010,53,1000,151,849,4.149377593361,9.43333333333333
2010,University of Ottawa,DFalah2010,54,1000,136,864,4.67289719626168,11.0769230769231
2010,University of Ottawa,DFalah2010,55,1000,23,977,13.5135135135135,19.156862745098
2010,University of Ottawa,DFalah2010,56,51,36,15,1.18604651162791,2.14285714285714
2010,University of Ottawa,DFalah2010,57,250,100,150,1.65562913907285,2.94117647058824
2010,University of Ottawa,DFalah2010,58,392,36,356,4.55813953488372,7.12
2010,University of Ottawa,DFalah2010,59,151,80,71,1.51,3.55
2010,University of Ottawa,DFalah2010,60,1000,24,976,10.5263157894737,13.7464788732394
2010,University of Ottawa,DFalah2010,61,1000,14,986,17.2413793103448,22.4090909090909
2010,University of Ottawa,DFalah2010,62,4,4,0,1,
2010,University of Ottawa,DFalah2010,63,1000,37,963,11.9047619047619,20.4893617021277
2010,University of Ottawa,DFalah2010,64,701,20,681,11.1269841269841,15.8372093023256
2010,University of Ottawa,DFalah2010,65,961,195,766,2.78550724637681,5.10666666666667
2010,University of Ottawa,DFalah2010,66,1000,513,487,1.59235668789809,4.23478260869565
2010,University of Ottawa,DFalah2010,67,9,9,0,1,
2010,University of Ottawa,DFalah2010,68,1000,32,968,10.8695652173913,16.1333333333333
2010,University of Ottawa,DFalah2010,69,141,58,83,1.7625,3.77272727272727
2010,University of Ottawa,DFalah2010,70,28,12,16,1.47368421052632,2.28571428571429
2010,University of Ottawa,DFalah2010,71,551,110,441,2.86979166666667,5.37804878048781
2010,University of Ottawa,DFalah2010,72,1000,27,973,15.3846153846154,25.6052631578947
2010,University of Ottawa,DFalah2010,73,931,103,828,4.77435897435897,9
2010,University of Ottawa,DFalah2010,74,1000,18,982,14.4927536231884,19.2549019607843
2010,University of Ottawa,DFalah2010,75,189,20,169,3.85714285714286,5.82758620689655
2010,University of Ottawa,DFalah2010,76,100,38,62,1.69491525423729,2.95238095238095
2010,University of Ottawa,DFalah2010,77,1000,26,974,12.3456790123457,17.7090909090909
2010,University of Ottawa,DFalah2010,78,1000,21,979,16.1290322580645,23.8780487804878
2010,University of Ottawa,DFalah2010,79,1000,28,972,12.987012987013,19.8367346938776
2010,University of Ottawa,DFalah2010,80,220,87,133,1.73228346456693,3.325
2010,University of Ottawa,DFalah2010,81,1000,35,965,10.989010989011,17.2321428571429
2010,University of Ottawa,DFalah2010,82,1000,18,982,17.5438596491228,25.1794871794872
2010,University of Ottawa,DFalah2010,83,1000,33,967,12.3456790123457,20.1458333333333
2010,University of Ottawa,DFalah2010,84,60,26,34,1.66666666666667,3.4
2010,University of Ottawa,DFalah2010,85,121,59,62,1.53164556962025,3.1
2010,University of Ottawa,DFalah2010,86,10,10,0,1,
2010,University of Ottawa,DFalah2010,87,70,45,25,1.25,2.27272727272727
2010,University of Ottawa,DFalah2010,88,40,24,16,1.29032258064516,2.28571428571429
2010,University of Ottawa,DFalah2010,89,871,32,839,10.6219512195122,16.78
2010,University of Ottawa,DFalah2010,90,281,24,257,5.2037037037037,8.56666666666667
2010,University of Ottawa,DFalah2010,91,411,132,279,2.08629441624365,4.29230769230769
2010,University of Ottawa,DFalah2010,92,1000,22,978,13.6986301369863,19.1764705882353
2010,University of Ottawa,DFalah2010,93,691,24,667,9.46575342465753,13.6122448979592
2010,University of Ottawa,DFalah2010,94,1000,30,970,12.3456790123457,19.0196078431373
2010,University of Ottawa,DFalah2010,95,1000,454,546,1.74216027874564,4.55
2010,University of Ottawa,DFalah2010,96,1000,26,974,14.0845070422535,21.6444444444444
2010,University of Ottawa,DFalah2010,97,1000,129,871,4.3859649122807,8.7979797979798
2010,University of Ottawa,DFalah2010,98,1000,20,980,14.9253731343284,20.8510638297872
2010,University of Ottawa,DFalah2010,99,1000,26,974,12.3456790123457,17.7090909090909
2010,University of Ottawa,DFalah2010,100,150,124,26,1.09489051094891,2
2010,"ICT, Chinese Academy of Sciences",ICTNETAD10R1,51,1000,920,80,1.04602510460251,2.22222222222222
2010,"ICT, Chinese Academy of Sciences",ICTNETAD10R1,52,1000,711,289,1.27064803049555,3.80263157894737
2010,"ICT, Chinese Academy of Sciences",ICTNETAD10R1,53,1000,911,89,1.0515247108307,2.225
2010,"ICT, Chinese Academy of Sciences",ICTNETAD10R1,54,1000,858,142,1.09649122807018,2.62962962962963
2010,"ICT, Chinese Academy of Sciences",ICTNETAD10R1,55,1000,940,60,1.0351966873706,2.30769230769231
2010,"ICT, Chinese Academy of Sciences",ICTNETAD10R1,56,1000,873,127,1.08459869848156,2.59183673469388
2010,"ICT, Chinese Academy of Sciences",ICTNETAD10R1,57,1000,963,37,1.02145045965271,2.3125
2010,"ICT, Chinese Academy of Sciences",ICTNETAD10R1,58,1000,888,112,1.06382978723404,2.15384615384615
2010,"ICT, Chinese Academy of Sciences",ICTNETAD10R1,59,1000,899,101,1.06044538706257,2.29545454545455
2010,"ICT, Chinese Academy of Sciences",ICTNETAD10R1,60,1000,739,261,1.26742712294043,5.22
2010,"ICT, Chinese Academy of Sciences",ICTNETAD10R1,61,1000,545,455,1.5748031496063,5.05555555555556
2010,"ICT, Chinese Academy of Sciences",ICTNETAD10R1,62,1000,902,98,1.06609808102345,2.72222222222222
2010,"ICT, Chinese Academy of Sciences",ICTNETAD10R1,63,1000,880,120,1.06837606837607,2.14285714285714
2010,"ICT, Chinese Academy of Sciences",ICTNETAD10R1,64,1000,907,93,1.0515247108307,2.11363636363636
2010,"ICT, Chinese Academy of Sciences",ICTNETAD10R1,65,1000,913,87,1.05042016806723,2.23076923076923
2010,"ICT, Chinese Academy of Sciences",ICTNETAD10R1,66,1000,942,58,1.04493207941484,3.86666666666667
2010,"ICT, Chinese Academy of Sciences",ICTNETAD10R1,67,1000,911,89,1.05820105820106,2.61764705882353
2010,"ICT, Chinese Academy of Sciences",ICTNETAD10R1,68,1000,856,144,1.085776330076,2.21538461538462
2010,"ICT, Chinese Academy of Sciences",ICTNETAD10R1,69,1000,929,71,1.03950103950104,2.15151515151515
2010,"ICT, Chinese Academy of Sciences",ICTNETAD10R1,70,1000,947,53,1.03412616339193,2.65
2010,"ICT, Chinese Academy of Sciences",ICTNETAD10R1,71,1000,944,56,1.03092783505155,2.15384615384615
2010,"ICT, Chinese Academy of Sciences",ICTNETAD10R1,72,1000,760,240,1.17096018735363,2.5531914893617
2010,"ICT, Chinese Academy of Sciences",ICTNETAD10R1,73,1000,987,13,1.00806451612903,2.6
2010,"ICT, Chinese Academy of Sciences",ICTNETAD10R1,74,1000,772,228,1.20048019207683,3.73770491803279
2010,"ICT, Chinese Academy of Sciences",ICTNETAD10R1,75,1000,841,159,1.0989010989011,2.30434782608696
2010,"ICT, Chinese Academy of Sciences",ICTNETAD10R1,76,1000,931,69,1.03734439834025,2.09090909090909
2010,"ICT, Chinese Academy of Sciences",ICTNETAD10R1,77,1000,899,101,1.05820105820106,2.19565217391304
2010,"ICT, Chinese Academy of Sciences",ICTNETAD10R1,78,1000,986,14,1.00704934541793,2
2010,"ICT, Chinese Academy of Sciences",ICTNETAD10R1,79,1000,886,114,1.07181136120043,2.42553191489362
2010,"ICT, Chinese Academy of Sciences",ICTNETAD10R1,80,1000,987,13,1.00704934541793,2.16666666666667
2010,"ICT, Chinese Academy of Sciences",ICTNETAD10R1,81,1000,883,117,1.07066381156317,2.29411764705882
2010,"ICT, Chinese Academy of Sciences",ICTNETAD10R1,82,1000,920,80,1.04384133611691,2.10526315789474
2010,"ICT, Chinese Academy of Sciences",ICTNETAD10R1,83,1000,220,780,2.32558139534884,3.71428571428571
2010,"ICT, Chinese Academy of Sciences",ICTNETAD10R1,84,1000,885,115,1.06723585912487,2.21153846153846
2010,"ICT, Chinese Academy of Sciences",ICTNETAD10R1,85,1000,928,72,1.04058272632674,2.18181818181818
2010,"ICT, Chinese Academy of Sciences",ICTNETAD10R1,86,1000,911,89,1.04931794333683,2.11904761904762
2010,"ICT, Chinese Academy of Sciences",ICTNETAD10R1,87,1000,954,46,1.02880658436214,2.55555555555556
2010,"ICT, Chinese Academy of Sciences",ICTNETAD10R1,88,1000,961,39,1.02145045965271,2.16666666666667
2010,"ICT, Chinese Academy of Sciences",ICTNETAD10R1,89,1000,933,67,1.03734439834025,2.16129032258065
2010,"ICT, Chinese Academy of Sciences",ICTNETAD10R1,90,1000,836,164,1.10619469026549,2.41176470588235
2010,"ICT, Chinese Academy of Sciences",ICTNETAD10R1,91,1000,926,74,1.04493207941484,2.38709677419355
2010,"ICT, Chinese Academy of Sciences",ICTNETAD10R1,92,1000,921,79,1.04602510460251,2.25714285714286
2010,"ICT, Chinese Academy of Sciences",ICTNETAD10R1,93,1000,925,75,1.04493207941484,2.34375
2010,"ICT, Chinese Academy of Sciences",ICTNETAD10R1,94,1000,643,357,1.45772594752187,8.30232558139535
2010,"ICT, Chinese Academy of Sciences",ICTNETAD10R1,95,1000,177,823,5.0761421319797,41.15
2010,"ICT, Chinese Academy of Sciences",ICTNETAD10R1,96,1000,810,190,1.12994350282486,2.53333333333333
2010,"ICT, Chinese Academy of Sciences",ICTNETAD10R1,97,1000,891,109,1.06837606837607,2.42222222222222
2010,"ICT, Chinese Academy of Sciences",ICTNETAD10R1,98,1000,838,162,1.10497237569061,2.41791044776119
2010,"ICT, Chinese Academy of Sciences",ICTNETAD10R1,99,1000,929,71,1.05932203389831,4.73333333333333
2010,"ICT, Chinese Academy of Sciences",ICTNETAD10R1,100,1000,843,157,1.11607142857143,2.9622641509434
2010,"ICT, Chinese Academy of Sciences",ICTNETAD10R2,51,1000,130,870,3.73134328358209,6.30434782608696
2010,"ICT, Chinese Academy of Sciences",ICTNETAD10R2,52,1000,594,406,1.45560407569141,4.36559139784946
2010,"ICT, Chinese Academy of Sciences",ICTNETAD10R2,53,1000,90,910,4.54545454545455,7
2010,"ICT, Chinese Academy of Sciences",ICTNETAD10R2,54,1000,168,832,2.9585798816568,4.89411764705882
2010,"ICT, Chinese Academy of Sciences",ICTNETAD10R2,55,1000,863,137,1.09170305676856,2.58490566037736
2010,"ICT, Chinese Academy of Sciences",ICTNETAD10R2,56,880,683,197,1.20383036935705,4.10416666666667
2010,"ICT, Chinese Academy of Sciences",ICTNETAD10R2,57,1000,83,917,5.15463917525773,8.26126126126126
2010,"ICT, Chinese Academy of Sciences",ICTNETAD10R2,58,1000,17,983,16.6666666666667,22.8604651162791
2010,"ICT, Chinese Academy of Sciences",ICTNETAD10R2,59,1000,405,595,1.73913043478261,3.5
2010,"ICT, Chinese Academy of Sciences",ICTNETAD10R2,60,1000,827,173,1.10497237569061,2.21794871794872
2010,"ICT, Chinese Academy of Sciences",ICTNETAD10R2,61,1000,884,116,1.06382978723404,2.07142857142857
2010,"ICT, Chinese Academy of Sciences",ICTNETAD10R2,62,1000,168,832,3.23624595469256,5.90070921985816
2010,"ICT, Chinese Academy of Sciences",ICTNETAD10R2,63,1000,926,74,1.04058272632674,2.11428571428571
2010,"ICT, Chinese Academy of Sciences",ICTNETAD10R2,64,1000,49,951,7.57575757575758,11.4578313253012
2010,"ICT, Chinese Academy of Sciences",ICTNETAD10R2,65,1000,34,966,8.47457627118644,11.5
2010,"ICT, Chinese Academy of Sciences",ICTNETAD10R2,66,1000,295,705,2.27272727272727,4.86206896551724
2010,"ICT, Chinese Academy of Sciences",ICTNETAD10R2,67,350,296,54,1.08359133126935,2
2010,"ICT, Chinese Academy of Sciences",ICTNETAD10R2,68,1000,906,94,1.0515247108307,2.08888888888889
2010,"ICT, Chinese Academy of Sciences",ICTNETAD10R2,69,1000,139,861,3.98406374501992,7.6875
2010,"ICT, Chinese Academy of Sciences",ICTNETAD10R2,70,1000,238,762,2.93255131964809,7.39805825242719
2010,"ICT, Chinese Academy of Sciences",ICTNETAD10R2,71,1000,106,894,4.95049504950495,9.3125
2010,"ICT, Chinese Academy of Sciences",ICTNETAD10R2,72,1000,1,999,38.4615384615385,39.96
2010,"ICT, Chinese Academy of Sciences",ICTNETAD10R2,73,1000,37,963,8.92857142857143,12.84
2010,"ICT, Chinese Academy of Sciences",ICTNETAD10R2,74,1000,634,366,1.46627565982405,7.625
2010,"ICT, Chinese Academy of Sciences",ICTNETAD10R2,75,1000,49,951,7.8125,12.0379746835443
2010,"ICT, Chinese Academy of Sciences",ICTNETAD10R2,76,1000,221,779,2.7027027027027,5.22818791946309
2010,"ICT, Chinese Academy of Sciences",ICTNETAD10R2,77,1000,899,101,1.05708245243129,2.14893617021277
2010,"ICT, Chinese Academy of Sciences",ICTNETAD10R2,78,1000,41,959,9.70873786407767,15.4677419354839
2010,"ICT, Chinese Academy of Sciences",ICTNETAD10R2,79,1000,887,113,1.06496272630458,2.17307692307692
2010,"ICT, Chinese Academy of Sciences",ICTNETAD10R2,80,1000,159,841,3.90625,8.67010309278351
2010,"ICT, Chinese Academy of Sciences",ICTNETAD10R2,81,1000,902,98,1.05820105820106,2.27906976744186
2010,"ICT, Chinese Academy of Sciences",ICTNETAD10R2,82,1000,21,979,17.2413793103448,26.4594594594595
2010,"ICT, Chinese Academy of Sciences",ICTNETAD10R2,83,1000,725,275,1.30208333333333,6.3953488372093
2010,"ICT, Chinese Academy of Sciences",ICTNETAD10R2,84,1000,139,861,3.34448160535117,5.38125
2010,"ICT, Chinese Academy of Sciences",ICTNETAD10R2,85,1000,183,817,3.03951367781155,5.5958904109589
2010,"ICT, Chinese Academy of Sciences",ICTNETAD10R2,86,1000,76,924,5.20833333333333,7.96551724137931
2010,"ICT, Chinese Academy of Sciences",ICTNETAD10R2,87,1000,179,821,3.46020761245675,7.46363636363636
2010,"ICT, Chinese Academy of Sciences",ICTNETAD10R2,88,1000,161,839,2.89017341040462,4.53513513513514
2010,"ICT, Chinese Academy of Sciences",ICTNETAD10R2,89,1000,896,104,1.07296137339056,2.88888888888889
2010,"ICT, Chinese Academy of Sciences",ICTNETAD10R2,90,1000,672,328,1.29032258064516,3.18446601941748
2010,"ICT, Chinese Academy of Sciences",ICTNETAD10R2,91,1000,68,932,9.25925925925926,23.3
2010,"ICT, Chinese Academy of Sciences",ICTNETAD10R2,92,1000,13,987,20,26.6756756756757
2010,"ICT, Chinese Academy of Sciences",ICTNETAD10R2,93,1000,44,956,8.47457627118644,12.9189189189189
2010,"ICT, Chinese Academy of Sciences",ICTNETAD10R2,94,1000,885,115,1.06382978723404,2.09090909090909
2010,"ICT, Chinese Academy of Sciences",ICTNETAD10R2,95,1000,782,218,1.18483412322275,3.51612903225806
2010,"ICT, Chinese Academy of Sciences",ICTNETAD10R2,96,1000,895,105,1.05932203389831,2.14285714285714
2010,"ICT, Chinese Academy of Sciences",ICTNETAD10R2,97,1000,1,999,100,111
2010,"ICT, Chinese Academy of Sciences",ICTNETAD10R2,98,1000,897,103,1.06382978723404,2.3953488372093
2010,"ICT, Chinese Academy of Sciences",ICTNETAD10R2,99,1000,883,117,1.09409190371991,3.7741935483871
2010,"ICT, Chinese Academy of Sciences",ICTNETAD10R2,100,1000,162,838,3.003003003003,4.90058479532164
2010,"ICT, Chinese Academy of Sciences",ICTNETAD10R3,51,1000,130,870,3.73134328358209,6.30434782608696
2010,"ICT, Chinese Academy of Sciences",ICTNETAD10R3,52,1000,594,406,1.45560407569141,4.36559139784946
2010,"ICT, Chinese Academy of Sciences",ICTNETAD10R3,53,1000,90,910,4.54545454545455,7
2010,"ICT, Chinese Academy of Sciences",ICTNETAD10R3,54,1000,168,832,2.9585798816568,4.89411764705882
2010,"ICT, Chinese Academy of Sciences",ICTNETAD10R3,55,1000,863,137,1.09170305676856,2.58490566037736
2010,"ICT, Chinese Academy of Sciences",ICTNETAD10R3,56,880,683,197,1.20383036935705,4.10416666666667
2010,"ICT, Chinese Academy of Sciences",ICTNETAD10R3,57,1000,83,917,5.15463917525773,8.26126126126126
2010,"ICT, Chinese Academy of Sciences",ICTNETAD10R3,58,1000,17,983,16.6666666666667,22.8604651162791
2010,"ICT, Chinese Academy of Sciences",ICTNETAD10R3,59,1000,405,595,1.73913043478261,3.5
2010,"ICT, Chinese Academy of Sciences",ICTNETAD10R3,60,1000,827,173,1.10497237569061,2.21794871794872
2010,"ICT, Chinese Academy of Sciences",ICTNETAD10R3,61,1000,884,116,1.06382978723404,2.07142857142857
2010,"ICT, Chinese Academy of Sciences",ICTNETAD10R3,62,1000,168,832,3.23624595469256,5.90070921985816
2010,"ICT, Chinese Academy of Sciences",ICTNETAD10R3,63,1000,926,74,1.04058272632674,2.11428571428571
2010,"ICT, Chinese Academy of Sciences",ICTNETAD10R3,64,1000,49,951,7.57575757575758,11.4578313253012
2010,"ICT, Chinese Academy of Sciences",ICTNETAD10R3,65,1000,34,966,8.47457627118644,11.5
2010,"ICT, Chinese Academy of Sciences",ICTNETAD10R3,66,1000,295,705,2.27272727272727,4.86206896551724
2010,"ICT, Chinese Academy of Sciences",ICTNETAD10R3,67,350,296,54,1.08359133126935,2
2010,"ICT, Chinese Academy of Sciences",ICTNETAD10R3,68,1000,906,94,1.0515247108307,2.08888888888889
2010,"ICT, Chinese Academy of Sciences",ICTNETAD10R3,69,1000,139,861,3.98406374501992,7.6875
2010,"ICT, Chinese Academy of Sciences",ICTNETAD10R3,70,1000,238,762,2.93255131964809,7.39805825242719
2010,"ICT, Chinese Academy of Sciences",ICTNETAD10R3,71,1000,106,894,4.95049504950495,9.3125
2010,"ICT, Chinese Academy of Sciences",ICTNETAD10R3,72,1000,1,999,38.4615384615385,39.96
2010,"ICT, Chinese Academy of Sciences",ICTNETAD10R3,73,1000,37,963,8.92857142857143,12.84
2010,"ICT, Chinese Academy of Sciences",ICTNETAD10R3,74,1000,634,366,1.46627565982405,7.625
2010,"ICT, Chinese Academy of Sciences",ICTNETAD10R3,75,1000,49,951,7.8125,12.0379746835443
2010,"ICT, Chinese Academy of Sciences",ICTNETAD10R3,76,1000,221,779,2.7027027027027,5.22818791946309
2010,"ICT, Chinese Academy of Sciences",ICTNETAD10R3,77,1000,899,101,1.05708245243129,2.14893617021277
2010,"ICT, Chinese Academy of Sciences",ICTNETAD10R3,78,1000,41,959,9.70873786407767,15.4677419354839
2010,"ICT, Chinese Academy of Sciences",ICTNETAD10R3,79,1000,887,113,1.06496272630458,2.17307692307692
2010,"ICT, Chinese Academy of Sciences",ICTNETAD10R3,80,1000,159,841,3.90625,8.67010309278351
2010,"ICT, Chinese Academy of Sciences",ICTNETAD10R3,81,1000,902,98,1.05820105820106,2.27906976744186
2010,"ICT, Chinese Academy of Sciences",ICTNETAD10R3,82,1000,21,979,17.2413793103448,26.4594594594595
2010,"ICT, Chinese Academy of Sciences",ICTNETAD10R3,83,1000,725,275,1.30208333333333,6.3953488372093
2010,"ICT, Chinese Academy of Sciences",ICTNETAD10R3,84,1000,139,861,3.34448160535117,5.38125
2010,"ICT, Chinese Academy of Sciences",ICTNETAD10R3,85,1000,183,817,3.03951367781155,5.5958904109589
2010,"ICT, Chinese Academy of Sciences",ICTNETAD10R3,86,1000,76,924,5.20833333333333,7.96551724137931
2010,"ICT, Chinese Academy of Sciences",ICTNETAD10R3,87,1000,179,821,3.46020761245675,7.46363636363636
2010,"ICT, Chinese Academy of Sciences",ICTNETAD10R3,88,1000,161,839,2.89017341040462,4.53513513513514
2010,"ICT, Chinese Academy of Sciences",ICTNETAD10R3,89,1000,896,104,1.07296137339056,2.88888888888889
2010,"ICT, Chinese Academy of Sciences",ICTNETAD10R3,90,1000,672,328,1.29032258064516,3.18446601941748
2010,"ICT, Chinese Academy of Sciences",ICTNETAD10R3,91,1000,68,932,9.25925925925926,23.3
2010,"ICT, Chinese Academy of Sciences",ICTNETAD10R3,92,1000,13,987,20,26.6756756756757
2010,"ICT, Chinese Academy of Sciences",ICTNETAD10R3,93,1000,44,956,8.47457627118644,12.9189189189189
2010,"ICT, Chinese Academy of Sciences",ICTNETAD10R3,94,1000,885,115,1.06382978723404,2.09090909090909
2010,"ICT, Chinese Academy of Sciences",ICTNETAD10R3,95,1000,782,218,1.18483412322275,3.51612903225806
2010,"ICT, Chinese Academy of Sciences",ICTNETAD10R3,96,1000,895,105,1.05932203389831,2.14285714285714
2010,"ICT, Chinese Academy of Sciences",ICTNETAD10R3,97,1000,1,999,100,111
2010,"ICT, Chinese Academy of Sciences",ICTNETAD10R3,98,1000,897,103,1.06382978723404,2.3953488372093
2010,"ICT, Chinese Academy of Sciences",ICTNETAD10R3,99,1000,883,117,1.09409190371991,3.7741935483871
2010,"ICT, Chinese Academy of Sciences",ICTNETAD10R3,100,1000,162,838,3.003003003003,4.90058479532164
2010,University of Maryland,IvoryBM25a,51,1000,967,33,1.01729399796541,2.0625
2010,University of Maryland,IvoryBM25a,52,1000,938,62,1.03734439834025,2.38461538461538
2010,University of Maryland,IvoryBM25a,53,1000,976,24,1.01317122593718,2.18181818181818
2010,University of Maryland,IvoryBM25a,54,1000,930,70,1.04275286757039,2.41379310344828
2010,University of Maryland,IvoryBM25a,55,1000,802,198,1.14025085518814,2.64
2010,University of Maryland,IvoryBM25a,56,1000,916,84,1.05596620908131,2.70967741935484
2010,University of Maryland,IvoryBM25a,57,1000,969,31,1.01936799184506,2.58333333333333
2010,University of Maryland,IvoryBM25a,58,1000,901,99,1.06496272630458,2.60526315789474
2010,University of Maryland,IvoryBM25a,59,1000,975,25,1.01317122593718,2.08333333333333
2010,University of Maryland,IvoryBM25a,60,1000,976,24,1.01317122593718,2.18181818181818
2010,University of Maryland,IvoryBM25a,61,1000,908,92,1.05485232067511,2.3
2010,University of Maryland,IvoryBM25a,62,1000,976,24,1.01419878296146,2.4
2010,University of Maryland,IvoryBM25a,63,1000,963,37,1.02040816326531,2.17647058823529
2010,University of Maryland,IvoryBM25a,64,1000,915,85,1.0515247108307,2.36111111111111
2010,University of Maryland,IvoryBM25a,65,1000,928,72,1.04166666666667,2.25
2010,University of Maryland,IvoryBM25a,66,1000,977,23,1.01419878296146,2.55555555555556
2010,University of Maryland,IvoryBM25a,67,1000,943,57,1.03412616339193,2.375
2010,University of Maryland,IvoryBM25a,68,1000,923,77,1.04712041884817,2.40625
2010,University of Maryland,IvoryBM25a,69,1000,953,47,1.03092783505155,2.76470588235294
2010,University of Maryland,IvoryBM25a,70,1000,923,77,1.04275286757039,2.13888888888889
2010,University of Maryland,IvoryBM25a,71,1000,959,41,1.02459016393443,2.41176470588235
2010,University of Maryland,IvoryBM25a,72,1000,956,44,1.02249488752556,2
2010,University of Maryland,IvoryBM25a,73,1000,922,78,1.04931794333683,2.51612903225806
2010,University of Maryland,IvoryBM25a,74,1000,879,121,1.08813928182807,3.025
2010,University of Maryland,IvoryBM25a,75,1000,906,94,1.05374077976818,2.18604651162791
2010,University of Maryland,IvoryBM25a,76,1000,968,32,1.01626016260163,2
2010,University of Maryland,IvoryBM25a,77,1000,943,57,1.03305785123967,2.28
2010,University of Maryland,IvoryBM25a,78,1000,982,18,1.00908173562059,2
2010,University of Maryland,IvoryBM25a,79,1000,473,527,1.73010380622837,5.01904761904762
2010,University of Maryland,IvoryBM25a,80,1000,1000,0,1,
2010,University of Maryland,IvoryBM25a,81,1000,869,131,1.09529025191676,2.97727272727273
2010,University of Maryland,IvoryBM25a,82,1000,943,57,1.0351966873706,2.47826086956522
2010,University of Maryland,IvoryBM25a,83,1000,844,156,1.09649122807018,2.29411764705882
2010,University of Maryland,IvoryBM25a,84,1000,903,97,1.05820105820106,2.30952380952381
2010,University of Maryland,IvoryBM25a,85,1000,978,22,1.01112234580384,2
2010,University of Maryland,IvoryBM25a,86,1000,935,65,1.03734439834025,2.24137931034483
2010,University of Maryland,IvoryBM25a,87,1000,985,15,1.00806451612903,2.14285714285714
2010,University of Maryland,IvoryBM25a,88,1000,954,46,1.02669404517454,2.3
2010,University of Maryland,IvoryBM25a,89,1000,953,47,1.02564102564103,2.13636363636364
2010,University of Maryland,IvoryBM25a,90,1000,942,58,1.03412616339193,2.32
2010,University of Maryland,IvoryBM25a,91,1000,903,97,1.06837606837607,2.93939393939394
2010,University of Maryland,IvoryBM25a,92,1000,932,68,1.03950103950104,2.26666666666667
2010,University of Maryland,IvoryBM25a,93,1000,954,46,1.02774922918808,2.42105263157895
2010,University of Maryland,IvoryBM25a,94,1000,909,91,1.05708245243129,2.45945945945946
2010,University of Maryland,IvoryBM25a,95,1000,931,69,1.05374077976818,3.83333333333333
2010,University of Maryland,IvoryBM25a,96,1000,949,51,1.02669404517454,2.04
2010,University of Maryland,IvoryBM25a,97,1000,961,39,1.02040816326531,2.05263157894737
2010,University of Maryland,IvoryBM25a,98,1000,958,42,1.02669404517454,2.625
2010,University of Maryland,IvoryBM25a,99,1000,703,297,1.25156445556946,3.09375
2010,University of Maryland,IvoryBM25a,100,1000,928,72,1.04931794333683,2.88
2010,University of Southern California / ISI,IvoryL2Rb,51,1000,959,41,1.02354145342886,2.27777777777778
2010,University of Southern California / ISI,IvoryL2Rb,52,1000,972,28,1.01522842639594,2.15384615384615
2010,University of Southern California / ISI,IvoryL2Rb,53,1000,988,12,1.00806451612903,3
2010,University of Southern California / ISI,IvoryL2Rb,54,1000,924,76,1.04384133611691,2.23529411764706
2010,University of Southern California / ISI,IvoryL2Rb,55,1000,925,75,1.04712041884817,2.5
2010,University of Southern California / ISI,IvoryL2Rb,56,1000,919,81,1.04493207941484,2.13157894736842
2010,University of Southern California / ISI,IvoryL2Rb,57,1000,997,3,1.00200400801603,3
2010,University of Southern California / ISI,IvoryL2Rb,58,1000,955,45,1.02774922918808,2.5
2010,University of Southern California / ISI,IvoryL2Rb,59,1000,973,27,1.0183299389002,3
2010,University of Southern California / ISI,IvoryL2Rb,60,1000,978,22,1.01112234580384,2
2010,University of Southern California / ISI,IvoryL2Rb,61,1000,940,60,1.0351966873706,2.30769230769231
2010,University of Southern California / ISI,IvoryL2Rb,62,1000,966,34,1.02459016393443,3.4
2010,University of Southern California / ISI,IvoryL2Rb,63,1000,963,37,1.02040816326531,2.17647058823529
2010,University of Southern California / ISI,IvoryL2Rb,64,1000,931,69,1.03842159916926,2.15625
2010,University of Southern California / ISI,IvoryL2Rb,65,1000,933,67,1.04166666666667,2.48148148148148
2010,University of Southern California / ISI,IvoryL2Rb,66,1000,970,30,1.0183299389002,2.5
2010,University of Southern California / ISI,IvoryL2Rb,67,1000,939,61,1.03626943005181,2.34615384615385
2010,University of Southern California / ISI,IvoryL2Rb,68,1000,996,4,1.00200400801603,2
2010,University of Southern California / ISI,IvoryL2Rb,69,1000,987,13,1.00704934541793,2.16666666666667
2010,University of Southern California / ISI,IvoryL2Rb,70,1000,987,13,1.00704934541793,2.16666666666667
2010,University of Southern California / ISI,IvoryL2Rb,71,1000,938,62,1.04058272632674,2.69565217391304
2010,University of Southern California / ISI,IvoryL2Rb,72,1000,956,44,1.02774922918808,2.58823529411765
2010,University of Southern California / ISI,IvoryL2Rb,73,1000,950,50,1.02774922918808,2.17391304347826
2010,University of Southern California / ISI,IvoryL2Rb,74,1000,976,24,1.01419878296146,2.4
2010,University of Southern California / ISI,IvoryL2Rb,75,1000,900,100,1.05485232067511,2.08333333333333
2010,University of Southern California / ISI,IvoryL2Rb,76,1000,996,4,1.00200400801603,2
2010,University of Southern California / ISI,IvoryL2Rb,77,1000,982,18,1.00908173562059,2
2010,University of Southern California / ISI,IvoryL2Rb,78,1000,966,34,1.01729399796541,2
2010,University of Southern California / ISI,IvoryL2Rb,79,1000,932,68,1.03842159916926,2.19354838709677
2010,University of Southern California / ISI,IvoryL2Rb,80,1000,998,2,1.001001001001,2
2010,University of Southern California / ISI,IvoryL2Rb,81,1000,867,133,1.0989010989011,3.09302325581395
2010,University of Southern California / ISI,IvoryL2Rb,82,1000,929,71,1.04166666666667,2.29032258064516
2010,University of Southern California / ISI,IvoryL2Rb,83,1000,980,20,1.01010101010101,2
2010,University of Southern California / ISI,IvoryL2Rb,84,1000,951,49,1.02669404517454,2.1304347826087
2010,University of Southern California / ISI,IvoryL2Rb,85,1000,977,23,1.01214574898785,2.09090909090909
2010,University of Southern California / ISI,IvoryL2Rb,86,1000,993,7,1.00401606425703,2.33333333333333
2010,University of Southern California / ISI,IvoryL2Rb,87,1000,954,46,1.02669404517454,2.3
2010,University of Southern California / ISI,IvoryL2Rb,88,1000,964,36,1.02459016393443,3
2010,University of Southern California / ISI,IvoryL2Rb,89,1000,991,9,1.00502512562814,2.25
2010,University of Southern California / ISI,IvoryL2Rb,90,1000,970,30,1.02145045965271,3.33333333333333
2010,University of Southern California / ISI,IvoryL2Rb,91,1000,980,20,1.01010101010101,2
2010,University of Southern California / ISI,IvoryL2Rb,92,1000,968,32,1.0183299389002,2.28571428571429
2010,University of Southern California / ISI,IvoryL2Rb,93,1000,988,12,1.00603621730382,2
2010,University of Southern California / ISI,IvoryL2Rb,94,1000,915,85,1.0482180293501,2.17948717948718
2010,University of Southern California / ISI,IvoryL2Rb,95,1000,952,48,1.03626943005181,3.69230769230769
2010,University of Southern California / ISI,IvoryL2Rb,96,1000,941,59,1.0351966873706,2.36
2010,University of Southern California / ISI,IvoryL2Rb,97,1000,992,8,1.00401606425703,2
2010,University of Southern California / ISI,IvoryL2Rb,98,1000,979,21,1.01419878296146,3
2010,University of Southern California / ISI,IvoryL2Rb,99,1000,957,43,1.02354145342886,2.15
2010,University of Southern California / ISI,IvoryL2Rb,100,1000,998,2,1.001001001001,2
2010,University of Southern California / ISI,IvoryLCEb,51,1000,934,66,1.03626943005181,2.12903225806452
2010,University of Southern California / ISI,IvoryLCEb,52,1000,919,81,1.04493207941484,2.13157894736842
2010,University of Southern California / ISI,IvoryLCEb,53,1000,961,39,1.02249488752556,2.29411764705882
2010,University of Southern California / ISI,IvoryLCEb,54,1000,779,221,1.15340253748558,2.51136363636364
2010,University of Southern California / ISI,IvoryLCEb,55,1000,811,189,1.12485939257593,2.42307692307692
2010,University of Southern California / ISI,IvoryLCEb,56,1000,827,173,1.11358574610245,2.43661971830986
2010,University of Southern California / ISI,IvoryLCEb,57,1000,955,45,1.02459016393443,2.14285714285714
2010,University of Southern California / ISI,IvoryLCEb,58,1000,910,90,1.05374077976818,2.30769230769231
2010,University of Southern California / ISI,IvoryLCEb,59,1000,928,72,1.04275286757039,2.32258064516129
2010,University of Southern California / ISI,IvoryLCEb,60,1000,914,86,1.04712041884817,2.09756097560976
2010,University of Southern California / ISI,IvoryLCEb,61,1000,824,176,1.11482720178372,2.41095890410959
2010,University of Southern California / ISI,IvoryLCEb,62,1000,915,85,1.05820105820106,2.83333333333333
2010,University of Southern California / ISI,IvoryLCEb,63,1000,913,87,1.05042016806723,2.23076923076923
2010,University of Southern California / ISI,IvoryLCEb,64,1000,889,111,1.06723585912487,2.3125
2010,University of Southern California / ISI,IvoryLCEb,65,1000,850,150,1.09769484083425,2.45901639344262
2010,University of Southern California / ISI,IvoryLCEb,66,1000,942,58,1.0351966873706,2.41666666666667
2010,University of Southern California / ISI,IvoryLCEb,67,1000,871,129,1.085776330076,2.58
2010,University of Southern California / ISI,IvoryLCEb,68,1000,968,32,1.01729399796541,2.13333333333333
2010,University of Southern California / ISI,IvoryLCEb,69,1000,902,98,1.07758620689655,3.76923076923077
2010,University of Southern California / ISI,IvoryLCEb,70,1000,917,83,1.0482180293501,2.24324324324324
2010,University of Southern California / ISI,IvoryLCEb,71,1000,879,121,1.08695652173913,2.95121951219512
2010,University of Southern California / ISI,IvoryLCEb,72,1000,836,164,1.11482720178372,2.68852459016393
2010,University of Southern California / ISI,IvoryLCEb,73,1000,860,140,1.08813928182807,2.3728813559322
2010,University of Southern California / ISI,IvoryLCEb,74,1000,945,55,1.03199174406605,2.29166666666667
2010,University of Southern California / ISI,IvoryLCEb,75,1000,844,156,1.09051254089422,2.13698630136986
2010,University of Southern California / ISI,IvoryLCEb,76,1000,958,42,1.02669404517454,2.625
2010,University of Southern California / ISI,IvoryLCEb,77,1000,925,75,1.04166666666667,2.14285714285714
2010,University of Southern California / ISI,IvoryLCEb,78,1000,980,20,1.01112234580384,2.22222222222222
2010,University of Southern California / ISI,IvoryLCEb,79,1000,866,134,1.08459869848156,2.39285714285714
2010,University of Southern California / ISI,IvoryLCEb,80,1000,980,20,1.01010101010101,2
2010,University of Southern California / ISI,IvoryLCEb,81,1000,802,198,1.15340253748558,3.04615384615385
2010,University of Southern California / ISI,IvoryLCEb,82,1000,819,181,1.12359550561798,2.54929577464789
2010,University of Southern California / ISI,IvoryLCEb,83,1000,890,110,1.06269925611052,2.15686274509804
2010,University of Southern California / ISI,IvoryLCEb,84,1000,883,117,1.07066381156317,2.29411764705882
2010,University of Southern California / ISI,IvoryLCEb,85,1000,929,71,1.03842159916926,2.08823529411765
2010,University of Southern California / ISI,IvoryLCEb,86,1000,945,55,1.03199174406605,2.29166666666667
2010,University of Southern California / ISI,IvoryLCEb,87,1000,835,165,1.11358574610245,2.61904761904762
2010,University of Southern California / ISI,IvoryLCEb,88,1000,931,69,1.04384133611691,2.55555555555556
2010,University of Southern California / ISI,IvoryLCEb,89,1000,950,50,1.02669404517454,2.08333333333333
2010,University of Southern California / ISI,IvoryLCEb,90,1000,941,59,1.03842159916926,2.68181818181818
2010,University of Southern California / ISI,IvoryLCEb,91,1000,964,36,1.02145045965271,2.4
2010,University of Southern California / ISI,IvoryLCEb,92,1000,947,53,1.02880658436214,2.12
2010,University of Southern California / ISI,IvoryLCEb,93,1000,947,53,1.02986611740474,2.20833333333333
2010,University of Southern California / ISI,IvoryLCEb,94,1000,839,161,1.1001100110011,2.3
2010,University of Southern California / ISI,IvoryLCEb,95,1000,937,63,1.04931794333683,3.9375
2010,University of Southern California / ISI,IvoryLCEb,96,1000,885,115,1.0752688172043,2.55555555555556
2010,University of Southern California / ISI,IvoryLCEb,97,1000,962,38,1.02040816326531,2.11111111111111
2010,University of Southern California / ISI,IvoryLCEb,98,1000,946,54,1.03412616339193,2.57142857142857
2010,University of Southern California / ISI,IvoryLCEb,99,1000,793,207,1.1454753722795,2.5875
2010,University of Southern California / ISI,IvoryLCEb,100,1000,988,12,1.00603621730382,2
2010,University of Maryland,IvorySDa,51,1000,964,36,1.01936799184506,2.11764705882353
2010,University of Maryland,IvorySDa,52,1000,938,62,1.03734439834025,2.38461538461538
2010,University of Maryland,IvorySDa,53,1000,974,26,1.01419878296146,2.16666666666667
2010,University of Maryland,IvorySDa,54,1000,913,87,1.05596620908131,2.55882352941176
2010,University of Maryland,IvorySDa,55,1000,771,229,1.17647058823529,2.89873417721519
2010,University of Maryland,IvorySDa,56,1000,911,89,1.05932203389831,2.6969696969697
2010,University of Maryland,IvorySDa,57,1000,929,71,1.05485232067511,3.73684210526316
2010,University of Maryland,IvorySDa,58,1000,901,99,1.06496272630458,2.60526315789474
2010,University of Maryland,IvorySDa,59,1000,983,17,1.00908173562059,2.125
2010,University of Maryland,IvorySDa,60,1000,976,24,1.01317122593718,2.18181818181818
2010,University of Maryland,IvorySDa,61,1000,964,36,1.0183299389002,2
2010,University of Maryland,IvorySDa,62,1000,956,44,1.02774922918808,2.58823529411765
2010,University of Maryland,IvorySDa,63,1000,963,37,1.02040816326531,2.17647058823529
2010,University of Maryland,IvorySDa,64,1000,915,85,1.0515247108307,2.36111111111111
2010,University of Maryland,IvorySDa,65,1000,931,69,1.03950103950104,2.2258064516129
2010,University of Maryland,IvorySDa,66,1000,975,25,1.01419878296146,2.27272727272727
2010,University of Maryland,IvorySDa,67,1000,945,55,1.03305785123967,2.39130434782609
2010,University of Maryland,IvorySDa,68,1000,927,73,1.04493207941484,2.43333333333333
2010,University of Maryland,IvorySDa,69,1000,952,48,1.03305785123967,3
2010,University of Maryland,IvorySDa,70,1000,930,70,1.03842159916926,2.12121212121212
2010,University of Maryland,IvorySDa,71,1000,943,57,1.03305785123967,2.28
2010,University of Maryland,IvorySDa,72,1000,931,69,1.04058272632674,2.3
2010,University of Maryland,IvorySDa,73,1000,935,65,1.04166666666667,2.6
2010,University of Maryland,IvorySDa,74,1000,874,126,1.09170305676856,3
2010,University of Maryland,IvorySDa,75,1000,892,108,1.06157112526539,2.16
2010,University of Maryland,IvorySDa,76,1000,952,48,1.02564102564103,2.08695652173913
2010,University of Maryland,IvorySDa,77,1000,945,55,1.03199174406605,2.29166666666667
2010,University of Maryland,IvorySDa,78,1000,978,22,1.01112234580384,2
2010,University of Maryland,IvorySDa,79,1000,496,504,1.66666666666667,4.84615384615385
2010,University of Maryland,IvorySDa,80,1000,966,34,1.02880658436214,5.66666666666667
2010,University of Maryland,IvorySDa,81,1000,864,136,1.0989010989011,2.95652173913043
2010,University of Maryland,IvorySDa,82,1000,940,60,1.03734439834025,2.5
2010,University of Maryland,IvorySDa,83,1000,856,144,1.08695652173913,2.25
2010,University of Maryland,IvorySDa,84,1000,903,97,1.05932203389831,2.36585365853659
2010,University of Maryland,IvorySDa,85,1000,969,31,1.01626016260163,2.06666666666667
2010,University of Maryland,IvorySDa,86,1000,957,43,1.02249488752556,2.04761904761905
2010,University of Maryland,IvorySDa,87,1000,972,28,1.01626016260163,2.33333333333333
2010,University of Maryland,IvorySDa,88,1000,954,46,1.02669404517454,2.3
2010,University of Maryland,IvorySDa,89,1000,957,43,1.02354145342886,2.15
2010,University of Maryland,IvorySDa,90,1000,942,58,1.03412616339193,2.32
2010,University of Maryland,IvorySDa,91,1000,864,136,1.09649122807018,2.83333333333333
2010,University of Maryland,IvorySDa,92,1000,936,64,1.03734439834025,2.28571428571429
2010,University of Maryland,IvorySDa,93,1000,952,48,1.02880658436214,2.4
2010,University of Maryland,IvorySDa,94,1000,911,89,1.05596620908131,2.47222222222222
2010,University of Maryland,IvorySDa,95,1000,910,90,1.05485232067511,2.36842105263158
2010,University of Maryland,IvorySDa,96,1000,951,49,1.02564102564103,2.04166666666667
2010,University of Maryland,IvorySDa,97,1000,965,35,1.0183299389002,2.05882352941176
2010,University of Maryland,IvorySDa,98,1000,958,42,1.02669404517454,2.625
2010,University of Maryland,IvorySDa,99,1000,730,270,1.21506682867558,2.90322580645161
2010,University of Maryland,IvorySDa,100,1000,926,74,1.05042016806723,2.84615384615385
2010,University of Maryland,IvoryWSDa,51,1000,962,38,1.02040816326531,2.11111111111111
2010,University of Maryland,IvoryWSDa,52,1000,936,64,1.03842159916926,2.37037037037037
2010,University of Maryland,IvoryWSDa,53,1000,972,28,1.01522842639594,2.15384615384615
2010,University of Maryland,IvoryWSDa,54,1000,940,60,1.03734439834025,2.5
2010,University of Maryland,IvoryWSDa,55,1000,759,241,1.18483412322275,2.83529411764706
2010,University of Maryland,IvoryWSDa,56,1000,909,91,1.06044538706257,2.67647058823529
2010,University of Maryland,IvoryWSDa,57,1000,916,84,1.05374077976818,2.54545454545455
2010,University of Maryland,IvoryWSDa,58,1000,918,82,1.05042016806723,2.41176470588235
2010,University of Maryland,IvoryWSDa,59,1000,977,23,1.01214574898785,2.09090909090909
2010,University of Maryland,IvoryWSDa,60,1000,976,24,1.01317122593718,2.18181818181818
2010,University of Maryland,IvoryWSDa,61,1000,960,40,1.02145045965271,2.10526315789474
2010,University of Maryland,IvoryWSDa,62,1000,956,44,1.02774922918808,2.58823529411765
2010,University of Maryland,IvoryWSDa,63,1000,961,39,1.02145045965271,2.16666666666667
2010,University of Maryland,IvoryWSDa,64,1000,915,85,1.0515247108307,2.36111111111111
2010,University of Maryland,IvoryWSDa,65,1000,932,68,1.03950103950104,2.26666666666667
2010,University of Maryland,IvoryWSDa,66,1000,944,56,1.03412616339193,2.43478260869565
2010,University of Maryland,IvoryWSDa,67,1000,947,53,1.03199174406605,2.40909090909091
2010,University of Maryland,IvoryWSDa,68,1000,930,70,1.04275286757039,2.41379310344828
2010,University of Maryland,IvoryWSDa,69,1000,946,54,1.03734439834025,3
2010,University of Maryland,IvoryWSDa,70,1000,936,64,1.0351966873706,2.13333333333333
2010,University of Maryland,IvoryWSDa,71,1000,949,51,1.02986611740474,2.31818181818182
2010,University of Maryland,IvoryWSDa,72,1000,889,111,1.07411385606874,2.64285714285714
2010,University of Maryland,IvoryWSDa,73,1000,987,13,1.00704934541793,2.16666666666667
2010,University of Maryland,IvoryWSDa,74,1000,872,128,1.09289617486339,2.97674418604651
2010,University of Maryland,IvoryWSDa,75,1000,890,110,1.06269925611052,2.15686274509804
2010,University of Maryland,IvoryWSDa,76,1000,946,54,1.02880658436214,2.07692307692308
2010,University of Maryland,IvoryWSDa,77,1000,945,55,1.03199174406605,2.29166666666667
2010,University of Maryland,IvoryWSDa,78,1000,978,22,1.01112234580384,2
2010,University of Maryland,IvoryWSDa,79,1000,524,476,1.6,4.71287128712871
2010,University of Maryland,IvoryWSDa,80,1000,966,34,1.02880658436214,5.66666666666667
2010,University of Maryland,IvoryWSDa,81,1000,863,137,1.0989010989011,2.91489361702128
2010,University of Maryland,IvoryWSDa,82,1000,936,64,1.03950103950104,2.46153846153846
2010,University of Maryland,IvoryWSDa,83,1000,860,140,1.08459869848156,2.25806451612903
2010,University of Maryland,IvoryWSDa,84,1000,909,91,1.05596620908131,2.39473684210526
2010,University of Maryland,IvoryWSDa,85,1000,965,35,1.0183299389002,2.05882352941176
2010,University of Maryland,IvoryWSDa,86,1000,951,49,1.02564102564103,2.04166666666667
2010,University of Maryland,IvoryWSDa,87,1000,929,71,1.04166666666667,2.29032258064516
2010,University of Maryland,IvoryWSDa,88,1000,954,46,1.02669404517454,2.3
2010,University of Maryland,IvoryWSDa,89,1000,953,47,1.02564102564103,2.13636363636364
2010,University of Maryland,IvoryWSDa,90,1000,942,58,1.03412616339193,2.32
2010,University of Maryland,IvoryWSDa,91,1000,865,135,1.09649122807018,2.87234042553192
2010,University of Maryland,IvoryWSDa,92,1000,942,58,1.03412616339193,2.32
2010,University of Maryland,IvoryWSDa,93,1000,952,48,1.02880658436214,2.4
2010,University of Maryland,IvoryWSDa,94,1000,906,94,1.05932203389831,2.47368421052632
2010,University of Maryland,IvoryWSDa,95,1000,945,55,1.03092783505155,2.2
2010,University of Maryland,IvoryWSDa,96,1000,936,64,1.03626943005181,2.20689655172414
2010,University of Maryland,IvoryWSDa,97,1000,947,53,1.02880658436214,2.12
2010,University of Maryland,IvoryWSDa,98,1000,957,43,1.02669404517454,2.52941176470588
2010,University of Maryland,IvoryWSDa,99,1000,774,226,1.16822429906542,2.75609756097561
2010,University of Maryland,IvoryWSDa,100,1000,926,74,1.05042016806723,2.84615384615385
2010,University of Southern California / ISI,IvoryWSDb,51,1000,934,66,1.03626943005181,2.12903225806452
2010,University of Southern California / ISI,IvoryWSDb,52,1000,919,81,1.04493207941484,2.13157894736842
2010,University of Southern California / ISI,IvoryWSDb,53,1000,960,40,1.02354145342886,2.35294117647059
2010,University of Southern California / ISI,IvoryWSDb,54,1000,748,252,1.18063754427391,2.54545454545455
2010,University of Southern California / ISI,IvoryWSDb,55,1000,807,193,1.12866817155756,2.44303797468354
2010,University of Southern California / ISI,IvoryWSDb,56,1000,820,180,1.11856823266219,2.43243243243243
2010,University of Southern California / ISI,IvoryWSDb,57,1000,955,45,1.02459016393443,2.14285714285714
2010,University of Southern California / ISI,IvoryWSDb,58,1000,914,86,1.0515247108307,2.32432432432432
2010,University of Southern California / ISI,IvoryWSDb,59,1000,928,72,1.04275286757039,2.32258064516129
2010,University of Southern California / ISI,IvoryWSDb,60,1000,918,82,1.04493207941484,2.1025641025641
2010,University of Southern California / ISI,IvoryWSDb,61,1000,867,133,1.08225108225108,2.33333333333333
2010,University of Southern California / ISI,IvoryWSDb,62,1000,917,83,1.05708245243129,2.86206896551724
2010,University of Southern California / ISI,IvoryWSDb,63,1000,920,80,1.04493207941484,2.16216216216216
2010,University of Southern California / ISI,IvoryWSDb,64,1000,891,109,1.06609808102345,2.31914893617021
2010,University of Southern California / ISI,IvoryWSDb,65,1000,869,131,1.08342361863489,2.42592592592593
2010,University of Southern California / ISI,IvoryWSDb,66,1000,942,58,1.0351966873706,2.41666666666667
2010,University of Southern California / ISI,IvoryWSDb,67,1000,869,131,1.08695652173913,2.56862745098039
2010,University of Southern California / ISI,IvoryWSDb,68,1000,968,32,1.01729399796541,2.13333333333333
2010,University of Southern California / ISI,IvoryWSDb,69,1000,900,100,1.07874865156419,3.7037037037037
2010,University of Southern California / ISI,IvoryWSDb,70,1000,930,70,1.03950103950104,2.1875
2010,University of Southern California / ISI,IvoryWSDb,71,1000,890,110,1.07758620689655,2.89473684210526
2010,University of Southern California / ISI,IvoryWSDb,72,1000,853,147,1.10132158590308,2.67272727272727
2010,University of Southern California / ISI,IvoryWSDb,73,1000,862,138,1.08695652173913,2.37931034482759
2010,University of Southern California / ISI,IvoryWSDb,74,1000,945,55,1.03199174406605,2.29166666666667
2010,University of Southern California / ISI,IvoryWSDb,75,1000,844,156,1.09170305676856,2.16666666666667
2010,University of Southern California / ISI,IvoryWSDb,76,1000,956,44,1.02774922918808,2.58823529411765
2010,University of Southern California / ISI,IvoryWSDb,77,1000,927,73,1.04058272632674,2.14705882352941
2010,University of Southern California / ISI,IvoryWSDb,78,1000,942,58,1.03305785123967,2.23076923076923
2010,University of Southern California / ISI,IvoryWSDb,79,1000,871,129,1.08108108108108,2.38888888888889
2010,University of Southern California / ISI,IvoryWSDb,80,1000,980,20,1.01010101010101,2
2010,University of Southern California / ISI,IvoryWSDb,81,1000,821,179,1.13765642775882,3.08620689655172
2010,University of Southern California / ISI,IvoryWSDb,82,1000,832,168,1.11482720178372,2.58461538461539
2010,University of Southern California / ISI,IvoryWSDb,83,1000,886,114,1.06496272630458,2.15094339622642
2010,University of Southern California / ISI,IvoryWSDb,84,1000,881,119,1.07066381156317,2.24528301886792
2010,University of Southern California / ISI,IvoryWSDb,85,1000,931,69,1.03734439834025,2.09090909090909
2010,University of Southern California / ISI,IvoryWSDb,86,1000,936,64,1.03734439834025,2.28571428571429
2010,University of Southern California / ISI,IvoryWSDb,87,1000,825,175,1.12359550561798,2.69230769230769
2010,University of Southern California / ISI,IvoryWSDb,88,1000,928,72,1.04602510460251,2.57142857142857
2010,University of Southern California / ISI,IvoryWSDb,89,1000,946,54,1.02986611740474,2.16
2010,University of Southern California / ISI,IvoryWSDb,90,1000,937,63,1.04058272632674,2.625
2010,University of Southern California / ISI,IvoryWSDb,91,1000,964,36,1.02145045965271,2.4
2010,University of Southern California / ISI,IvoryWSDb,92,1000,899,101,1.05820105820106,2.19565217391304
2010,University of Southern California / ISI,IvoryWSDb,93,1000,949,51,1.02880658436214,2.21739130434783
2010,University of Southern California / ISI,IvoryWSDb,94,1000,840,160,1.1001100110011,2.31884057971015
2010,University of Southern California / ISI,IvoryWSDb,95,1000,937,63,1.05042016806723,4.2
2010,University of Southern California / ISI,IvoryWSDb,96,1000,879,121,1.07411385606874,2.32692307692308
2010,University of Southern California / ISI,IvoryWSDb,97,1000,942,58,1.03412616339193,2.32
2010,University of Southern California / ISI,IvoryWSDb,98,1000,946,54,1.03412616339193,2.57142857142857
2010,University of Southern California / ISI,IvoryWSDb,99,1000,854,146,1.09769484083425,2.56140350877193
2010,University of Southern California / ISI,IvoryWSDb,100,1000,988,12,1.00603621730382,2
2010,University College London (Media Futures Group),MF1,51,1000,470,530,1.55038759689923,3.02857142857143
2010,University College London (Media Futures Group),MF1,52,1000,186,814,2.77777777777778,4.67816091954023
2010,University College London (Media Futures Group),MF1,53,1000,330,670,2.24215246636771,5.77586206896552
2010,University College London (Media Futures Group),MF1,54,1000,872,128,1.07296137339056,2.13333333333333
2010,University College London (Media Futures Group),MF1,55,1000,228,772,2.4330900243309,4.21857923497268
2010,University College London (Media Futures Group),MF1,56,1000,501,499,1.51057401812689,3.09937888198758
2010,University College London (Media Futures Group),MF1,57,1000,594,406,1.41043723554302,3.5304347826087
2010,University College London (Media Futures Group),MF1,58,1000,243,757,2.34741784037559,4.13661202185792
2010,University College London (Media Futures Group),MF1,59,1000,582,418,1.35685210312076,2.69677419354839
2010,University College London (Media Futures Group),MF1,60,1000,180,820,2.61096605744125,4.03940886699507
2010,University College London (Media Futures Group),MF1,61,1000,205,795,2.6525198938992,4.62209302325581
2010,University College London (Media Futures Group),MF1,62,1000,697,303,1.24069478908189,2.77981651376147
2010,University College London (Media Futures Group),MF1,63,1000,201,799,2.63157894736842,4.46368715083799
2010,University College London (Media Futures Group),MF1,64,1000,177,823,2.90697674418605,4.92814371257485
2010,University College London (Media Futures Group),MF1,65,1000,636,364,1.30548302872063,2.8
2010,University College London (Media Futures Group),MF1,66,1000,228,772,2.40963855421687,4.1283422459893
2010,University College London (Media Futures Group),MF1,67,1000,311,689,2.1551724137931,4.50326797385621
2010,University College London (Media Futures Group),MF1,68,1000,185,815,2.71739130434783,4.45355191256831
2010,University College London (Media Futures Group),MF1,69,1000,547,453,1.41643059490085,2.84905660377359
2010,University College London (Media Futures Group),MF1,70,1000,294,706,2.04498977505112,3.62051282051282
2010,University College London (Media Futures Group),MF1,71,1000,542,458,1.5748031496063,4.9247311827957
2010,University College London (Media Futures Group),MF1,72,1000,311,689,1.96463654223969,3.47979797979798
2010,University College London (Media Futures Group),MF1,73,1000,458,542,1.63132137030995,3.49677419354839
2010,University College London (Media Futures Group),MF1,74,1000,126,874,3.690036900369,6.02758620689655
2010,University College London (Media Futures Group),MF1,75,1000,207,793,2.37529691211401,3.70560747663551
2010,University College London (Media Futures Group),MF1,76,1000,607,393,1.34228187919463,2.84782608695652
2010,University College London (Media Futures Group),MF1,77,1000,143,857,3.16455696202532,4.95375722543353
2010,University College London (Media Futures Group),MF1,78,1000,314,686,1.91204588910134,3.2822966507177
2010,University College London (Media Futures Group),MF1,79,1000,168,832,3.15457413249211,5.58389261744966
2010,University College London (Media Futures Group),MF1,80,1000,738,262,1.19617224880383,2.6734693877551
2010,University College London (Media Futures Group),MF1,81,1000,224,776,2.42130750605327,4.10582010582011
2010,University College London (Media Futures Group),MF1,82,1000,209,791,2.56410256410256,4.37016574585635
2010,University College London (Media Futures Group),MF1,83,1000,20,980,21.2765957446809,36.2962962962963
2010,University College London (Media Futures Group),MF1,84,1000,463,537,1.61290322580645,3.4203821656051
2010,University College London (Media Futures Group),MF1,85,1000,437,563,1.68350168350168,3.5859872611465
2010,University College London (Media Futures Group),MF1,86,1000,332,668,1.94552529182879,3.67032967032967
2010,University College London (Media Futures Group),MF1,87,1000,136,864,4,7.57894736842105
2010,University College London (Media Futures Group),MF1,88,1000,395,605,1.77304964539007,3.57988165680473
2010,University College London (Media Futures Group),MF1,89,1000,189,811,2.55102040816327,3.99507389162562
2010,University College London (Media Futures Group),MF1,90,1000,116,884,4,6.59701492537313
2010,University College London (Media Futures Group),MF1,91,1000,794,206,1.14025085518814,2.48192771084337
2010,University College London (Media Futures Group),MF1,92,1000,227,773,2.40384615384615,4.08994708994709
2010,University College London (Media Futures Group),MF1,93,1000,140,860,3.41296928327645,5.62091503267974
2010,University College London (Media Futures Group),MF1,94,1000,236,764,2.29357798165138,3.82
2010,University College London (Media Futures Group),MF1,95,1000,185,815,2.5974025974026,4.075
2010,University College London (Media Futures Group),MF1,96,1000,226,774,2.42718446601942,4.16129032258065
2010,University College London (Media Futures Group),MF1,97,1000,650,350,1.26742712294043,2.51798561151079
2010,University College London (Media Futures Group),MF1,98,1000,244,756,2.26244343891403,3.81818181818182
2010,University College London (Media Futures Group),MF1,99,1000,316,684,1.953125,3.48979591836735
2010,University College London (Media Futures Group),MF1,100,1000,585,415,1.39082058414465,3.09701492537313
2010,University College London (Media Futures Group),MF2,51,1000,448,552,1.61030595813205,3.19075144508671
2010,University College London (Media Futures Group),MF2,52,1000,170,830,3.003003003003,5.0920245398773
2010,University College London (Media Futures Group),MF2,53,1000,129,871,6.17283950617284,26.3939393939394
2010,University College London (Media Futures Group),MF2,54,1000,784,216,1.14678899082569,2.45454545454545
2010,University College London (Media Futures Group),MF2,55,1000,166,834,2.89855072463768,4.65921787709497
2010,University College London (Media Futures Group),MF2,56,1000,493,507,1.62866449511401,4.1900826446281
2010,University College London (Media Futures Group),MF2,57,1000,567,433,1.43266475644699,3.30534351145038
2010,University College London (Media Futures Group),MF2,58,1000,186,814,2.78551532033426,4.70520231213873
2010,University College London (Media Futures Group),MF2,59,1000,479,521,1.57232704402516,3.31847133757962
2010,University College London (Media Futures Group),MF2,60,1000,149,851,3.03951367781155,4.72777777777778
2010,University College London (Media Futures Group),MF2,61,1000,170,830,2.9940119760479,5.0609756097561
2010,University College London (Media Futures Group),MF2,62,1000,585,415,1.41242937853107,3.3739837398374
2010,University College London (Media Futures Group),MF2,63,1000,171,829,3.003003003003,5.11728395061728
2010,University College London (Media Futures Group),MF2,64,1000,148,852,3.34448160535117,5.64238410596027
2010,University College London (Media Futures Group),MF2,65,1000,557,443,1.4265335235378,3.07638888888889
2010,University College London (Media Futures Group),MF2,66,1000,228,772,2.40963855421687,4.1283422459893
2010,University College London (Media Futures Group),MF2,67,1000,369,631,1.91204588910134,4.0974025974026
2010,University College London (Media Futures Group),MF2,68,1000,155,845,3.13479623824451,5.15243902439024
2010,University College London (Media Futures Group),MF2,69,1000,471,529,1.59235668789809,3.36942675159236
2010,University College London (Media Futures Group),MF2,70,1000,221,779,2.5706940874036,4.63690476190476
2010,University College London (Media Futures Group),MF2,71,1000,379,621,1.97628458498024,4.88976377952756
2010,University College London (Media Futures Group),MF2,72,1000,232,768,2.40963855421687,4.19672131147541
2010,University College London (Media Futures Group),MF2,73,1000,470,530,1.6,3.41935483870968
2010,University College London (Media Futures Group),MF2,74,1000,120,880,3.73134328358209,5.94594594594595
2010,University College London (Media Futures Group),MF2,75,1000,175,825,2.63157894736842,4.02439024390244
2010,University College London (Media Futures Group),MF2,76,1000,487,513,1.54559505409583,3.20625
2010,University College London (Media Futures Group),MF2,77,1000,129,871,3.38983050847458,5.24698795180723
2010,University College London (Media Futures Group),MF2,78,1000,262,738,2.16450216450216,3.69
2010,University College London (Media Futures Group),MF2,79,1000,136,864,3.53356890459364,5.87755102040816
2010,University College London (Media Futures Group),MF2,80,1000,676,324,1.25628140703518,2.7
2010,University College London (Media Futures Group),MF2,81,1000,167,833,3.18471337579618,5.66666666666667
2010,University College London (Media Futures Group),MF2,82,1000,155,845,3.11526479750779,5.09036144578313
2010,University College London (Media Futures Group),MF2,83,1000,24,976,20,37.5384615384615
2010,University College London (Media Futures Group),MF2,84,1000,390,610,1.78890876565295,3.6094674556213
2010,University College London (Media Futures Group),MF2,85,1000,413,587,1.76056338028169,3.78709677419355
2010,University College London (Media Futures Group),MF2,86,1000,235,765,2.52525252525253,4.75155279503106
2010,University College London (Media Futures Group),MF2,87,1000,316,684,2.39808153477218,6.77227722772277
2010,University College London (Media Futures Group),MF2,88,1000,353,647,1.94174757281553,3.99382716049383
2010,University College London (Media Futures Group),MF2,89,1000,174,826,2.73224043715847,4.30208333333333
2010,University College London (Media Futures Group),MF2,90,1000,108,892,4.42477876106195,7.55932203389831
2010,University College London (Media Futures Group),MF2,91,1000,625,375,1.35685210312076,3.34821428571429
2010,University College London (Media Futures Group),MF2,92,1000,170,830,2.84090909090909,4.56043956043956
2010,University College London (Media Futures Group),MF2,93,1000,105,895,4.11522633744856,6.48550724637681
2010,University College London (Media Futures Group),MF2,94,1000,186,814,2.710027100271,4.44808743169399
2010,University College London (Media Futures Group),MF2,95,1000,185,815,2.5974025974026,4.075
2010,University College London (Media Futures Group),MF2,96,1000,170,830,2.94985250737463,4.9112426035503
2010,University College London (Media Futures Group),MF2,97,1000,549,451,1.42045454545455,2.90967741935484
2010,University College London (Media Futures Group),MF2,98,1000,176,824,2.9585798816568,5.08641975308642
2010,University College London (Media Futures Group),MF2,99,1000,316,684,1.953125,3.48979591836735
2010,University College London (Media Futures Group),MF2,100,1000,573,427,1.40252454417952,3.05
2010,"Cluster of Excellence """"Multimodal Computing and Interaction"""" (MMCI)",MMCITLCLl20M,51,1000,792,208,1.12233445566779,2.1010101010101
2010,"Cluster of Excellence """"Multimodal Computing and Interaction"""" (MMCI)",MMCITLCLl20M,52,1000,84,916,3.08641975308642,3.81666666666667
2010,"Cluster of Excellence """"Multimodal Computing and Interaction"""" (MMCI)",MMCITLCLl20M,53,1000,928,72,1.04493207941484,2.48275862068966
2010,"Cluster of Excellence """"Multimodal Computing and Interaction"""" (MMCI)",MMCITLCLl20M,54,1000,678,322,1.24378109452736,2.55555555555556
2010,"Cluster of Excellence """"Multimodal Computing and Interaction"""" (MMCI)",MMCITLCLl20M,55,1000,11,989,11.9047619047619,13.5479452054795
2010,"Cluster of Excellence """"Multimodal Computing and Interaction"""" (MMCI)",MMCITLCLl20M,56,1000,829,171,1.10987791342952,2.375
2010,"Cluster of Excellence """"Multimodal Computing and Interaction"""" (MMCI)",MMCITLCLl20M,57,1000,830,170,1.14285714285714,3.77777777777778
2010,"Cluster of Excellence """"Multimodal Computing and Interaction"""" (MMCI)",MMCITLCLl20M,58,1000,10,990,9.61538461538461,10.531914893617
2010,"Cluster of Excellence """"Multimodal Computing and Interaction"""" (MMCI)",MMCITLCLl20M,59,1000,908,92,1.05042016806723,2.09090909090909
2010,"Cluster of Excellence """"Multimodal Computing and Interaction"""" (MMCI)",MMCITLCLl20M,60,1000,25,975,7.46268656716418,8.94495412844037
2010,"Cluster of Excellence """"Multimodal Computing and Interaction"""" (MMCI)",MMCITLCLl20M,61,1000,35,965,5.81395348837209,7.04379562043796
2010,"Cluster of Excellence """"Multimodal Computing and Interaction"""" (MMCI)",MMCITLCLl20M,62,1000,787,213,1.15740740740741,2.76623376623377
2010,"Cluster of Excellence """"Multimodal Computing and Interaction"""" (MMCI)",MMCITLCLl20M,63,1000,30,970,9.25925925925926,12.4358974358974
2010,"Cluster of Excellence """"Multimodal Computing and Interaction"""" (MMCI)",MMCITLCLl20M,64,1000,56,944,3.86100386100386,4.65024630541872
2010,"Cluster of Excellence """"Multimodal Computing and Interaction"""" (MMCI)",MMCITLCLl20M,65,1000,25,975,10.5263157894737,13.9285714285714
2010,"Cluster of Excellence """"Multimodal Computing and Interaction"""" (MMCI)",MMCITLCLl20M,66,1000,933,67,1.04712041884817,3.04545454545455
2010,"Cluster of Excellence """"Multimodal Computing and Interaction"""" (MMCI)",MMCITLCLl20M,67,1000,879,121,1.07642626480086,2.42
2010,"Cluster of Excellence """"Multimodal Computing and Interaction"""" (MMCI)",MMCITLCLl20M,68,1000,24,976,5.37634408602151,6.02469135802469
2010,"Cluster of Excellence """"Multimodal Computing and Interaction"""" (MMCI)",MMCITLCLl20M,69,1000,762,238,1.14678899082569,2.16363636363636
2010,"Cluster of Excellence """"Multimodal Computing and Interaction"""" (MMCI)",MMCITLCLl20M,70,1000,15,985,13.1578947368421,16.1475409836066
2010,"Cluster of Excellence """"Multimodal Computing and Interaction"""" (MMCI)",MMCITLCLl20M,71,1000,800,200,1.15207373271889,2.94117647058824
2010,"Cluster of Excellence """"Multimodal Computing and Interaction"""" (MMCI)",MMCITLCLl20M,72,1000,3,997,15.1515151515152,15.8253968253968
2010,"Cluster of Excellence """"Multimodal Computing and Interaction"""" (MMCI)",MMCITLCLl20M,73,1000,900,100,1.05932203389831,2.27272727272727
2010,"Cluster of Excellence """"Multimodal Computing and Interaction"""" (MMCI)",MMCITLCLl20M,74,1000,48,952,4.20168067226891,5.01052631578947
2010,"Cluster of Excellence """"Multimodal Computing and Interaction"""" (MMCI)",MMCITLCLl20M,75,1000,22,978,6.17283950617284,6.98571428571429
2010,"Cluster of Excellence """"Multimodal Computing and Interaction"""" (MMCI)",MMCITLCLl20M,76,1000,861,139,1.08225108225108,2.20634920634921
2010,"Cluster of Excellence """"Multimodal Computing and Interaction"""" (MMCI)",MMCITLCLl20M,77,1000,47,953,5,6.22875816993464
2010,"Cluster of Excellence """"Multimodal Computing and Interaction"""" (MMCI)",MMCITLCLl20M,78,1000,5,995,15.1515151515152,16.3114754098361
2010,"Cluster of Excellence """"Multimodal Computing and Interaction"""" (MMCI)",MMCITLCLl20M,79,1000,17,983,12.3456790123457,15.359375
2010,"Cluster of Excellence """"Multimodal Computing and Interaction"""" (MMCI)",MMCITLCLl20M,80,1000,917,83,1.05374077976818,2.59375
2010,"Cluster of Excellence """"Multimodal Computing and Interaction"""" (MMCI)",MMCITLCLl20M,81,1000,17,983,7.93650793650794,9.01834862385321
2010,"Cluster of Excellence """"Multimodal Computing and Interaction"""" (MMCI)",MMCITLCLl20M,82,1000,18,982,6.32911392405063,7.01428571428571
2010,"Cluster of Excellence """"Multimodal Computing and Interaction"""" (MMCI)",MMCITLCLl20M,83,1000,8,992,40,58.3529411764706
2010,"Cluster of Excellence """"Multimodal Computing and Interaction"""" (MMCI)",MMCITLCLl20M,84,1000,695,305,1.22399020807834,2.5
2010,"Cluster of Excellence """"Multimodal Computing and Interaction"""" (MMCI)",MMCITLCLl20M,85,1000,935,65,1.03626943005181,2.16666666666667
2010,"Cluster of Excellence """"Multimodal Computing and Interaction"""" (MMCI)",MMCITLCLl20M,86,1000,806,194,1.13895216400911,2.69444444444444
2010,"Cluster of Excellence """"Multimodal Computing and Interaction"""" (MMCI)",MMCITLCLl20M,87,1000,810,190,1.12107623318386,2.31707317073171
2010,"Cluster of Excellence """"Multimodal Computing and Interaction"""" (MMCI)",MMCITLCLl20M,88,1000,890,110,1.06269925611052,2.15686274509804
2010,"Cluster of Excellence """"Multimodal Computing and Interaction"""" (MMCI)",MMCITLCLl20M,89,1000,22,978,4.83091787439614,5.28648648648649
2010,"Cluster of Excellence """"Multimodal Computing and Interaction"""" (MMCI)",MMCITLCLl20M,90,1000,151,849,2.53807106598985,3.49382716049383
2010,"Cluster of Excellence """"Multimodal Computing and Interaction"""" (MMCI)",MMCITLCLl20M,91,1000,612,388,1.37551581843191,3.37391304347826
2010,"Cluster of Excellence """"Multimodal Computing and Interaction"""" (MMCI)",MMCITLCLl20M,92,1000,9,991,10.2040816326531,11.1348314606742
2010,"Cluster of Excellence """"Multimodal Computing and Interaction"""" (MMCI)",MMCITLCLl20M,93,1000,80,920,3.25732899022801,4.05286343612335
2010,"Cluster of Excellence """"Multimodal Computing and Interaction"""" (MMCI)",MMCITLCLl20M,94,1000,28,972,5.95238095238095,6.94285714285714
2010,"Cluster of Excellence """"Multimodal Computing and Interaction"""" (MMCI)",MMCITLCLl20M,95,1000,903,97,1.06951871657754,3.03125
2010,"Cluster of Excellence """"Multimodal Computing and Interaction"""" (MMCI)",MMCITLCLl20M,96,1000,17,983,9.61538461538461,11.2988505747126
2010,"Cluster of Excellence """"Multimodal Computing and Interaction"""" (MMCI)",MMCITLCLl20M,97,1000,625,375,1.38888888888889,3.94736842105263
2010,"Cluster of Excellence """"Multimodal Computing and Interaction"""" (MMCI)",MMCITLCLl20M,98,1000,21,979,7.35294117647059,8.51304347826087
2010,"Cluster of Excellence """"Multimodal Computing and Interaction"""" (MMCI)",MMCITLCLl20M,99,1000,21,979,10.8695652173913,13.7887323943662
2010,"Cluster of Excellence """"Multimodal Computing and Interaction"""" (MMCI)",MMCITLCLl20M,100,1000,848,152,1.09649122807018,2.375
2010,"Cluster of Excellence """"Multimodal Computing and Interaction"""" (MMCI)",MMCITLl20M,51,1000,760,240,1.14942528735632,2.18181818181818
2010,"Cluster of Excellence """"Multimodal Computing and Interaction"""" (MMCI)",MMCITLl20M,52,1000,84,916,3.08641975308642,3.81666666666667
2010,"Cluster of Excellence """"Multimodal Computing and Interaction"""" (MMCI)",MMCITLl20M,53,1000,840,160,1.11358574610245,2.75862068965517
2010,"Cluster of Excellence """"Multimodal Computing and Interaction"""" (MMCI)",MMCITLl20M,54,1000,571,429,1.40449438202247,3.04255319148936
2010,"Cluster of Excellence """"Multimodal Computing and Interaction"""" (MMCI)",MMCITLl20M,55,1000,11,989,11.9047619047619,13.5479452054795
2010,"Cluster of Excellence """"Multimodal Computing and Interaction"""" (MMCI)",MMCITLl20M,56,1000,813,187,1.11731843575419,2.28048780487805
2010,"Cluster of Excellence """"Multimodal Computing and Interaction"""" (MMCI)",MMCITLl20M,57,1000,731,269,1.22249388753056,3.09195402298851
2010,"Cluster of Excellence """"Multimodal Computing and Interaction"""" (MMCI)",MMCITLl20M,58,1000,10,990,9.61538461538461,10.531914893617
2010,"Cluster of Excellence """"Multimodal Computing and Interaction"""" (MMCI)",MMCITLl20M,59,1000,453,547,2.02839756592292,13.675
2010,"Cluster of Excellence """"Multimodal Computing and Interaction"""" (MMCI)",MMCITLl20M,60,1000,25,975,7.46268656716418,8.94495412844037
2010,"Cluster of Excellence """"Multimodal Computing and Interaction"""" (MMCI)",MMCITLl20M,61,1000,35,965,5.81395348837209,7.04379562043796
2010,"Cluster of Excellence """"Multimodal Computing and Interaction"""" (MMCI)",MMCITLl20M,62,1000,786,214,1.15740740740741,2.74358974358974
2010,"Cluster of Excellence """"Multimodal Computing and Interaction"""" (MMCI)",MMCITLl20M,63,1000,30,970,9.25925925925926,12.4358974358974
2010,"Cluster of Excellence """"Multimodal Computing and Interaction"""" (MMCI)",MMCITLl20M,64,1000,56,944,3.86100386100386,4.65024630541872
2010,"Cluster of Excellence """"Multimodal Computing and Interaction"""" (MMCI)",MMCITLl20M,65,1000,12,988,16.6666666666667,20.5833333333333
2010,"Cluster of Excellence """"Multimodal Computing and Interaction"""" (MMCI)",MMCITLl20M,66,1000,917,83,1.0482180293501,2.24324324324324
2010,"Cluster of Excellence """"Multimodal Computing and Interaction"""" (MMCI)",MMCITLl20M,67,1000,869,131,1.08342361863489,2.42592592592593
2010,"Cluster of Excellence """"Multimodal Computing and Interaction"""" (MMCI)",MMCITLl20M,68,1000,24,976,5.37634408602151,6.02469135802469
2010,"Cluster of Excellence """"Multimodal Computing and Interaction"""" (MMCI)",MMCITLl20M,69,1000,708,292,1.20772946859903,2.43333333333333
2010,"Cluster of Excellence """"Multimodal Computing and Interaction"""" (MMCI)",MMCITLl20M,70,1000,15,985,13.1578947368421,16.1475409836066
2010,"Cluster of Excellence """"Multimodal Computing and Interaction"""" (MMCI)",MMCITLl20M,71,1000,851,149,1.1037527593819,2.70909090909091
2010,"Cluster of Excellence """"Multimodal Computing and Interaction"""" (MMCI)",MMCITLl20M,72,1000,3,997,15.1515151515152,15.8253968253968
2010,"Cluster of Excellence """"Multimodal Computing and Interaction"""" (MMCI)",MMCITLl20M,73,1000,835,165,1.1037527593819,2.32394366197183
2010,"Cluster of Excellence """"Multimodal Computing and Interaction"""" (MMCI)",MMCITLl20M,74,1000,48,952,4.20168067226891,5.01052631578947
2010,"Cluster of Excellence """"Multimodal Computing and Interaction"""" (MMCI)",MMCITLl20M,75,1000,22,978,6.17283950617284,6.98571428571429
2010,"Cluster of Excellence """"Multimodal Computing and Interaction"""" (MMCI)",MMCITLl20M,76,1000,853,147,1.08932461873638,2.26153846153846
2010,"Cluster of Excellence """"Multimodal Computing and Interaction"""" (MMCI)",MMCITLl20M,77,1000,47,953,5,6.22875816993464
2010,"Cluster of Excellence """"Multimodal Computing and Interaction"""" (MMCI)",MMCITLl20M,78,1000,5,995,15.1515151515152,16.3114754098361
2010,"Cluster of Excellence """"Multimodal Computing and Interaction"""" (MMCI)",MMCITLl20M,79,1000,17,983,12.3456790123457,15.359375
2010,"Cluster of Excellence """"Multimodal Computing and Interaction"""" (MMCI)",MMCITLl20M,80,1000,950,50,1.02669404517454,2.08333333333333
2010,"Cluster of Excellence """"Multimodal Computing and Interaction"""" (MMCI)",MMCITLl20M,81,1000,17,983,7.93650793650794,9.01834862385321
2010,"Cluster of Excellence """"Multimodal Computing and Interaction"""" (MMCI)",MMCITLl20M,82,1000,18,982,6.32911392405063,7.01428571428571
2010,"Cluster of Excellence """"Multimodal Computing and Interaction"""" (MMCI)",MMCITLl20M,83,1000,8,992,40,58.3529411764706
2010,"Cluster of Excellence """"Multimodal Computing and Interaction"""" (MMCI)",MMCITLl20M,84,1000,692,308,1.22549019607843,2.48387096774194
2010,"Cluster of Excellence """"Multimodal Computing and Interaction"""" (MMCI)",MMCITLl20M,85,1000,887,113,1.07066381156317,2.40425531914894
2010,"Cluster of Excellence """"Multimodal Computing and Interaction"""" (MMCI)",MMCITLl20M,86,1000,823,177,1.12866817155756,2.80952380952381
2010,"Cluster of Excellence """"Multimodal Computing and Interaction"""" (MMCI)",MMCITLl20M,87,1000,815,185,1.12485939257593,2.5
2010,"Cluster of Excellence """"Multimodal Computing and Interaction"""" (MMCI)",MMCITLl20M,88,1000,876,124,1.07296137339056,2.21428571428571
2010,"Cluster of Excellence """"Multimodal Computing and Interaction"""" (MMCI)",MMCITLl20M,89,1000,22,978,4.83091787439614,5.28648648648649
2010,"Cluster of Excellence """"Multimodal Computing and Interaction"""" (MMCI)",MMCITLl20M,90,1000,151,849,2.53807106598985,3.49382716049383
2010,"Cluster of Excellence """"Multimodal Computing and Interaction"""" (MMCI)",MMCITLl20M,91,1000,822,178,1.10864745011086,2.225
2010,"Cluster of Excellence """"Multimodal Computing and Interaction"""" (MMCI)",MMCITLl20M,92,1000,9,991,10.2040816326531,11.1348314606742
2010,"Cluster of Excellence """"Multimodal Computing and Interaction"""" (MMCI)",MMCITLl20M,93,1000,80,920,3.25732899022801,4.05286343612335
2010,"Cluster of Excellence """"Multimodal Computing and Interaction"""" (MMCI)",MMCITLl20M,94,1000,28,972,5.95238095238095,6.94285714285714
2010,"Cluster of Excellence """"Multimodal Computing and Interaction"""" (MMCI)",MMCITLl20M,95,1000,803,197,1.15874855156431,3.28333333333333
2010,"Cluster of Excellence """"Multimodal Computing and Interaction"""" (MMCI)",MMCITLl20M,96,1000,17,983,9.61538461538461,11.2988505747126
2010,"Cluster of Excellence """"Multimodal Computing and Interaction"""" (MMCI)",MMCITLl20M,97,1000,341,659,1.92678227360308,3.70224719101124
2010,"Cluster of Excellence """"Multimodal Computing and Interaction"""" (MMCI)",MMCITLl20M,98,1000,21,979,7.35294117647059,8.51304347826087
2010,"Cluster of Excellence """"Multimodal Computing and Interaction"""" (MMCI)",MMCITLl20M,99,1000,21,979,10.8695652173913,13.7887323943662
2010,"Cluster of Excellence """"Multimodal Computing and Interaction"""" (MMCI)",MMCITLl20M,100,1000,851,149,1.09769484083425,2.48333333333333
2010,"Cluster of Excellence """"Multimodal Computing and Interaction"""" (MMCI)",MMCIl410m1,51,1000,561,439,1.48588410104012,3.91964285714286
2010,"Cluster of Excellence """"Multimodal Computing and Interaction"""" (MMCI)",MMCIl410m1,52,410,71,339,2.30337078651685,3.16822429906542
2010,"Cluster of Excellence """"Multimodal Computing and Interaction"""" (MMCI)",MMCIl410m1,53,1000,801,199,1.13122171945701,2.39759036144578
2010,"Cluster of Excellence """"Multimodal Computing and Interaction"""" (MMCI)",MMCIl410m1,54,1000,420,580,1.69491525423729,3.41176470588235
2010,"Cluster of Excellence """"Multimodal Computing and Interaction"""" (MMCI)",MMCIl410m1,55,410,12,398,6.72131147540984,8.12244897959184
2010,"Cluster of Excellence """"Multimodal Computing and Interaction"""" (MMCI)",MMCIl410m1,56,1000,788,212,1.15074798619102,2.61728395061728
2010,"Cluster of Excellence """"Multimodal Computing and Interaction"""" (MMCI)",MMCIl410m1,57,1000,333,667,2.55754475703325,11.5
2010,"Cluster of Excellence """"Multimodal Computing and Interaction"""" (MMCI)",MMCIl410m1,58,410,10,400,5.61643835616438,6.34920634920635
2010,"Cluster of Excellence """"Multimodal Computing and Interaction"""" (MMCI)",MMCIl410m1,59,1000,378,622,2.14592274678112,7.06818181818182
2010,"Cluster of Excellence """"Multimodal Computing and Interaction"""" (MMCI)",MMCIl410m1,60,410,25,385,4.36170212765957,5.57971014492754
2010,"Cluster of Excellence """"Multimodal Computing and Interaction"""" (MMCI)",MMCIl410m1,61,410,36,374,3.59649122807018,4.7948717948718
2010,"Cluster of Excellence """"Multimodal Computing and Interaction"""" (MMCI)",MMCIl410m1,62,1000,505,495,1.53374233128834,3.36734693877551
2010,"Cluster of Excellence """"Multimodal Computing and Interaction"""" (MMCI)",MMCIl410m1,63,410,30,380,4.76744186046512,6.78571428571429
2010,"Cluster of Excellence """"Multimodal Computing and Interaction"""" (MMCI)",MMCIl410m1,64,410,52,358,2.75167785234899,3.69072164948454
2010,"Cluster of Excellence """"Multimodal Computing and Interaction"""" (MMCI)",MMCIl410m1,65,1000,37,963,7.93650793650794,10.8202247191011
2010,"Cluster of Excellence """"Multimodal Computing and Interaction"""" (MMCI)",MMCIl410m1,66,1000,805,195,1.14810562571757,2.95454545454545
2010,"Cluster of Excellence """"Multimodal Computing and Interaction"""" (MMCI)",MMCIl410m1,67,1000,488,512,1.81488203266788,8.12698412698413
2010,"Cluster of Excellence """"Multimodal Computing and Interaction"""" (MMCI)",MMCIl410m1,68,410,24,386,4.27083333333333,5.36111111111111
2010,"Cluster of Excellence """"Multimodal Computing and Interaction"""" (MMCI)",MMCIl410m1,69,1000,350,650,2.13675213675214,5.50847457627119
2010,"Cluster of Excellence """"Multimodal Computing and Interaction"""" (MMCI)",MMCIl410m1,70,410,15,395,6.61290322580645,8.40425531914894
2010,"Cluster of Excellence """"Multimodal Computing and Interaction"""" (MMCI)",MMCIl410m1,71,1000,342,658,2.45098039215686,9.96969696969697
2010,"Cluster of Excellence """"Multimodal Computing and Interaction"""" (MMCI)",MMCIl410m1,72,410,4,406,9.53488372093023,10.4102564102564
2010,"Cluster of Excellence """"Multimodal Computing and Interaction"""" (MMCI)",MMCIl410m1,73,1000,418,582,1.82481751824818,4.47692307692308
2010,"Cluster of Excellence """"Multimodal Computing and Interaction"""" (MMCI)",MMCIl410m1,74,410,32,378,3.53448275862069,4.5
2010,"Cluster of Excellence """"Multimodal Computing and Interaction"""" (MMCI)",MMCIl410m1,75,410,22,388,4.18367346938776,5.10526315789474
2010,"Cluster of Excellence """"Multimodal Computing and Interaction"""" (MMCI)",MMCIl410m1,76,1000,399,601,1.94174757281553,5.18103448275862
2010,"Cluster of Excellence """"Multimodal Computing and Interaction"""" (MMCI)",MMCIl410m1,77,410,45,365,3.25396825396825,4.50617283950617
2010,"Cluster of Excellence """"Multimodal Computing and Interaction"""" (MMCI)",MMCIl410m1,78,410,5,405,11.3888888888889,13.0645161290323
2010,"Cluster of Excellence """"Multimodal Computing and Interaction"""" (MMCI)",MMCIl410m1,79,410,17,393,10.5128205128205,17.8636363636364
2010,"Cluster of Excellence """"Multimodal Computing and Interaction"""" (MMCI)",MMCIl410m1,80,1000,376,624,2.1505376344086,7.01123595505618
2010,"Cluster of Excellence """"Multimodal Computing and Interaction"""" (MMCI)",MMCIl410m1,81,410,16,394,4.40860215053763,5.11688311688312
2010,"Cluster of Excellence """"Multimodal Computing and Interaction"""" (MMCI)",MMCIl410m1,82,410,19,391,4.14141414141414,4.8875
2010,"Cluster of Excellence """"Multimodal Computing and Interaction"""" (MMCI)",MMCIl410m1,83,410,8,402,16.4,23.6470588235294
2010,"Cluster of Excellence """"Multimodal Computing and Interaction"""" (MMCI)",MMCIl410m1,84,1000,301,699,2.1551724137931,4.28834355828221
2010,"Cluster of Excellence """"Multimodal Computing and Interaction"""" (MMCI)",MMCIl410m1,85,1000,614,386,1.47275405007364,5.93846153846154
2010,"Cluster of Excellence """"Multimodal Computing and Interaction"""" (MMCI)",MMCIl410m1,86,1000,214,786,3.11526479750779,7.34579439252337
2010,"Cluster of Excellence """"Multimodal Computing and Interaction"""" (MMCI)",MMCIl410m1,87,1000,349,651,2.05761316872428,4.75182481751825
2010,"Cluster of Excellence """"Multimodal Computing and Interaction"""" (MMCI)",MMCIl410m1,88,1000,520,480,1.54559505409583,3.77952755905512
2010,"Cluster of Excellence """"Multimodal Computing and Interaction"""" (MMCI)",MMCIl410m1,89,410,18,392,4.01960784313726,4.66666666666667
2010,"Cluster of Excellence """"Multimodal Computing and Interaction"""" (MMCI)",MMCIl410m1,90,410,57,353,2.54658385093168,3.39423076923077
2010,"Cluster of Excellence """"Multimodal Computing and Interaction"""" (MMCI)",MMCIl410m1,91,1000,333,667,2.41545893719807,8.23456790123457
2010,"Cluster of Excellence """"Multimodal Computing and Interaction"""" (MMCI)",MMCIl410m1,92,410,9,401,6.02941176470588,6.79661016949153
2010,"Cluster of Excellence """"Multimodal Computing and Interaction"""" (MMCI)",MMCIl410m1,93,410,39,371,3.53448275862069,4.81818181818182
2010,"Cluster of Excellence """"Multimodal Computing and Interaction"""" (MMCI)",MMCIl410m1,94,410,28,382,3.98058252427184,5.09333333333333
2010,"Cluster of Excellence """"Multimodal Computing and Interaction"""" (MMCI)",MMCIl410m1,95,1000,461,539,1.71821305841924,4.45454545454545
2010,"Cluster of Excellence """"Multimodal Computing and Interaction"""" (MMCI)",MMCIl410m1,96,410,17,393,5.54054054054054,6.89473684210526
2010,"Cluster of Excellence """"Multimodal Computing and Interaction"""" (MMCI)",MMCIl410m1,97,1000,227,773,3.003003003003,7.29245283018868
2010,"Cluster of Excellence """"Multimodal Computing and Interaction"""" (MMCI)",MMCIl410m1,98,410,20,390,6.83333333333333,9.75
2010,"Cluster of Excellence """"Multimodal Computing and Interaction"""" (MMCI)",MMCIl410m1,99,410,21,389,5.46666666666667,7.2037037037037
2010,"Cluster of Excellence """"Multimodal Computing and Interaction"""" (MMCI)",MMCIl410m1,100,1000,714,286,1.20918984280532,2.53097345132743
2010,"Tsinghua University, Info Retrieval Group",THUIR10Qa,51,1000,1000,0,1,
2010,"Tsinghua University, Info Retrieval Group",THUIR10Qa,52,1000,1000,0,1,
2010,"Tsinghua University, Info Retrieval Group",THUIR10Qa,53,1000,998,2,1.001001001001,2
2010,"Tsinghua University, Info Retrieval Group",THUIR10Qa,54,1000,998,2,1.001001001001,2
2010,"Tsinghua University, Info Retrieval Group",THUIR10Qa,55,1000,1000,0,1,
2010,"Tsinghua University, Info Retrieval Group",THUIR10Qa,56,1000,1000,0,1,
2010,"Tsinghua University, Info Retrieval Group",THUIR10Qa,57,1000,1000,0,1,
2010,"Tsinghua University, Info Retrieval Group",THUIR10Qa,58,1000,1000,0,1,
2010,"Tsinghua University, Info Retrieval Group",THUIR10Qa,59,1000,1000,0,1,
2010,"Tsinghua University, Info Retrieval Group",THUIR10Qa,60,1000,1000,0,1,
2010,"Tsinghua University, Info Retrieval Group",THUIR10Qa,61,1000,1000,0,1,
2010,"Tsinghua University, Info Retrieval Group",THUIR10Qa,62,1000,1000,0,1,
2010,"Tsinghua University, Info Retrieval Group",THUIR10Qa,63,1000,1000,0,1,
2010,"Tsinghua University, Info Retrieval Group",THUIR10Qa,64,1000,1000,0,1,
2010,"Tsinghua University, Info Retrieval Group",THUIR10Qa,65,1000,998,2,1.001001001001,2
2010,"Tsinghua University, Info Retrieval Group",THUIR10Qa,66,1000,1000,0,1,
2010,"Tsinghua University, Info Retrieval Group",THUIR10Qa,67,1000,1000,0,1,
2010,"Tsinghua University, Info Retrieval Group",THUIR10Qa,68,1000,1000,0,1,
2010,"Tsinghua University, Info Retrieval Group",THUIR10Qa,69,1000,1000,0,1,
2010,"Tsinghua University, Info Retrieval Group",THUIR10Qa,70,1000,998,2,1.001001001001,2
2010,"Tsinghua University, Info Retrieval Group",THUIR10Qa,71,1000,1000,0,1,
2010,"Tsinghua University, Info Retrieval Group",THUIR10Qa,72,1000,1000,0,1,
2010,"Tsinghua University, Info Retrieval Group",THUIR10Qa,73,1000,1000,0,1,
2010,"Tsinghua University, Info Retrieval Group",THUIR10Qa,74,1000,1000,0,1,
2010,"Tsinghua University, Info Retrieval Group",THUIR10Qa,75,1000,1000,0,1,
2010,"Tsinghua University, Info Retrieval Group",THUIR10Qa,76,1000,1000,0,1,
2010,"Tsinghua University, Info Retrieval Group",THUIR10Qa,77,1000,1000,0,1,
2010,"Tsinghua University, Info Retrieval Group",THUIR10Qa,78,1000,1000,0,1,
2010,"Tsinghua University, Info Retrieval Group",THUIR10Qa,79,1000,1000,0,1,
2010,"Tsinghua University, Info Retrieval Group",THUIR10Qa,80,1000,1000,0,1,
2010,"Tsinghua University, Info Retrieval Group",THUIR10Qa,81,1000,998,2,1.001001001001,2
2010,"Tsinghua University, Info Retrieval Group",THUIR10Qa,82,1000,1000,0,1,
2010,"Tsinghua University, Info Retrieval Group",THUIR10Qa,83,1000,1000,0,1,
2010,"Tsinghua University, Info Retrieval Group",THUIR10Qa,84,1000,1000,0,1,
2010,"Tsinghua University, Info Retrieval Group",THUIR10Qa,85,1000,1000,0,1,
2010,"Tsinghua University, Info Retrieval Group",THUIR10Qa,86,1000,1000,0,1,
2010,"Tsinghua University, Info Retrieval Group",THUIR10Qa,87,1000,1000,0,1,
2010,"Tsinghua University, Info Retrieval Group",THUIR10Qa,88,1000,1000,0,1,
2010,"Tsinghua University, Info Retrieval Group",THUIR10Qa,89,1000,1000,0,1,
2010,"Tsinghua University, Info Retrieval Group",THUIR10Qa,90,1000,1000,0,1,
2010,"Tsinghua University, Info Retrieval Group",THUIR10Qa,91,1000,1000,0,1,
2010,"Tsinghua University, Info Retrieval Group",THUIR10Qa,92,1000,1000,0,1,
2010,"Tsinghua University, Info Retrieval Group",THUIR10Qa,93,1000,998,2,1.001001001001,2
2010,"Tsinghua University, Info Retrieval Group",THUIR10Qa,94,1000,1000,0,1,
2010,"Tsinghua University, Info Retrieval Group",THUIR10Qa,95,1000,1000,0,1,
2010,"Tsinghua University, Info Retrieval Group",THUIR10Qa,96,1000,1000,0,1,
2010,"Tsinghua University, Info Retrieval Group",THUIR10Qa,97,1000,1000,0,1,
2010,"Tsinghua University, Info Retrieval Group",THUIR10Qa,98,1000,1000,0,1,
2010,"Tsinghua University, Info Retrieval Group",THUIR10Qa,99,1000,1000,0,1,
2010,"Tsinghua University, Info Retrieval Group",THUIR10Qa,100,1000,1000,0,1,
2010,"Tsinghua University, Info Retrieval Group",THUIR10QaHt,51,1000,1000,0,1,
2010,"Tsinghua University, Info Retrieval Group",THUIR10QaHt,52,1000,1000,0,1,
2010,"Tsinghua University, Info Retrieval Group",THUIR10QaHt,53,1000,1000,0,1,
2010,"Tsinghua University, Info Retrieval Group",THUIR10QaHt,54,1000,1000,0,1,
2010,"Tsinghua University, Info Retrieval Group",THUIR10QaHt,55,1000,1000,0,1,
2010,"Tsinghua University, Info Retrieval Group",THUIR10QaHt,56,1000,1000,0,1,
2010,"Tsinghua University, Info Retrieval Group",THUIR10QaHt,57,1000,1000,0,1,
2010,"Tsinghua University, Info Retrieval Group",THUIR10QaHt,58,1000,1000,0,1,
2010,"Tsinghua University, Info Retrieval Group",THUIR10QaHt,59,1000,1000,0,1,
2010,"Tsinghua University, Info Retrieval Group",THUIR10QaHt,60,1000,1000,0,1,
2010,"Tsinghua University, Info Retrieval Group",THUIR10QaHt,61,1000,1000,0,1,
2010,"Tsinghua University, Info Retrieval Group",THUIR10QaHt,62,1000,1000,0,1,
2010,"Tsinghua University, Info Retrieval Group",THUIR10QaHt,63,1000,1000,0,1,
2010,"Tsinghua University, Info Retrieval Group",THUIR10QaHt,64,1000,1000,0,1,
2010,"Tsinghua University, Info Retrieval Group",THUIR10QaHt,65,1000,1000,0,1,
2010,"Tsinghua University, Info Retrieval Group",THUIR10QaHt,66,1000,1000,0,1,
2010,"Tsinghua University, Info Retrieval Group",THUIR10QaHt,67,1000,1000,0,1,
2010,"Tsinghua University, Info Retrieval Group",THUIR10QaHt,68,1000,1000,0,1,
2010,"Tsinghua University, Info Retrieval Group",THUIR10QaHt,69,1000,1000,0,1,
2010,"Tsinghua University, Info Retrieval Group",THUIR10QaHt,70,1000,1000,0,1,
2010,"Tsinghua University, Info Retrieval Group",THUIR10QaHt,71,1000,1000,0,1,
2010,"Tsinghua University, Info Retrieval Group",THUIR10QaHt,72,1000,1000,0,1,
2010,"Tsinghua University, Info Retrieval Group",THUIR10QaHt,73,1000,1000,0,1,
2010,"Tsinghua University, Info Retrieval Group",THUIR10QaHt,74,1000,1000,0,1,
2010,"Tsinghua University, Info Retrieval Group",THUIR10QaHt,75,1000,1000,0,1,
2010,"Tsinghua University, Info Retrieval Group",THUIR10QaHt,76,1000,1000,0,1,
2010,"Tsinghua University, Info Retrieval Group",THUIR10QaHt,77,1000,1000,0,1,
2010,"Tsinghua University, Info Retrieval Group",THUIR10QaHt,78,1000,1000,0,1,
2010,"Tsinghua University, Info Retrieval Group",THUIR10QaHt,79,1000,1000,0,1,
2010,"Tsinghua University, Info Retrieval Group",THUIR10QaHt,80,1000,1000,0,1,
2010,"Tsinghua University, Info Retrieval Group",THUIR10QaHt,81,1000,1000,0,1,
2010,"Tsinghua University, Info Retrieval Group",THUIR10QaHt,82,1000,1000,0,1,
2010,"Tsinghua University, Info Retrieval Group",THUIR10QaHt,83,1000,1000,0,1,
2010,"Tsinghua University, Info Retrieval Group",THUIR10QaHt,84,1000,1000,0,1,
2010,"Tsinghua University, Info Retrieval Group",THUIR10QaHt,85,1000,1000,0,1,
2010,"Tsinghua University, Info Retrieval Group",THUIR10QaHt,86,1000,1000,0,1,
2010,"Tsinghua University, Info Retrieval Group",THUIR10QaHt,87,1000,1000,0,1,
2010,"Tsinghua University, Info Retrieval Group",THUIR10QaHt,88,1000,1000,0,1,
2010,"Tsinghua University, Info Retrieval Group",THUIR10QaHt,89,1000,1000,0,1,
2010,"Tsinghua University, Info Retrieval Group",THUIR10QaHt,90,1000,1000,0,1,
2010,"Tsinghua University, Info Retrieval Group",THUIR10QaHt,91,1000,1000,0,1,
2010,"Tsinghua University, Info Retrieval Group",THUIR10QaHt,92,1000,1000,0,1,
2010,"Tsinghua University, Info Retrieval Group",THUIR10QaHt,93,1000,1000,0,1,
2010,"Tsinghua University, Info Retrieval Group",THUIR10QaHt,94,1000,1000,0,1,
2010,"Tsinghua University, Info Retrieval Group",THUIR10QaHt,95,1000,1000,0,1,
2010,"Tsinghua University, Info Retrieval Group",THUIR10QaHt,96,1000,1000,0,1,
2010,"Tsinghua University, Info Retrieval Group",THUIR10QaHt,97,1000,1000,0,1,
2010,"Tsinghua University, Info Retrieval Group",THUIR10QaHt,98,1000,1000,0,1,
2010,"Tsinghua University, Info Retrieval Group",THUIR10QaHt,99,1000,1000,0,1,
2010,"Tsinghua University, Info Retrieval Group",THUIR10QaHt,100,1000,1000,0,1,
2010,"Tsinghua University, Info Retrieval Group",THUIR10Str,51,1000,966,34,1.01936799184506,2.26666666666667
2010,"Tsinghua University, Info Retrieval Group",THUIR10Str,52,1000,969,31,1.01626016260163,2.06666666666667
2010,"Tsinghua University, Info Retrieval Group",THUIR10Str,53,1000,982,18,1.00908173562059,2
2010,"Tsinghua University, Info Retrieval Group",THUIR10Str,54,1000,973,27,1.01522842639594,2.25
2010,"Tsinghua University, Info Retrieval Group",THUIR10Str,55,1000,960,40,1.02040816326531,2
2010,"Tsinghua University, Info Retrieval Group",THUIR10Str,56,1000,961,39,1.02459016393443,2.6
2010,"Tsinghua University, Info Retrieval Group",THUIR10Str,57,1000,953,47,1.03305785123967,3.13333333333333
2010,"Tsinghua University, Info Retrieval Group",THUIR10Str,58,1000,954,46,1.02880658436214,2.55555555555556
2010,"Tsinghua University, Info Retrieval Group",THUIR10Str,59,1000,991,9,1.00502512562814,2.25
2010,"Tsinghua University, Info Retrieval Group",THUIR10Str,60,1000,964,36,1.02145045965271,2.4
2010,"Tsinghua University, Info Retrieval Group",THUIR10Str,61,1000,913,87,1.04712041884817,2.07142857142857
2010,"Tsinghua University, Info Retrieval Group",THUIR10Str,62,1000,975,25,1.01522842639594,2.5
2010,"Tsinghua University, Info Retrieval Group",THUIR10Str,63,1000,972,28,1.01419878296146,2
2010,"Tsinghua University, Info Retrieval Group",THUIR10Str,64,1000,921,79,1.04602510460251,2.25714285714286
2010,"Tsinghua University, Info Retrieval Group",THUIR10Str,65,1000,963,37,1.02145045965271,2.3125
2010,"Tsinghua University, Info Retrieval Group",THUIR10Str,66,1000,908,92,1.06837606837607,3.28571428571429
2010,"Tsinghua University, Info Retrieval Group",THUIR10Str,67,1000,965,35,1.02040816326531,2.33333333333333
2010,"Tsinghua University, Info Retrieval Group",THUIR10Str,68,1000,776,224,1.20192307692308,4
2010,"Tsinghua University, Info Retrieval Group",THUIR10Str,69,1000,775,225,1.1454753722795,2.29591836734694
2010,"Tsinghua University, Info Retrieval Group",THUIR10Str,70,1000,982,18,1.00908173562059,2
2010,"Tsinghua University, Info Retrieval Group",THUIR10Str,71,1000,971,29,1.01626016260163,2.23076923076923
2010,"Tsinghua University, Info Retrieval Group",THUIR10Str,72,1000,988,12,1.00603621730382,2
2010,"Tsinghua University, Info Retrieval Group",THUIR10Str,73,1000,962,38,1.02354145342886,2.53333333333333
2010,"Tsinghua University, Info Retrieval Group",THUIR10Str,74,1000,905,95,1.06269925611052,2.63888888888889
2010,"Tsinghua University, Info Retrieval Group",THUIR10Str,75,1000,947,53,1.02880658436214,2.12
2010,"Tsinghua University, Info Retrieval Group",THUIR10Str,76,1000,978,22,1.01214574898785,2.2
2010,"Tsinghua University, Info Retrieval Group",THUIR10Str,77,1000,901,99,1.06044538706257,2.35714285714286
2010,"Tsinghua University, Info Retrieval Group",THUIR10Str,78,1000,951,49,1.03412616339193,3.0625
2010,"Tsinghua University, Info Retrieval Group",THUIR10Str,79,1000,946,54,1.02986611740474,2.16
2010,"Tsinghua University, Info Retrieval Group",THUIR10Str,80,1000,957,43,1.0351966873706,4.77777777777778
2010,"Tsinghua University, Info Retrieval Group",THUIR10Str,81,1000,919,81,1.04712041884817,2.25
2010,"Tsinghua University, Info Retrieval Group",THUIR10Str,82,1000,939,61,1.03412616339193,2.17857142857143
2010,"Tsinghua University, Info Retrieval Group",THUIR10Str,83,1000,925,75,1.04384133611691,2.27272727272727
2010,"Tsinghua University, Info Retrieval Group",THUIR10Str,84,1000,829,171,1.11982082866741,2.671875
2010,"Tsinghua University, Info Retrieval Group",THUIR10Str,85,1000,986,14,1.00704934541793,2
2010,"Tsinghua University, Info Retrieval Group",THUIR10Str,86,1000,979,21,1.01112234580384,2.1
2010,"Tsinghua University, Info Retrieval Group",THUIR10Str,87,1000,979,21,1.01112234580384,2.1
2010,"Tsinghua University, Info Retrieval Group",THUIR10Str,88,1000,958,42,1.02145045965271,2
2010,"Tsinghua University, Info Retrieval Group",THUIR10Str,89,1000,919,81,1.04602510460251,2.18918918918919
2010,"Tsinghua University, Info Retrieval Group",THUIR10Str,90,1000,788,212,1.14025085518814,2.38202247191011
2010,"Tsinghua University, Info Retrieval Group",THUIR10Str,91,1000,795,205,1.12359550561798,2.15789473684211
2010,"Tsinghua University, Info Retrieval Group",THUIR10Str,92,1000,983,17,1.00908173562059,2.125
2010,"Tsinghua University, Info Retrieval Group",THUIR10Str,93,1000,945,55,1.03305785123967,2.39130434782609
2010,"Tsinghua University, Info Retrieval Group",THUIR10Str,94,1000,938,62,1.03734439834025,2.38461538461538
2010,"Tsinghua University, Info Retrieval Group",THUIR10Str,95,1000,817,183,1.15874855156431,3.97826086956522
2010,"Tsinghua University, Info Retrieval Group",THUIR10Str,96,1000,956,44,1.02249488752556,2
2010,"Tsinghua University, Info Retrieval Group",THUIR10Str,97,1000,974,26,1.01317122593718,2
2010,"Tsinghua University, Info Retrieval Group",THUIR10Str,98,1000,902,98,1.06837606837607,2.88235294117647
2010,"Tsinghua University, Info Retrieval Group",THUIR10Str,99,1000,901,99,1.06044538706257,2.35714285714286
2010,"Tsinghua University, Info Retrieval Group",THUIR10Str,100,1000,972,28,1.01419878296146,2
2010,University of Amsterdam (Kamps),UAMSA10d2a8,51,1000,929,71,1.04058272632674,2.21875
2010,University of Amsterdam (Kamps),UAMSA10d2a8,52,1000,944,56,1.02986611740474,2.07407407407407
2010,University of Amsterdam (Kamps),UAMSA10d2a8,53,1000,937,63,1.03950103950104,2.52
2010,University of Amsterdam (Kamps),UAMSA10d2a8,54,1000,956,44,1.02459016393443,2.2
2010,University of Amsterdam (Kamps),UAMSA10d2a8,55,1000,968,32,1.01626016260163,2
2010,University of Amsterdam (Kamps),UAMSA10d2a8,56,1000,949,51,1.03412616339193,2.83333333333333
2010,University of Amsterdam (Kamps),UAMSA10d2a8,57,1000,880,120,1.07874865156419,2.5531914893617
2010,University of Amsterdam (Kamps),UAMSA10d2a8,58,1000,953,47,1.02986611740474,2.61111111111111
2010,University of Amsterdam (Kamps),UAMSA10d2a8,59,1000,739,261,1.20627261761158,2.9
2010,University of Amsterdam (Kamps),UAMSA10d2a8,60,1000,985,15,1.00806451612903,2.14285714285714
2010,University of Amsterdam (Kamps),UAMSA10d2a8,61,1000,958,42,1.02669404517454,2.625
2010,University of Amsterdam (Kamps),UAMSA10d2a8,62,1000,968,32,1.0183299389002,2.28571428571429
2010,University of Amsterdam (Kamps),UAMSA10d2a8,63,1000,974,26,1.01419878296146,2.16666666666667
2010,University of Amsterdam (Kamps),UAMSA10d2a8,64,1000,985,15,1.00806451612903,2.14285714285714
2010,University of Amsterdam (Kamps),UAMSA10d2a8,65,1000,962,38,1.02040816326531,2.11111111111111
2010,University of Amsterdam (Kamps),UAMSA10d2a8,66,1000,952,48,1.02986611740474,2.52631578947368
2010,University of Amsterdam (Kamps),UAMSA10d2a8,67,1000,867,133,1.08225108225108,2.33333333333333
2010,University of Amsterdam (Kamps),UAMSA10d2a8,68,1000,977,23,1.01214574898785,2.09090909090909
2010,University of Amsterdam (Kamps),UAMSA10d2a8,69,1000,892,108,1.06496272630458,2.29787234042553
2010,University of Amsterdam (Kamps),UAMSA10d2a8,70,1000,933,67,1.0351966873706,2.03030303030303
2010,University of Amsterdam (Kamps),UAMSA10d2a8,71,1000,953,47,1.02564102564103,2.13636363636364
2010,University of Amsterdam (Kamps),UAMSA10d2a8,72,1000,943,57,1.03199174406605,2.19230769230769
2010,University of Amsterdam (Kamps),UAMSA10d2a8,73,1000,980,20,1.01010101010101,2
2010,University of Amsterdam (Kamps),UAMSA10d2a8,74,1000,969,31,1.0183299389002,2.38461538461538
2010,University of Amsterdam (Kamps),UAMSA10d2a8,75,1000,937,63,1.03626943005181,2.25
2010,University of Amsterdam (Kamps),UAMSA10d2a8,76,1000,932,68,1.04058272632674,2.3448275862069
2010,University of Amsterdam (Kamps),UAMSA10d2a8,77,1000,979,21,1.01214574898785,2.33333333333333
2010,University of Amsterdam (Kamps),UAMSA10d2a8,78,1000,830,170,1.12739571589628,2.98245614035088
2010,University of Amsterdam (Kamps),UAMSA10d2a8,79,1000,816,184,1.12866817155756,2.62857142857143
2010,University of Amsterdam (Kamps),UAMSA10d2a8,80,1000,927,73,1.04275286757039,2.28125
2010,University of Amsterdam (Kamps),UAMSA10d2a8,81,1000,794,206,1.18906064209275,4.38297872340426
2010,University of Amsterdam (Kamps),UAMSA10d2a8,82,1000,972,28,1.01522842639594,2.15384615384615
2010,University of Amsterdam (Kamps),UAMSA10d2a8,83,1000,913,87,1.05042016806723,2.23076923076923
2010,University of Amsterdam (Kamps),UAMSA10d2a8,84,1000,898,102,1.06496272630458,2.48780487804878
2010,University of Amsterdam (Kamps),UAMSA10d2a8,85,1000,952,48,1.02774922918808,2.28571428571429
2010,University of Amsterdam (Kamps),UAMSA10d2a8,86,1000,969,31,1.01729399796541,2.21428571428571
2010,University of Amsterdam (Kamps),UAMSA10d2a8,87,1000,954,46,1.02459016393443,2.09090909090909
2010,University of Amsterdam (Kamps),UAMSA10d2a8,88,1000,878,122,1.07066381156317,2.17857142857143
2010,University of Amsterdam (Kamps),UAMSA10d2a8,89,1000,984,16,1.00908173562059,2.28571428571429
2010,University of Amsterdam (Kamps),UAMSA10d2a8,90,1000,865,135,1.07642626480086,2.109375
2010,University of Amsterdam (Kamps),UAMSA10d2a8,91,1000,868,132,1.09289617486339,2.80851063829787
2010,University of Amsterdam (Kamps),UAMSA10d2a8,92,1000,919,81,1.0482180293501,2.31428571428571
2010,University of Amsterdam (Kamps),UAMSA10d2a8,93,1000,969,31,1.0183299389002,2.38461538461538
2010,University of Amsterdam (Kamps),UAMSA10d2a8,94,1000,983,17,1.01010101010101,2.42857142857143
2010,University of Amsterdam (Kamps),UAMSA10d2a8,95,1000,963,37,1.02145045965271,2.3125
2010,University of Amsterdam (Kamps),UAMSA10d2a8,96,1000,970,30,1.0183299389002,2.5
2010,University of Amsterdam (Kamps),UAMSA10d2a8,97,1000,831,169,1.14025085518814,3.67391304347826
2010,University of Amsterdam (Kamps),UAMSA10d2a8,98,1000,925,75,1.04602510460251,2.41935483870968
2010,University of Amsterdam (Kamps),UAMSA10d2a8,99,1000,917,83,1.0515247108307,2.44117647058824
2010,University of Amsterdam (Kamps),UAMSA10d2a8,100,1000,908,92,1.06609808102345,3.06666666666667
2010,University of Amsterdam (Kamps),UAMSA10mSF30,51,1000,933,67,1.03626943005181,2.09375
2010,University of Amsterdam (Kamps),UAMSA10mSF30,52,1000,928,72,1.03842159916926,2.05714285714286
2010,University of Amsterdam (Kamps),UAMSA10mSF30,53,1000,941,59,1.03412616339193,2.26923076923077
2010,University of Amsterdam (Kamps),UAMSA10mSF30,54,1000,960,40,1.02249488752556,2.22222222222222
2010,University of Amsterdam (Kamps),UAMSA10mSF30,55,1000,968,32,1.01626016260163,2
2010,University of Amsterdam (Kamps),UAMSA10mSF30,56,1000,953,47,1.03199174406605,2.9375
2010,University of Amsterdam (Kamps),UAMSA10mSF30,57,1000,902,98,1.05820105820106,2.27906976744186
2010,University of Amsterdam (Kamps),UAMSA10mSF30,58,1000,960,40,1.02459016393443,2.5
2010,University of Amsterdam (Kamps),UAMSA10mSF30,59,1000,748,252,1.19331742243437,2.8
2010,University of Amsterdam (Kamps),UAMSA10mSF30,60,1000,979,21,1.01214574898785,2.33333333333333
2010,University of Amsterdam (Kamps),UAMSA10mSF30,61,1000,969,31,1.01936799184506,2.58333333333333
2010,University of Amsterdam (Kamps),UAMSA10mSF30,62,1000,968,32,1.0183299389002,2.28571428571429
2010,University of Amsterdam (Kamps),UAMSA10mSF30,63,1000,943,57,1.03412616339193,2.375
2010,University of Amsterdam (Kamps),UAMSA10mSF30,64,1000,982,18,1.00908173562059,2
2010,University of Amsterdam (Kamps),UAMSA10mSF30,65,1000,926,74,1.05485232067511,3.36363636363636
2010,University of Amsterdam (Kamps),UAMSA10mSF30,66,1000,946,54,1.03305785123967,2.45454545454545
2010,University of Amsterdam (Kamps),UAMSA10mSF30,67,1000,871,129,1.07991360691145,2.34545454545455
2010,University of Amsterdam (Kamps),UAMSA10mSF30,68,1000,969,31,1.0183299389002,2.38461538461538
2010,University of Amsterdam (Kamps),UAMSA10mSF30,69,1000,888,112,1.06609808102345,2.24
2010,University of Amsterdam (Kamps),UAMSA10mSF30,70,1000,940,60,1.03092783505155,2
2010,University of Amsterdam (Kamps),UAMSA10mSF30,71,1000,945,55,1.02986611740474,2.11538461538462
2010,University of Amsterdam (Kamps),UAMSA10mSF30,72,1000,935,65,1.03842159916926,2.32142857142857
2010,University of Amsterdam (Kamps),UAMSA10mSF30,73,1000,958,42,1.02249488752556,2.1
2010,University of Amsterdam (Kamps),UAMSA10mSF30,74,1000,953,47,1.02880658436214,2.47368421052632
2010,University of Amsterdam (Kamps),UAMSA10mSF30,75,1000,942,58,1.03305785123967,2.23076923076923
2010,University of Amsterdam (Kamps),UAMSA10mSF30,76,1000,933,67,1.03950103950104,2.31034482758621
2010,University of Amsterdam (Kamps),UAMSA10mSF30,77,1000,983,17,1.00908173562059,2.125
2010,University of Amsterdam (Kamps),UAMSA10mSF30,78,1000,887,113,1.07874865156419,2.825
2010,University of Amsterdam (Kamps),UAMSA10mSF30,79,1000,785,215,1.16144018583043,2.82894736842105
2010,University of Amsterdam (Kamps),UAMSA10mSF30,80,1000,907,93,1.05820105820106,2.44736842105263
2010,University of Amsterdam (Kamps),UAMSA10mSF30,81,1000,803,197,1.17924528301887,4.37777777777778
2010,University of Amsterdam (Kamps),UAMSA10mSF30,82,1000,964,36,1.01936799184506,2.11764705882353
2010,University of Amsterdam (Kamps),UAMSA10mSF30,83,1000,914,86,1.04931794333683,2.20512820512821
2010,University of Amsterdam (Kamps),UAMSA10mSF30,84,1000,917,83,1.05042016806723,2.37142857142857
2010,University of Amsterdam (Kamps),UAMSA10mSF30,85,1000,962,38,1.02040816326531,2.11111111111111
2010,University of Amsterdam (Kamps),UAMSA10mSF30,86,1000,963,37,1.02040816326531,2.17647058823529
2010,University of Amsterdam (Kamps),UAMSA10mSF30,87,1000,957,43,1.02249488752556,2.04761904761905
2010,University of Amsterdam (Kamps),UAMSA10mSF30,88,1000,890,110,1.06496272630458,2.24489795918367
2010,University of Amsterdam (Kamps),UAMSA10mSF30,89,1000,982,18,1.01010101010101,2.25
2010,University of Amsterdam (Kamps),UAMSA10mSF30,90,1000,852,148,1.08342361863489,2.08450704225352
2010,University of Amsterdam (Kamps),UAMSA10mSF30,91,1000,857,143,1.1001100110011,2.75
2010,University of Amsterdam (Kamps),UAMSA10mSF30,92,1000,922,78,1.04712041884817,2.36363636363636
2010,University of Amsterdam (Kamps),UAMSA10mSF30,93,1000,972,28,1.01729399796541,2.54545454545455
2010,University of Amsterdam (Kamps),UAMSA10mSF30,94,1000,984,16,1.00908173562059,2.28571428571429
2010,University of Amsterdam (Kamps),UAMSA10mSF30,95,1000,938,62,1.03734439834025,2.38461538461538
2010,University of Amsterdam (Kamps),UAMSA10mSF30,96,1000,966,34,1.02249488752556,2.83333333333333
2010,University of Amsterdam (Kamps),UAMSA10mSF30,97,1000,833,167,1.13636363636364,3.5531914893617
2010,University of Amsterdam (Kamps),UAMSA10mSF30,98,1000,924,76,1.04493207941484,2.3030303030303
2010,University of Amsterdam (Kamps),UAMSA10mSF30,99,1000,899,101,1.06609808102345,2.58974358974359
2010,University of Amsterdam (Kamps),UAMSA10mSF30,100,1000,908,92,1.06951871657754,3.40740740740741
2010,University of Amsterdam (Kamps),UAMSA10mSFPR,51,1000,1000,0,1,
2010,University of Amsterdam (Kamps),UAMSA10mSFPR,52,1000,1000,0,1,
2010,University of Amsterdam (Kamps),UAMSA10mSFPR,53,1000,1000,0,1,
2010,University of Amsterdam (Kamps),UAMSA10mSFPR,54,1000,1000,0,1,
2010,University of Amsterdam (Kamps),UAMSA10mSFPR,55,1000,1000,0,1,
2010,University of Amsterdam (Kamps),UAMSA10mSFPR,56,1000,1000,0,1,
2010,University of Amsterdam (Kamps),UAMSA10mSFPR,57,1000,1000,0,1,
2010,University of Amsterdam (Kamps),UAMSA10mSFPR,58,1000,1000,0,1,
2010,University of Amsterdam (Kamps),UAMSA10mSFPR,59,1000,1000,0,1,
2010,University of Amsterdam (Kamps),UAMSA10mSFPR,60,1000,1000,0,1,
2010,University of Amsterdam (Kamps),UAMSA10mSFPR,61,1000,1000,0,1,
2010,University of Amsterdam (Kamps),UAMSA10mSFPR,62,1000,1000,0,1,
2010,University of Amsterdam (Kamps),UAMSA10mSFPR,63,1000,1000,0,1,
2010,University of Amsterdam (Kamps),UAMSA10mSFPR,64,1000,1000,0,1,
2010,University of Amsterdam (Kamps),UAMSA10mSFPR,65,1000,1000,0,1,
2010,University of Amsterdam (Kamps),UAMSA10mSFPR,66,1000,1000,0,1,
2010,University of Amsterdam (Kamps),UAMSA10mSFPR,67,1000,1000,0,1,
2010,University of Amsterdam (Kamps),UAMSA10mSFPR,68,1000,1000,0,1,
2010,University of Amsterdam (Kamps),UAMSA10mSFPR,69,1000,1000,0,1,
2010,University of Amsterdam (Kamps),UAMSA10mSFPR,70,1000,1000,0,1,
2010,University of Amsterdam (Kamps),UAMSA10mSFPR,71,1000,1000,0,1,
2010,University of Amsterdam (Kamps),UAMSA10mSFPR,72,1000,1000,0,1,
2010,University of Amsterdam (Kamps),UAMSA10mSFPR,73,1000,1000,0,1,
2010,University of Amsterdam (Kamps),UAMSA10mSFPR,74,1000,1000,0,1,
2010,University of Amsterdam (Kamps),UAMSA10mSFPR,75,1000,1000,0,1,
2010,University of Amsterdam (Kamps),UAMSA10mSFPR,76,1000,1000,0,1,
2010,University of Amsterdam (Kamps),UAMSA10mSFPR,77,1000,1000,0,1,
2010,University of Amsterdam (Kamps),UAMSA10mSFPR,78,1000,1000,0,1,
2010,University of Amsterdam (Kamps),UAMSA10mSFPR,79,1000,1000,0,1,
2010,University of Amsterdam (Kamps),UAMSA10mSFPR,80,1000,1000,0,1,
2010,University of Amsterdam (Kamps),UAMSA10mSFPR,81,1000,1000,0,1,
2010,University of Amsterdam (Kamps),UAMSA10mSFPR,82,1000,1000,0,1,
2010,University of Amsterdam (Kamps),UAMSA10mSFPR,83,1000,1000,0,1,
2010,University of Amsterdam (Kamps),UAMSA10mSFPR,84,1000,1000,0,1,
2010,University of Amsterdam (Kamps),UAMSA10mSFPR,85,1000,1000,0,1,
2010,University of Amsterdam (Kamps),UAMSA10mSFPR,86,1000,1000,0,1,
2010,University of Amsterdam (Kamps),UAMSA10mSFPR,87,1000,1000,0,1,
2010,University of Amsterdam (Kamps),UAMSA10mSFPR,88,1000,1000,0,1,
2010,University of Amsterdam (Kamps),UAMSA10mSFPR,89,1000,1000,0,1,
2010,University of Amsterdam (Kamps),UAMSA10mSFPR,90,1000,1000,0,1,
2010,University of Amsterdam (Kamps),UAMSA10mSFPR,91,1000,1000,0,1,
2010,University of Amsterdam (Kamps),UAMSA10mSFPR,92,1000,1000,0,1,
2010,University of Amsterdam (Kamps),UAMSA10mSFPR,93,1000,1000,0,1,
2010,University of Amsterdam (Kamps),UAMSA10mSFPR,94,1000,998,2,1.001001001001,2
2010,University of Amsterdam (Kamps),UAMSA10mSFPR,95,1000,998,2,1.001001001001,2
2010,University of Amsterdam (Kamps),UAMSA10mSFPR,96,1000,1000,0,1,
2010,University of Amsterdam (Kamps),UAMSA10mSFPR,97,1000,1000,0,1,
2010,University of Amsterdam (Kamps),UAMSA10mSFPR,98,1000,994,6,1.00401606425703,3
2010,University of Amsterdam (Kamps),UAMSA10mSFPR,99,1000,1000,0,1,
2010,University of Amsterdam (Kamps),UAMSA10mSFPR,100,1000,1000,0,1,
2010,"SCSI, University College Dublin",UCDSIFTMAP,51,1000,1000,0,1,
2010,"SCSI, University College Dublin",UCDSIFTMAP,52,1000,1000,0,1,
2010,"SCSI, University College Dublin",UCDSIFTMAP,53,1000,1000,0,1,
2010,"SCSI, University College Dublin",UCDSIFTMAP,54,1000,1000,0,1,
2010,"SCSI, University College Dublin",UCDSIFTMAP,55,1000,1000,0,1,
2010,"SCSI, University College Dublin",UCDSIFTMAP,56,1000,1000,0,1,
2010,"SCSI, University College Dublin",UCDSIFTMAP,57,1000,1000,0,1,
2010,"SCSI, University College Dublin",UCDSIFTMAP,58,1000,1000,0,1,
2010,"SCSI, University College Dublin",UCDSIFTMAP,59,1000,1000,0,1,
2010,"SCSI, University College Dublin",UCDSIFTMAP,60,1000,1000,0,1,
2010,"SCSI, University College Dublin",UCDSIFTMAP,61,1000,1000,0,1,
2010,"SCSI, University College Dublin",UCDSIFTMAP,62,1000,1000,0,1,
2010,"SCSI, University College Dublin",UCDSIFTMAP,63,1000,1000,0,1,
2010,"SCSI, University College Dublin",UCDSIFTMAP,64,1000,1000,0,1,
2010,"SCSI, University College Dublin",UCDSIFTMAP,65,1000,1000,0,1,
2010,"SCSI, University College Dublin",UCDSIFTMAP,66,1000,1000,0,1,
2010,"SCSI, University College Dublin",UCDSIFTMAP,67,1000,1000,0,1,
2010,"SCSI, University College Dublin",UCDSIFTMAP,68,1000,1000,0,1,
2010,"SCSI, University College Dublin",UCDSIFTMAP,69,1000,1000,0,1,
2010,"SCSI, University College Dublin",UCDSIFTMAP,70,1000,1000,0,1,
2010,"SCSI, University College Dublin",UCDSIFTMAP,71,1000,1000,0,1,
2010,"SCSI, University College Dublin",UCDSIFTMAP,72,1000,1000,0,1,
2010,"SCSI, University College Dublin",UCDSIFTMAP,73,1000,1000,0,1,
2010,"SCSI, University College Dublin",UCDSIFTMAP,74,1000,1000,0,1,
2010,"SCSI, University College Dublin",UCDSIFTMAP,75,1000,1000,0,1,
2010,"SCSI, University College Dublin",UCDSIFTMAP,76,1000,1000,0,1,
2010,"SCSI, University College Dublin",UCDSIFTMAP,77,1000,1000,0,1,
2010,"SCSI, University College Dublin",UCDSIFTMAP,78,1000,1000,0,1,
2010,"SCSI, University College Dublin",UCDSIFTMAP,79,1000,1000,0,1,
2010,"SCSI, University College Dublin",UCDSIFTMAP,80,1000,1000,0,1,
2010,"SCSI, University College Dublin",UCDSIFTMAP,81,1000,1000,0,1,
2010,"SCSI, University College Dublin",UCDSIFTMAP,82,1000,1000,0,1,
2010,"SCSI, University College Dublin",UCDSIFTMAP,83,1000,1000,0,1,
2010,"SCSI, University College Dublin",UCDSIFTMAP,84,1000,1000,0,1,
2010,"SCSI, University College Dublin",UCDSIFTMAP,85,1000,1000,0,1,
2010,"SCSI, University College Dublin",UCDSIFTMAP,86,1000,1000,0,1,
2010,"SCSI, University College Dublin",UCDSIFTMAP,87,1000,1000,0,1,
2010,"SCSI, University College Dublin",UCDSIFTMAP,88,1000,1000,0,1,
2010,"SCSI, University College Dublin",UCDSIFTMAP,89,1000,1000,0,1,
2010,"SCSI, University College Dublin",UCDSIFTMAP,90,1000,1000,0,1,
2010,"SCSI, University College Dublin",UCDSIFTMAP,91,1000,1000,0,1,
2010,"SCSI, University College Dublin",UCDSIFTMAP,92,1000,1000,0,1,
2010,"SCSI, University College Dublin",UCDSIFTMAP,93,1000,1000,0,1,
2010,"SCSI, University College Dublin",UCDSIFTMAP,94,1000,1000,0,1,
2010,"SCSI, University College Dublin",UCDSIFTMAP,95,1000,1000,0,1,
2010,"SCSI, University College Dublin",UCDSIFTMAP,96,1000,1000,0,1,
2010,"SCSI, University College Dublin",UCDSIFTMAP,97,1000,1000,0,1,
2010,"SCSI, University College Dublin",UCDSIFTMAP,98,1000,1000,0,1,
2010,"SCSI, University College Dublin",UCDSIFTMAP,99,1000,1000,0,1,
2010,"SCSI, University College Dublin",UCDSIFTMAP,100,1000,1000,0,1,
2010,"SCSI, University College Dublin",UCDSIFTProb,51,1000,55,945,7.93650793650794,13.3098591549296
2010,"SCSI, University College Dublin",UCDSIFTProb,52,1000,33,967,8.92857142857143,12.2405063291139
2010,"SCSI, University College Dublin",UCDSIFTProb,53,1000,152,848,3.92156862745098,8.23300970873786
2010,"SCSI, University College Dublin",UCDSIFTProb,54,1000,105,895,5.3475935828877,10.9146341463415
2010,"SCSI, University College Dublin",UCDSIFTProb,55,1000,125,875,4.52488687782805,9.11458333333333
2010,"SCSI, University College Dublin",UCDSIFTProb,56,1000,126,874,5.05050505050505,12.1388888888889
2010,"SCSI, University College Dublin",UCDSIFTProb,57,1000,114,886,5,10.3023255813953
2010,"SCSI, University College Dublin",UCDSIFTProb,58,1000,117,883,4.42477876106195,8.10091743119266
2010,"SCSI, University College Dublin",UCDSIFTProb,59,1000,154,846,4.20168067226891,10.0714285714286
2010,"SCSI, University College Dublin",UCDSIFTProb,60,1000,63,937,6.28930817610063,9.76041666666667
2010,"SCSI, University College Dublin",UCDSIFTProb,61,1000,100,900,5.15463917525773,9.57446808510638
2010,"SCSI, University College Dublin",UCDSIFTProb,62,1000,111,889,4.65116279069768,8.54807692307692
2010,"SCSI, University College Dublin",UCDSIFTProb,63,1000,75,925,6.09756097560976,10.3932584269663
2010,"SCSI, University College Dublin",UCDSIFTProb,64,1000,49,951,7.19424460431655,10.5666666666667
2010,"SCSI, University College Dublin",UCDSIFTProb,65,1000,93,907,5.43478260869565,9.96703296703297
2010,"SCSI, University College Dublin",UCDSIFTProb,66,1000,167,833,3.66300366300366,7.85849056603774
2010,"SCSI, University College Dublin",UCDSIFTProb,67,1000,33,967,10.8695652173913,16.3898305084746
2010,"SCSI, University College Dublin",UCDSIFTProb,68,1000,71,929,6.02409638554217,9.77894736842105
2010,"SCSI, University College Dublin",UCDSIFTProb,69,1000,93,907,5.31914893617021,9.54736842105263
2010,"SCSI, University College Dublin",UCDSIFTProb,70,1000,46,954,11.2359550561798,22.1860465116279
2010,"SCSI, University College Dublin",UCDSIFTProb,71,1000,111,889,4.739336492891,8.89
2010,"SCSI, University College Dublin",UCDSIFTProb,72,1000,102,898,5.98802395209581,13.8153846153846
2010,"SCSI, University College Dublin",UCDSIFTProb,73,1000,57,943,7.19424460431655,11.5
2010,"SCSI, University College Dublin",UCDSIFTProb,74,1000,62,938,7.09219858156028,11.873417721519
2010,"SCSI, University College Dublin",UCDSIFTProb,75,1000,81,919,5.37634408602151,8.75238095238095
2010,"SCSI, University College Dublin",UCDSIFTProb,76,1000,126,874,4.80769230769231,10.6585365853659
2010,"SCSI, University College Dublin",UCDSIFTProb,77,1000,65,935,6.45161290322581,10.3888888888889
2010,"SCSI, University College Dublin",UCDSIFTProb,78,1000,127,873,5.46448087431694,15.5892857142857
2010,"SCSI, University College Dublin",UCDSIFTProb,79,1000,118,882,4.69483568075117,9.28421052631579
2010,"SCSI, University College Dublin",UCDSIFTProb,80,1000,119,881,4.58715596330275,8.8989898989899
2010,"SCSI, University College Dublin",UCDSIFTProb,81,1000,129,871,4.83091787439614,11.1666666666667
2010,"SCSI, University College Dublin",UCDSIFTProb,82,1000,129,871,4.71698113207547,10.4939759036145
2010,"SCSI, University College Dublin",UCDSIFTProb,83,1000,22,978,15.3846153846154,22.7441860465116
2010,"SCSI, University College Dublin",UCDSIFTProb,84,1000,44,956,8.26446280991735,12.4155844155844
2010,"SCSI, University College Dublin",UCDSIFTProb,85,1000,46,954,8.54700854700855,13.4366197183099
2010,"SCSI, University College Dublin",UCDSIFTProb,86,1000,92,908,4.92610837438424,8.18018018018018
2010,"SCSI, University College Dublin",UCDSIFTProb,87,1000,172,828,3.89105058365759,9.74117647058823
2010,"SCSI, University College Dublin",UCDSIFTProb,88,1000,70,930,6.89655172413793,12.4
2010,"SCSI, University College Dublin",UCDSIFTProb,89,1000,42,958,7.93650793650794,11.4047619047619
2010,"SCSI, University College Dublin",UCDSIFTProb,90,1000,53,947,6.89655172413793,10.2934782608696
2010,"SCSI, University College Dublin",UCDSIFTProb,91,1000,167,833,4.01606425702811,10.1585365853659
2010,"SCSI, University College Dublin",UCDSIFTProb,92,1000,118,882,5.88235294117647,16.9615384615385
2010,"SCSI, University College Dublin",UCDSIFTProb,93,1000,43,957,8.26446280991735,12.2692307692308
2010,"SCSI, University College Dublin",UCDSIFTProb,94,1000,129,871,4.18410041841004,7.91818181818182
2010,"SCSI, University College Dublin",UCDSIFTProb,95,1000,143,857,4.31034482758621,9.62921348314607
2010,"SCSI, University College Dublin",UCDSIFTProb,96,1000,135,865,4.42477876106195,9.50549450549451
2010,"SCSI, University College Dublin",UCDSIFTProb,97,1000,152,848,4.48430493273543,11.943661971831
2010,"SCSI, University College Dublin",UCDSIFTProb,98,1000,83,917,6.99300699300699,15.2833333333333
2010,"SCSI, University College Dublin",UCDSIFTProb,99,1000,105,895,5.0251256281407,9.52127659574468
2010,"SCSI, University College Dublin",UCDSIFTProb,100,1000,47,953,7.2463768115942,10.4725274725275
2010,"SCSI, University College Dublin",UCDSIFTSlide,51,1000,562,438,1.52439024390244,4.65957446808511
2010,"SCSI, University College Dublin",UCDSIFTSlide,52,1000,711,289,1.2453300124533,3.14130434782609
2010,"SCSI, University College Dublin",UCDSIFTSlide,53,1000,542,458,1.58982511923688,5.26436781609195
2010,"SCSI, University College Dublin",UCDSIFTSlide,54,1000,493,507,1.70068027210884,5.33684210526316
2010,"SCSI, University College Dublin",UCDSIFTSlide,55,1000,504,496,1.72413793103448,6.52631578947368
2010,"SCSI, University College Dublin",UCDSIFTSlide,56,1000,342,658,2.12765957446809,5.140625
2010,"SCSI, University College Dublin",UCDSIFTSlide,57,1000,544,456,1.6260162601626,6.42253521126761
2010,"SCSI, University College Dublin",UCDSIFTSlide,58,1000,566,434,1.52439024390244,4.82222222222222
2010,"SCSI, University College Dublin",UCDSIFTSlide,59,1000,519,481,1.63934426229508,5.28571428571429
2010,"SCSI, University College Dublin",UCDSIFTSlide,60,1000,617,383,1.39275766016713,3.79207920792079
2010,"SCSI, University College Dublin",UCDSIFTSlide,61,1000,513,487,1.64473684210526,5.12631578947369
2010,"SCSI, University College Dublin",UCDSIFTSlide,62,1000,579,421,1.52439024390244,5.46753246753247
2010,"SCSI, University College Dublin",UCDSIFTSlide,63,1000,551,449,1.57232704402516,5.28235294117647
2010,"SCSI, University College Dublin",UCDSIFTSlide,64,1000,606,394,1.41843971631206,3.97979797979798
2010,"SCSI, University College Dublin",UCDSIFTSlide,65,1000,489,511,1.69779286926995,5.11
2010,"SCSI, University College Dublin",UCDSIFTSlide,66,1000,577,423,1.50602409638554,4.86206896551724
2010,"SCSI, University College Dublin",UCDSIFTSlide,67,1000,655,345,1.2970168612192,2.97413793103448
2010,"SCSI, University College Dublin",UCDSIFTSlide,68,1000,637,363,1.3531799729364,3.55882352941176
2010,"SCSI, University College Dublin",UCDSIFTSlide,69,1000,550,450,1.55763239875389,4.89130434782609
2010,"SCSI, University College Dublin",UCDSIFTSlide,70,1000,352,648,2.1978021978022,6.29126213592233
2010,"SCSI, University College Dublin",UCDSIFTSlide,71,1000,447,553,1.87617260787993,6.43023255813954
2010,"SCSI, University College Dublin",UCDSIFTSlide,72,1000,395,605,2.05338809034908,6.57608695652174
2010,"SCSI, University College Dublin",UCDSIFTSlide,73,1000,655,345,1.34048257372654,3.79120879120879
2010,"SCSI, University College Dublin",UCDSIFTSlide,74,1000,664,336,1.3262599469496,3.73333333333333
2010,"SCSI, University College Dublin",UCDSIFTSlide,75,1000,572,428,1.4792899408284,4.11538461538462
2010,"SCSI, University College Dublin",UCDSIFTSlide,76,1000,494,506,1.69491525423729,5.27083333333333
2010,"SCSI, University College Dublin",UCDSIFTSlide,77,1000,632,368,1.36986301369863,3.75510204081633
2010,"SCSI, University College Dublin",UCDSIFTSlide,78,1000,375,625,2.04498977505112,5.48245614035088
2010,"SCSI, University College Dublin",UCDSIFTSlide,79,1000,497,503,1.70068027210884,5.52747252747253
2010,"SCSI, University College Dublin",UCDSIFTSlide,80,1000,503,497,1.66389351081531,5.07142857142857
2010,"SCSI, University College Dublin",UCDSIFTSlide,81,1000,413,587,1.953125,5.92929292929293
2010,"SCSI, University College Dublin",UCDSIFTSlide,82,1000,426,574,1.9047619047619,5.7979797979798
2010,"SCSI, University College Dublin",UCDSIFTSlide,83,1000,283,717,2.47524752475248,5.92561983471074
2010,"SCSI, University College Dublin",UCDSIFTSlide,84,1000,662,338,1.32802124833997,3.71428571428571
2010,"SCSI, University College Dublin",UCDSIFTSlide,85,1000,580,420,1.48588410104012,4.51612903225807
2010,"SCSI, University College Dublin",UCDSIFTSlide,86,1000,614,386,1.41043723554302,4.06315789473684
2010,"SCSI, University College Dublin",UCDSIFTSlide,87,1000,452,548,1.82149362477231,5.64948453608248
2010,"SCSI, University College Dublin",UCDSIFTSlide,88,1000,548,452,1.58478605388273,5.44578313253012
2010,"SCSI, University College Dublin",UCDSIFTSlide,89,1000,737,263,1.20481927710843,2.82795698924731
2010,"SCSI, University College Dublin",UCDSIFTSlide,90,1000,685,315,1.27713920817369,3.21428571428571
2010,"SCSI, University College Dublin",UCDSIFTSlide,91,1000,465,535,1.8018018018018,5.94444444444445
2010,"SCSI, University College Dublin",UCDSIFTSlide,92,1000,377,623,2.08333333333333,6.04854368932039
2010,"SCSI, University College Dublin",UCDSIFTSlide,93,1000,631,369,1.36612021857924,3.65346534653465
2010,"SCSI, University College Dublin",UCDSIFTSlide,94,1000,572,428,1.50375939849624,4.60215053763441
2010,"SCSI, University College Dublin",UCDSIFTSlide,95,1000,511,489,1.70648464163823,6.52
2010,"SCSI, University College Dublin",UCDSIFTSlide,96,1000,503,497,1.68634064080944,5.52222222222222
2010,"SCSI, University College Dublin",UCDSIFTSlide,97,1000,446,554,1.85873605947955,6.02173913043478
2010,"SCSI, University College Dublin",UCDSIFTSlide,98,1000,379,621,2.02020202020202,5.35344827586207
2010,"SCSI, University College Dublin",UCDSIFTSlide,99,1000,490,510,1.74216027874564,6.07142857142857
2010,"SCSI, University College Dublin",UCDSIFTSlide,100,1000,637,363,1.3531799729364,3.55882352941176
2010,The University of Melbourne,UMa10BASF,51,1000,39,961,11.6279069767442,20.4468085106383
2010,The University of Melbourne,UMa10BASF,52,1000,1,999,52.6315789473684,55.5
2010,The University of Melbourne,UMa10BASF,53,1000,202,798,3.3003300330033,7.9009900990099
2010,The University of Melbourne,UMa10BASF,54,1000,103,897,7.69230769230769,33.2222222222222
2010,The University of Melbourne,UMa10BASF,55,1000,0,1000,166.666666666667,166.666666666667
2010,The University of Melbourne,UMa10BASF,56,1000,314,686,2.17864923747277,4.73103448275862
2010,The University of Melbourne,UMa10BASF,57,1000,33,967,16.9491525423729,37.1923076923077
2010,The University of Melbourne,UMa10BASF,58,1000,0,1000,166.666666666667,166.666666666667
2010,The University of Melbourne,UMa10BASF,59,1000,144,856,4.0650406504065,8.3921568627451
2010,The University of Melbourne,UMa10BASF,60,1000,1,999,62.5,66.6
2010,The University of Melbourne,UMa10BASF,61,1000,0,1000,166.666666666667,166.666666666667
2010,The University of Melbourne,UMa10BASF,62,1000,225,775,2.91545189504373,6.56779661016949
2010,The University of Melbourne,UMa10BASF,63,1000,0,1000,58.8235294117647,58.8235294117647
2010,The University of Melbourne,UMa10BASF,64,1000,1,999,62.5,66.6
2010,The University of Melbourne,UMa10BASF,65,1000,72,928,7.8740157480315,16.8727272727273
2010,The University of Melbourne,UMa10BASF,66,1000,428,572,1.98412698412698,7.52631578947368
2010,The University of Melbourne,UMa10BASF,67,1000,12,988,19.2307692307692,24.7
2010,The University of Melbourne,UMa10BASF,68,1000,2,998,66.6666666666667,76.7692307692308
2010,The University of Melbourne,UMa10BASF,69,1000,63,937,8.69565217391304,18.0192307692308
2010,The University of Melbourne,UMa10BASF,70,1000,7,993,58.8235294117647,99.3
2010,The University of Melbourne,UMa10BASF,71,1000,70,930,7.63358778625954,15.2459016393443
2010,The University of Melbourne,UMa10BASF,72,1000,7,993,52.6315789473684,82.75
2010,The University of Melbourne,UMa10BASF,73,1000,69,931,8.33333333333333,18.2549019607843
2010,The University of Melbourne,UMa10BASF,74,1000,0,1000,55.5555555555556,55.5555555555556
2010,The University of Melbourne,UMa10BASF,75,1000,0,1000,111.111111111111,111.111111111111
2010,The University of Melbourne,UMa10BASF,76,1000,46,954,10.989010989011,21.2
2010,The University of Melbourne,UMa10BASF,77,1000,1,999,55.5555555555556,58.764705882353
2010,The University of Melbourne,UMa10BASF,78,1000,0,1000,200,200
2010,The University of Melbourne,UMa10BASF,79,1000,1,999,55.5555555555556,58.764705882353
2010,The University of Melbourne,UMa10BASF,80,1000,109,891,5.15463917525773,10.4823529411765
2010,The University of Melbourne,UMa10BASF,81,1000,0,1000,166.666666666667,166.666666666667
2010,The University of Melbourne,UMa10BASF,82,1000,0,1000,125,125
2010,The University of Melbourne,UMa10BASF,83,1000,0,1000,166.666666666667,166.666666666667
2010,The University of Melbourne,UMa10BASF,84,1000,80,920,7.2463768115942,15.8620689655172
2010,The University of Melbourne,UMa10BASF,85,1000,124,876,4.80769230769231,10.4285714285714
2010,The University of Melbourne,UMa10BASF,86,1000,103,897,5.43478260869565,11.0740740740741
2010,The University of Melbourne,UMa10BASF,87,1000,84,916,5.74712643678161,10.1777777777778
2010,The University of Melbourne,UMa10BASF,88,1000,42,958,10.4166666666667,17.7407407407407
2010,The University of Melbourne,UMa10BASF,89,1000,1,999,55.5555555555556,58.764705882353
2010,The University of Melbourne,UMa10BASF,90,1000,0,1000,55.5555555555556,55.5555555555556
2010,The University of Melbourne,UMa10BASF,91,1000,167,833,3.33333333333333,6.26315789473684
2010,The University of Melbourne,UMa10BASF,92,1000,0,1000,83.3333333333333,83.3333333333333
2010,The University of Melbourne,UMa10BASF,93,1000,2,998,52.6315789473684,58.7058823529412
2010,The University of Melbourne,UMa10BASF,94,1000,0,1000,90.9090909090909,90.9090909090909
2010,The University of Melbourne,UMa10BASF,95,1000,297,703,2.5062656641604,6.8921568627451
2010,The University of Melbourne,UMa10BASF,96,1000,0,1000,166.666666666667,166.666666666667
2010,The University of Melbourne,UMa10BASF,97,1000,11,989,22.2222222222222,29.0882352941177
2010,The University of Melbourne,UMa10BASF,98,1000,1,999,71.4285714285714,76.8461538461538
2010,The University of Melbourne,UMa10BASF,99,1000,0,1000,166.666666666667,166.666666666667
2010,The University of Melbourne,UMa10BASF,100,1000,126,874,4.95049504950495,11.5
2010,The University of Melbourne,UMa10BSF,51,1000,1,999,71.4285714285714,76.8461538461538
2010,The University of Melbourne,UMa10BSF,52,1000,0,1000,1000,1000
2010,The University of Melbourne,UMa10BSF,53,1000,18,982,17.2413793103448,24.55
2010,The University of Melbourne,UMa10BSF,54,1000,5,995,31.25,36.8518518518519
2010,The University of Melbourne,UMa10BSF,55,1000,0,1000,1000,1000
2010,The University of Melbourne,UMa10BSF,56,1000,187,813,3.18471337579618,6.40157480314961
2010,The University of Melbourne,UMa10BSF,57,1000,0,1000,100,100
2010,The University of Melbourne,UMa10BSF,58,1000,0,1000,1000,1000
2010,The University of Melbourne,UMa10BSF,59,1000,3,997,47.6190476190476,55.3888888888889
2010,The University of Melbourne,UMa10BSF,60,1000,0,1000,1000,1000
2010,The University of Melbourne,UMa10BSF,61,1000,0,1000,1000,1000
2010,The University of Melbourne,UMa10BSF,62,1000,42,958,8.62068965517242,12.9459459459459
2010,The University of Melbourne,UMa10BSF,63,1000,0,1000,1000,1000
2010,The University of Melbourne,UMa10BSF,64,1000,0,1000,1000,1000
2010,The University of Melbourne,UMa10BSF,65,1000,0,1000,333.333333333333,333.333333333333
2010,The University of Melbourne,UMa10BSF,66,1000,17,983,19.2307692307692,28.0857142857143
2010,The University of Melbourne,UMa10BSF,67,1000,2,998,30.3030303030303,32.1935483870968
2010,The University of Melbourne,UMa10BSF,68,1000,0,1000,1000,1000
2010,The University of Melbourne,UMa10BSF,69,1000,1,999,45.4545454545455,47.5714285714286
2010,The University of Melbourne,UMa10BSF,70,1000,0,1000,1000,1000
2010,The University of Melbourne,UMa10BSF,71,1000,0,1000,100,100
2010,The University of Melbourne,UMa10BSF,72,1000,0,1000,1000,1000
2010,The University of Melbourne,UMa10BSF,73,1000,0,1000,250,250
2010,The University of Melbourne,UMa10BSF,74,1000,0,1000,1000,1000
2010,The University of Melbourne,UMa10BSF,75,1000,0,1000,1000,1000
2010,The University of Melbourne,UMa10BSF,76,1000,0,1000,166.666666666667,166.666666666667
2010,The University of Melbourne,UMa10BSF,77,1000,0,1000,1000,1000
2010,The University of Melbourne,UMa10BSF,78,1000,0,1000,1000,1000
2010,The University of Melbourne,UMa10BSF,79,1000,0,1000,1000,1000
2010,The University of Melbourne,UMa10BSF,80,1000,0,1000,166.666666666667,166.666666666667
2010,The University of Melbourne,UMa10BSF,81,1000,0,1000,1000,1000
2010,The University of Melbourne,UMa10BSF,82,1000,0,1000,1000,1000
2010,The University of Melbourne,UMa10BSF,83,1000,0,1000,1000,1000
2010,The University of Melbourne,UMa10BSF,84,1000,1,999,55.5555555555556,58.764705882353
2010,The University of Melbourne,UMa10BSF,85,1000,41,959,8.47457627118644,12.4545454545455
2010,The University of Melbourne,UMa10BSF,86,1000,3,997,23.2558139534884,24.925
2010,The University of Melbourne,UMa10BSF,87,1000,5,995,18.1818181818182,19.9
2010,The University of Melbourne,UMa10BSF,88,1000,7,993,31.25,39.72
2010,The University of Melbourne,UMa10BSF,89,1000,0,1000,1000,1000
2010,The University of Melbourne,UMa10BSF,90,1000,0,1000,500,500
2010,The University of Melbourne,UMa10BSF,91,1000,32,968,7.75193798449612,9.97938144329897
2010,The University of Melbourne,UMa10BSF,92,1000,0,1000,1000,1000
2010,The University of Melbourne,UMa10BSF,93,1000,0,1000,1000,1000
2010,The University of Melbourne,UMa10BSF,94,1000,0,1000,1000,1000
2010,The University of Melbourne,UMa10BSF,95,1000,17,983,14.2857142857143,18.5471698113208
2010,The University of Melbourne,UMa10BSF,96,1000,0,1000,1000,1000
2010,The University of Melbourne,UMa10BSF,97,1000,0,1000,1000,1000
2010,The University of Melbourne,UMa10BSF,98,1000,0,1000,1000,1000
2010,The University of Melbourne,UMa10BSF,99,1000,0,1000,1000,1000
2010,The University of Melbourne,UMa10BSF,100,1000,4,996,31.25,35.5714285714286
2010,The University of Melbourne,UMa10IASF,51,1000,21,979,17.5438596491228,27.1944444444444
2010,The University of Melbourne,UMa10IASF,52,1000,1,999,58.8235294117647,62.4375
2010,The University of Melbourne,UMa10IASF,53,1000,141,859,4.36681222707424,9.76136363636364
2010,The University of Melbourne,UMa10IASF,54,1000,90,910,7.93650793650794,25.2777777777778
2010,The University of Melbourne,UMa10IASF,55,1000,0,1000,166.666666666667,166.666666666667
2010,The University of Melbourne,UMa10IASF,56,1000,141,859,4.18410041841004,8.76530612244898
2010,The University of Melbourne,UMa10IASF,57,1000,28,972,21.2765957446809,51.1578947368421
2010,The University of Melbourne,UMa10IASF,58,1000,0,1000,166.666666666667,166.666666666667
2010,The University of Melbourne,UMa10IASF,59,1000,109,891,5.15463917525773,10.4823529411765
2010,The University of Melbourne,UMa10IASF,60,1000,1,999,62.5,66.6
2010,The University of Melbourne,UMa10IASF,61,1000,0,1000,166.666666666667,166.666666666667
2010,The University of Melbourne,UMa10IASF,62,1000,143,857,4.58715596330275,11.4266666666667
2010,The University of Melbourne,UMa10IASF,63,1000,0,1000,58.8235294117647,58.8235294117647
2010,The University of Melbourne,UMa10IASF,64,1000,1,999,62.5,66.6
2010,The University of Melbourne,UMa10IASF,65,1000,53,947,10.1010101010101,20.5869565217391
2010,The University of Melbourne,UMa10IASF,66,1000,305,695,2.54452926208651,7.89772727272727
2010,The University of Melbourne,UMa10IASF,67,1000,9,991,29.4117647058824,39.64
2010,The University of Melbourne,UMa10IASF,68,1000,2,998,66.6666666666667,76.7692307692308
2010,The University of Melbourne,UMa10IASF,69,1000,61,939,8.92857142857143,18.4117647058824
2010,The University of Melbourne,UMa10IASF,70,1000,7,993,58.8235294117647,99.3
2010,The University of Melbourne,UMa10IASF,71,1000,59,941,9.25925925925926,19.2040816326531
2010,The University of Melbourne,UMa10IASF,72,1000,7,993,52.6315789473684,82.75
2010,The University of Melbourne,UMa10IASF,73,1000,36,964,13.1578947368421,24.1
2010,The University of Melbourne,UMa10IASF,74,1000,0,1000,55.5555555555556,55.5555555555556
2010,The University of Melbourne,UMa10IASF,75,1000,0,1000,111.111111111111,111.111111111111
2010,The University of Melbourne,UMa10IASF,76,1000,46,954,11.1111111111111,21.6818181818182
2010,The University of Melbourne,UMa10IASF,77,1000,1,999,55.5555555555556,58.764705882353
2010,The University of Melbourne,UMa10IASF,78,1000,0,1000,200,200
2010,The University of Melbourne,UMa10IASF,79,1000,1,999,55.5555555555556,58.764705882353
2010,The University of Melbourne,UMa10IASF,80,1000,82,918,6.25,11.7692307692308
2010,The University of Melbourne,UMa10IASF,81,1000,0,1000,166.666666666667,166.666666666667
2010,The University of Melbourne,UMa10IASF,82,1000,0,1000,125,125
2010,The University of Melbourne,UMa10IASF,83,1000,0,1000,166.666666666667,166.666666666667
2010,The University of Melbourne,UMa10IASF,84,1000,68,932,8.40336134453782,18.2745098039216
2010,The University of Melbourne,UMa10IASF,85,1000,78,922,6.99300699300699,14.1846153846154
2010,The University of Melbourne,UMa10IASF,86,1000,78,922,6.57894736842105,12.4594594594595
2010,The University of Melbourne,UMa10IASF,87,1000,40,960,10.4166666666667,17.1428571428571
2010,The University of Melbourne,UMa10IASF,88,1000,30,970,15.625,28.5294117647059
2010,The University of Melbourne,UMa10IASF,89,1000,0,1000,62.5,62.5
2010,The University of Melbourne,UMa10IASF,90,1000,0,1000,66.6666666666667,66.6666666666667
2010,The University of Melbourne,UMa10IASF,91,1000,93,907,6.41025641025641,14.3968253968254
2010,The University of Melbourne,UMa10IASF,92,1000,0,1000,83.3333333333333,83.3333333333333
2010,The University of Melbourne,UMa10IASF,93,1000,1,999,55.5555555555556,58.764705882353
2010,The University of Melbourne,UMa10IASF,94,1000,0,1000,90.9090909090909,90.9090909090909
2010,The University of Melbourne,UMa10IASF,95,1000,155,845,4.13223140495868,9.71264367816092
2010,The University of Melbourne,UMa10IASF,96,1000,0,1000,166.666666666667,166.666666666667
2010,The University of Melbourne,UMa10IASF,97,1000,11,989,22.2222222222222,29.0882352941177
2010,The University of Melbourne,UMa10IASF,98,1000,1,999,71.4285714285714,76.8461538461538
2010,The University of Melbourne,UMa10IASF,99,1000,0,1000,166.666666666667,166.666666666667
2010,The University of Melbourne,UMa10IASF,100,1000,99,901,6.06060606060606,13.6515151515152
2010,N/A,blv79y00prob,51,1000,1,999,11.7647058823529,11.8928571428571
2010,N/A,blv79y00prob,52,1000,0,1000,31.25,31.25
2010,N/A,blv79y00prob,53,1000,875,125,1.06951871657754,2.08333333333333
2010,N/A,blv79y00prob,54,1000,688,312,1.21951219512195,2.36363636363636
2010,N/A,blv79y00prob,55,1000,572,428,1.32978723404255,2.37777777777778
2010,N/A,blv79y00prob,56,325,272,53,1.12847222222222,3.3125
2010,N/A,blv79y00prob,57,1000,813,187,1.11234705228031,2.17441860465116
2010,N/A,blv79y00prob,58,1000,94,906,2.89855072463768,3.60956175298805
2010,N/A,blv79y00prob,59,1000,544,456,1.33689839572193,2.23529411764706
2010,N/A,blv79y00prob,60,1000,6,994,7.8740157480315,8.21487603305785
2010,N/A,blv79y00prob,61,1000,116,884,2.80898876404494,3.68333333333333
2010,N/A,blv79y00prob,62,1000,891,109,1.07642626480086,2.86842105263158
2010,N/A,blv79y00prob,63,1000,209,791,2.06611570247934,2.87636363636364
2010,N/A,blv79y00prob,64,1000,4,996,11.1111111111111,11.5813953488372
2010,N/A,blv79y00prob,65,1000,530,470,1.37931034482759,2.41025641025641
2010,N/A,blv79y00prob,66,1000,923,77,1.04058272632674,2.02631578947368
2010,N/A,blv79y00prob,67,1000,407,593,2.11864406779661,9.12307692307692
2010,N/A,blv79y00prob,68,1000,4,996,8.26446280991735,8.51282051282051
2010,N/A,blv79y00prob,69,1000,433,567,1.49253731343284,2.39240506329114
2010,N/A,blv79y00prob,70,1000,950,50,1.02669404517454,2.08333333333333
2010,N/A,blv79y00prob,71,1000,834,166,1.09529025191676,2.10126582278481
2010,N/A,blv79y00prob,72,1000,837,163,1.10253583241455,2.32857142857143
2010,N/A,blv79y00prob,73,1000,385,615,1.59744408945687,2.55186721991701
2010,N/A,blv79y00prob,74,1000,11,989,7.19424460431655,7.7265625
2010,N/A,blv79y00prob,75,1000,6,994,8.84955752212389,9.28971962616822
2010,N/A,blv79y00prob,76,1000,909,91,1.0482180293501,2.02222222222222
2010,N/A,blv79y00prob,77,1000,0,1000,19.2307692307692,19.2307692307692
2010,N/A,blv79y00prob,78,1000,520,480,1.36425648021828,2.25352112676056
2010,N/A,blv79y00prob,79,1000,13,987,6.99300699300699,7.59230769230769
2010,N/A,blv79y00prob,80,1000,656,344,1.22699386503067,2.16352201257862
2010,N/A,blv79y00prob,81,1000,525,475,1.40056022408964,2.51322751322751
2010,N/A,blv79y00prob,82,1000,742,258,1.16279069767442,2.1864406779661
2010,N/A,blv79y00prob,83,1000,248,752,1.91204588910134,2.73454545454545
2010,N/A,blv79y00prob,84,1000,557,443,1.35869565217391,2.47486033519553
2010,N/A,blv79y00prob,85,1000,633,367,1.25944584382872,2.27950310559006
2010,N/A,blv79y00prob,86,1000,716,284,1.24069478908189,3.15555555555556
2010,N/A,blv79y00prob,87,1000,887,113,1.06609808102345,2.2156862745098
2010,N/A,blv79y00prob,88,1000,808,192,1.11482720178372,2.15730337078652
2010,N/A,blv79y00prob,89,1000,0,1000,34.4827586206897,34.4827586206897
2010,N/A,blv79y00prob,90,1000,61,939,4.95049504950495,6.65957446808511
2010,N/A,blv79y00prob,91,1000,950,50,1.02774922918808,2.17391304347826
2010,N/A,blv79y00prob,92,1000,907,93,1.0515247108307,2.11363636363636
2010,N/A,blv79y00prob,93,1000,4,996,9.80392156862745,10.1632653061224
2010,N/A,blv79y00prob,94,1000,80,920,3.15457413249211,3.88185654008439
2010,N/A,blv79y00prob,95,1000,876,124,1.07296137339056,2.21428571428571
2010,N/A,blv79y00prob,96,1000,416,584,1.54559505409583,2.52813852813853
2010,N/A,blv79y00prob,97,1000,417,583,1.50375939849624,2.3508064516129
2010,N/A,blv79y00prob,98,1000,871,129,1.07066381156317,2.04761904761905
2010,N/A,blv79y00prob,99,1000,586,414,1.30890052356021,2.32584269662921
2010,N/A,blv79y00prob,100,1000,155,845,2.40384615384615,3.23754789272031
2010,N/A,blv79y00shnk,51,1000,964,36,1.0183299389002,2
2010,N/A,blv79y00shnk,52,1000,936,64,1.03412616339193,2.06451612903226
2010,N/A,blv79y00shnk,53,1000,978,22,1.01214574898785,2.2
2010,N/A,blv79y00shnk,54,1000,960,40,1.02040816326531,2
2010,N/A,blv79y00shnk,55,1000,885,115,1.06609808102345,2.16981132075472
2010,N/A,blv79y00shnk,56,325,303,22,1.03503184713376,2
2010,N/A,blv79y00shnk,57,1000,984,16,1.00806451612903,2
2010,N/A,blv79y00shnk,58,1000,952,48,1.02459016393443,2
2010,N/A,blv79y00shnk,59,1000,974,26,1.01317122593718,2
2010,N/A,blv79y00shnk,60,1000,943,57,1.03092783505155,2.11111111111111
2010,N/A,blv79y00shnk,61,1000,895,105,1.05820105820106,2.1
2010,N/A,blv79y00shnk,62,1000,958,42,1.02459016393443,2.33333333333333
2010,N/A,blv79y00shnk,63,1000,952,48,1.02564102564103,2.08695652173913
2010,N/A,blv79y00shnk,64,1000,901,99,1.05596620908131,2.15217391304348
2010,N/A,blv79y00shnk,65,1000,954,46,1.02459016393443,2.09090909090909
2010,N/A,blv79y00shnk,66,1000,976,24,1.01214574898785,2
2010,N/A,blv79y00shnk,67,1000,928,72,1.04058272632674,2.18181818181818
2010,N/A,blv79y00shnk,68,1000,966,34,1.0183299389002,2.125
2010,N/A,blv79y00shnk,69,1000,940,60,1.0351966873706,2.30769230769231
2010,N/A,blv79y00shnk,70,1000,964,36,1.01936799184506,2.11764705882353
2010,N/A,blv79y00shnk,71,1000,974,26,1.01317122593718,2
2010,N/A,blv79y00shnk,72,1000,912,88,1.05263157894737,2.31578947368421
2010,N/A,blv79y00shnk,73,1000,944,56,1.02986611740474,2.07407407407407
2010,N/A,blv79y00shnk,74,1000,953,47,1.02669404517454,2.23809523809524
2010,N/A,blv79y00shnk,75,1000,927,73,1.04058272632674,2.14705882352941
2010,N/A,blv79y00shnk,76,1000,976,24,1.01317122593718,2.18181818181818
2010,N/A,blv79y00shnk,77,1000,945,55,1.02986611740474,2.11538461538462
2010,N/A,blv79y00shnk,78,1000,990,10,1.00502512562814,2
2010,N/A,blv79y00shnk,79,1000,926,74,1.04058272632674,2.11428571428571
2010,N/A,blv79y00shnk,80,1000,994,6,1.00300902708124,2
2010,N/A,blv79y00shnk,81,1000,909,91,1.05485232067511,2.33333333333333
2010,N/A,blv79y00shnk,82,1000,906,94,1.05263157894737,2.13636363636364
2010,N/A,blv79y00shnk,83,1000,881,119,1.07066381156317,2.24528301886792
2010,N/A,blv79y00shnk,84,1000,935,65,1.0351966873706,2.09677419354839
2010,N/A,blv79y00shnk,85,1000,962,38,1.01936799184506,2
2010,N/A,blv79y00shnk,86,1000,967,33,1.0183299389002,2.2
2010,N/A,blv79y00shnk,87,1000,965,35,1.0183299389002,2.05882352941176
2010,N/A,blv79y00shnk,88,1000,956,44,1.02354145342886,2.0952380952381
2010,N/A,blv79y00shnk,89,1000,947,53,1.02774922918808,2.03846153846154
2010,N/A,blv79y00shnk,90,1000,962,38,1.02145045965271,2.23529411764706
2010,N/A,blv79y00shnk,91,1000,972,28,1.01522842639594,2.15384615384615
2010,N/A,blv79y00shnk,92,1000,946,54,1.02986611740474,2.16
2010,N/A,blv79y00shnk,93,1000,965,35,1.01936799184506,2.1875
2010,N/A,blv79y00shnk,94,1000,937,63,1.0351966873706,2.17241379310345
2010,N/A,blv79y00shnk,95,1000,932,68,1.05596620908131,4.53333333333333
2010,N/A,blv79y00shnk,96,1000,935,65,1.03412616339193,2.03125
2010,N/A,blv79y00shnk,97,1000,975,25,1.01317122593718,2.08333333333333
2010,N/A,blv79y00shnk,98,1000,962,38,1.01936799184506,2
2010,N/A,blv79y00shnk,99,1000,908,92,1.05596620908131,2.35897435897436
2010,N/A,blv79y00shnk,100,1000,992,8,1.00401606425703,2
2010,Carnegie Mellon University,cmuBase10,51,1000,959,41,1.02145045965271,2.05
2010,Carnegie Mellon University,cmuBase10,52,1000,938,62,1.03842159916926,2.48
2010,Carnegie Mellon University,cmuBase10,53,1000,956,44,1.02249488752556,2
2010,Carnegie Mellon University,cmuBase10,54,1000,936,64,1.03842159916926,2.37037037037037
2010,Carnegie Mellon University,cmuBase10,55,1000,781,219,1.17370892018779,3.08450704225352
2010,Carnegie Mellon University,cmuBase10,56,1000,901,99,1.05374077976818,2.0625
2010,Carnegie Mellon University,cmuBase10,57,1000,922,78,1.04712041884817,2.36363636363636
2010,Carnegie Mellon University,cmuBase10,58,1000,942,58,1.02986611740474,2
2010,Carnegie Mellon University,cmuBase10,59,1000,972,28,1.01419878296146,2
2010,Carnegie Mellon University,cmuBase10,60,1000,954,46,1.02564102564103,2.19047619047619
2010,Carnegie Mellon University,cmuBase10,61,1000,943,57,1.02986611740474,2.03571428571429
2010,Carnegie Mellon University,cmuBase10,62,1000,976,24,1.01214574898785,2
2010,Carnegie Mellon University,cmuBase10,63,1000,942,58,1.03412616339193,2.32
2010,Carnegie Mellon University,cmuBase10,64,1000,901,99,1.05820105820106,2.25
2010,Carnegie Mellon University,cmuBase10,65,1000,950,50,1.02774922918808,2.17391304347826
2010,Carnegie Mellon University,cmuBase10,66,1000,960,40,1.02145045965271,2.10526315789474
2010,Carnegie Mellon University,cmuBase10,67,1000,918,82,1.04275286757039,2
2010,Carnegie Mellon University,cmuBase10,68,1000,966,34,1.01729399796541,2
2010,Carnegie Mellon University,cmuBase10,69,1000,914,86,1.05042016806723,2.26315789473684
2010,Carnegie Mellon University,cmuBase10,70,1000,951,49,1.02564102564103,2.04166666666667
2010,Carnegie Mellon University,cmuBase10,71,1000,949,51,1.02880658436214,2.21739130434783
2010,Carnegie Mellon University,cmuBase10,72,1000,929,71,1.03842159916926,2.08823529411765
2010,Carnegie Mellon University,cmuBase10,73,1000,954,46,1.02354145342886,2
2010,Carnegie Mellon University,cmuBase10,74,1000,919,81,1.04602510460251,2.18918918918919
2010,Carnegie Mellon University,cmuBase10,75,1000,918,82,1.04384133611691,2.05
2010,Carnegie Mellon University,cmuBase10,76,1000,970,30,1.01626016260163,2.14285714285714
2010,Carnegie Mellon University,cmuBase10,77,1000,950,50,1.02564102564103,2
2010,Carnegie Mellon University,cmuBase10,78,1000,970,30,1.01522842639594,2
2010,Carnegie Mellon University,cmuBase10,79,1000,912,88,1.05263157894737,2.31578947368421
2010,Carnegie Mellon University,cmuBase10,80,1000,963,37,1.02040816326531,2.17647058823529
2010,Carnegie Mellon University,cmuBase10,81,1000,945,55,1.02986611740474,2.11538461538462
2010,Carnegie Mellon University,cmuBase10,82,1000,966,34,1.01936799184506,2.26666666666667
2010,Carnegie Mellon University,cmuBase10,83,1000,85,915,4.739336492891,7.26190476190476
2010,Carnegie Mellon University,cmuBase10,84,1000,907,93,1.05263157894737,2.16279069767442
2010,Carnegie Mellon University,cmuBase10,85,1000,963,37,1.01936799184506,2.05555555555556
2010,Carnegie Mellon University,cmuBase10,86,1000,952,48,1.02669404517454,2.18181818181818
2010,Carnegie Mellon University,cmuBase10,87,1000,959,41,1.02145045965271,2.05
2010,Carnegie Mellon University,cmuBase10,88,1000,974,26,1.01419878296146,2.16666666666667
2010,Carnegie Mellon University,cmuBase10,89,1000,937,63,1.04275286757039,2.86363636363636
2010,Carnegie Mellon University,cmuBase10,90,1000,808,192,1.12994350282486,2.49350649350649
2010,Carnegie Mellon University,cmuBase10,91,1000,952,48,1.02774922918808,2.28571428571429
2010,Carnegie Mellon University,cmuBase10,92,1000,931,69,1.03734439834025,2.09090909090909
2010,Carnegie Mellon University,cmuBase10,93,1000,967,33,1.01729399796541,2.0625
2010,Carnegie Mellon University,cmuBase10,94,1000,949,51,1.02669404517454,2.04
2010,Carnegie Mellon University,cmuBase10,95,1000,941,59,1.03305785123967,2.18518518518519
2010,Carnegie Mellon University,cmuBase10,96,1000,986,14,1.00704934541793,2
2010,Carnegie Mellon University,cmuBase10,97,1000,946,54,1.02986611740474,2.16
2010,Carnegie Mellon University,cmuBase10,98,1000,917,83,1.04931794333683,2.30555555555556
2010,Carnegie Mellon University,cmuBase10,99,1000,896,104,1.06269925611052,2.31111111111111
2010,Carnegie Mellon University,cmuBase10,100,1000,972,28,1.01419878296146,2
2010,Carnegie Mellon University,cmuFuTop10,51,1000,975,25,1.01317122593718,2.08333333333333
2010,Carnegie Mellon University,cmuFuTop10,52,1000,797,203,1.17647058823529,3.83018867924528
2010,Carnegie Mellon University,cmuFuTop10,53,1000,936,64,1.03305785123967,2
2010,Carnegie Mellon University,cmuFuTop10,54,1000,921,79,1.04712041884817,2.32352941176471
2010,Carnegie Mellon University,cmuFuTop10,55,1000,959,41,1.02145045965271,2.05
2010,Carnegie Mellon University,cmuFuTop10,56,1000,873,127,1.06951871657754,2.04838709677419
2010,Carnegie Mellon University,cmuFuTop10,57,1000,959,41,1.02459016393443,2.41176470588235
2010,Carnegie Mellon University,cmuFuTop10,58,1000,978,22,1.01112234580384,2
2010,Carnegie Mellon University,cmuFuTop10,59,1000,978,22,1.01112234580384,2
2010,Carnegie Mellon University,cmuFuTop10,60,1000,968,32,1.01626016260163,2
2010,Carnegie Mellon University,cmuFuTop10,61,1000,956,44,1.02249488752556,2
2010,Carnegie Mellon University,cmuFuTop10,62,1000,974,26,1.01317122593718,2
2010,Carnegie Mellon University,cmuFuTop10,63,1000,928,72,1.04275286757039,2.32258064516129
2010,Carnegie Mellon University,cmuFuTop10,64,1000,935,65,1.03626943005181,2.16666666666667
2010,Carnegie Mellon University,cmuFuTop10,65,1000,932,68,1.03734439834025,2.125
2010,Carnegie Mellon University,cmuFuTop10,66,1000,937,63,1.03305785123967,2.03225806451613
2010,Carnegie Mellon University,cmuFuTop10,67,1000,932,68,1.03842159916926,2.19354838709677
2010,Carnegie Mellon University,cmuFuTop10,68,1000,964,36,1.0183299389002,2
2010,Carnegie Mellon University,cmuFuTop10,69,1000,968,32,1.0183299389002,2.28571428571429
2010,Carnegie Mellon University,cmuFuTop10,70,1000,984,16,1.00806451612903,2
2010,Carnegie Mellon University,cmuFuTop10,71,1000,959,41,1.02249488752556,2.15789473684211
2010,Carnegie Mellon University,cmuFuTop10,72,1000,922,78,1.04384133611691,2.16666666666667
2010,Carnegie Mellon University,cmuFuTop10,73,1000,976,24,1.01214574898785,2
2010,Carnegie Mellon University,cmuFuTop10,74,1000,918,82,1.0482180293501,2.27777777777778
2010,Carnegie Mellon University,cmuFuTop10,75,1000,921,79,1.04166666666667,2.02564102564103
2010,Carnegie Mellon University,cmuFuTop10,76,1000,968,32,1.01626016260163,2
2010,Carnegie Mellon University,cmuFuTop10,77,1000,962,38,1.01936799184506,2
2010,Carnegie Mellon University,cmuFuTop10,78,1000,956,44,1.02249488752556,2
2010,Carnegie Mellon University,cmuFuTop10,79,1000,916,84,1.05042016806723,2.33333333333333
2010,Carnegie Mellon University,cmuFuTop10,80,1000,957,43,1.02354145342886,2.15
2010,Carnegie Mellon University,cmuFuTop10,81,1000,962,38,1.01936799184506,2
2010,Carnegie Mellon University,cmuFuTop10,82,1000,954,46,1.02459016393443,2.09090909090909
2010,Carnegie Mellon University,cmuFuTop10,83,1000,127,873,4.0983606557377,7.46153846153846
2010,Carnegie Mellon University,cmuFuTop10,84,1000,949,51,1.02774922918808,2.125
2010,Carnegie Mellon University,cmuFuTop10,85,1000,972,28,1.01419878296146,2
2010,Carnegie Mellon University,cmuFuTop10,86,1000,971,29,1.01522842639594,2.07142857142857
2010,Carnegie Mellon University,cmuFuTop10,87,1000,943,57,1.02986611740474,2.03571428571429
2010,Carnegie Mellon University,cmuFuTop10,88,1000,962,38,1.01936799184506,2
2010,Carnegie Mellon University,cmuFuTop10,89,1000,948,52,1.03734439834025,3.25
2010,Carnegie Mellon University,cmuFuTop10,90,1000,807,193,1.13250283125708,2.53947368421053
2010,Carnegie Mellon University,cmuFuTop10,91,1000,960,40,1.02040816326531,2
2010,Carnegie Mellon University,cmuFuTop10,92,1000,921,79,1.04275286757039,2.07894736842105
2010,Carnegie Mellon University,cmuFuTop10,93,1000,975,25,1.01317122593718,2.08333333333333
2010,Carnegie Mellon University,cmuFuTop10,94,1000,932,68,1.04712041884817,2.95652173913043
2010,Carnegie Mellon University,cmuFuTop10,95,1000,922,78,1.04493207941484,2.22857142857143
2010,Carnegie Mellon University,cmuFuTop10,96,1000,972,28,1.01419878296146,2
2010,Carnegie Mellon University,cmuFuTop10,97,1000,968,32,1.01729399796541,2.13333333333333
2010,Carnegie Mellon University,cmuFuTop10,98,1000,954,46,1.02459016393443,2.09090909090909
2010,Carnegie Mellon University,cmuFuTop10,99,1000,866,134,1.08813928182807,2.52830188679245
2010,Carnegie Mellon University,cmuFuTop10,100,1000,974,26,1.01317122593718,2
2010,Carnegie Mellon University,cmuWiki10,51,1000,974,26,1.01317122593718,2
2010,Carnegie Mellon University,cmuWiki10,52,1000,886,114,1.085776330076,3.25714285714286
2010,Carnegie Mellon University,cmuWiki10,53,1000,936,64,1.03305785123967,2
2010,Carnegie Mellon University,cmuWiki10,54,1000,932,68,1.03626943005181,2.06060606060606
2010,Carnegie Mellon University,cmuWiki10,55,1000,953,47,1.02459016393443,2.04347826086957
2010,Carnegie Mellon University,cmuWiki10,56,1000,862,138,1.07642626480086,2.05970149253731
2010,Carnegie Mellon University,cmuWiki10,57,1000,922,78,1.04712041884817,2.36363636363636
2010,Carnegie Mellon University,cmuWiki10,58,1000,955,45,1.02354145342886,2.04545454545455
2010,Carnegie Mellon University,cmuWiki10,59,1000,952,48,1.02459016393443,2
2010,Carnegie Mellon University,cmuWiki10,60,1000,966,34,1.01729399796541,2
2010,Carnegie Mellon University,cmuWiki10,61,1000,949,51,1.02774922918808,2.125
2010,Carnegie Mellon University,cmuWiki10,62,1000,966,34,1.01729399796541,2
2010,Carnegie Mellon University,cmuWiki10,63,1000,930,70,1.04712041884817,2.8
2010,Carnegie Mellon University,cmuWiki10,64,1000,937,63,1.0351966873706,2.17241379310345
2010,Carnegie Mellon University,cmuWiki10,65,1000,931,69,1.03842159916926,2.15625
2010,Carnegie Mellon University,cmuWiki10,66,1000,933,67,1.0351966873706,2.03030303030303
2010,Carnegie Mellon University,cmuWiki10,67,1000,875,125,1.07066381156317,2.11864406779661
2010,Carnegie Mellon University,cmuWiki10,68,1000,969,31,1.01626016260163,2.06666666666667
2010,Carnegie Mellon University,cmuWiki10,69,1000,952,48,1.02669404517454,2.18181818181818
2010,Carnegie Mellon University,cmuWiki10,70,1000,951,49,1.02564102564103,2.04166666666667
2010,Carnegie Mellon University,cmuWiki10,71,1000,913,87,1.04712041884817,2.07142857142857
2010,Carnegie Mellon University,cmuWiki10,72,1000,911,89,1.04931794333683,2.11904761904762
2010,Carnegie Mellon University,cmuWiki10,73,1000,945,55,1.02986611740474,2.11538461538462
2010,Carnegie Mellon University,cmuWiki10,74,1000,953,47,1.02564102564103,2.13636363636364
2010,Carnegie Mellon University,cmuWiki10,75,1000,941,59,1.03092783505155,2.03448275862069
2010,Carnegie Mellon University,cmuWiki10,76,1000,972,28,1.01522842639594,2.15384615384615
2010,Carnegie Mellon University,cmuWiki10,77,1000,963,37,1.01936799184506,2.05555555555556
2010,Carnegie Mellon University,cmuWiki10,78,1000,951,49,1.02564102564103,2.04166666666667
2010,Carnegie Mellon University,cmuWiki10,79,1000,936,64,1.03842159916926,2.37037037037037
2010,Carnegie Mellon University,cmuWiki10,80,1000,955,45,1.02459016393443,2.14285714285714
2010,Carnegie Mellon University,cmuWiki10,81,1000,951,49,1.02564102564103,2.04166666666667
2010,Carnegie Mellon University,cmuWiki10,82,1000,920,80,1.05263157894737,2.66666666666667
2010,Carnegie Mellon University,cmuWiki10,83,1000,383,617,1.70648464163823,3.03940886699507
2010,Carnegie Mellon University,cmuWiki10,84,1000,948,52,1.02774922918808,2.08
2010,Carnegie Mellon University,cmuWiki10,85,1000,966,34,1.01729399796541,2
2010,Carnegie Mellon University,cmuWiki10,86,1000,974,26,1.01317122593718,2
2010,Carnegie Mellon University,cmuWiki10,87,1000,743,257,1.17096018735363,2.31531531531532
2010,Carnegie Mellon University,cmuWiki10,88,1000,860,140,1.08225108225108,2.1875
2010,Carnegie Mellon University,cmuWiki10,89,1000,960,40,1.02145045965271,2.10526315789474
2010,Carnegie Mellon University,cmuWiki10,90,1000,784,216,1.14942528735632,2.51162790697674
2010,Carnegie Mellon University,cmuWiki10,91,1000,923,77,1.04493207941484,2.26470588235294
2010,Carnegie Mellon University,cmuWiki10,92,1000,941,59,1.03092783505155,2.03448275862069
2010,Carnegie Mellon University,cmuWiki10,93,1000,966,34,1.01729399796541,2
2010,Carnegie Mellon University,cmuWiki10,94,1000,966,34,1.01729399796541,2
2010,Carnegie Mellon University,cmuWiki10,95,1000,941,59,1.03305785123967,2.18518518518519
2010,Carnegie Mellon University,cmuWiki10,96,1000,972,28,1.01419878296146,2
2010,Carnegie Mellon University,cmuWiki10,97,1000,951,49,1.02669404517454,2.1304347826087
2010,Carnegie Mellon University,cmuWiki10,98,1000,956,44,1.02249488752556,2
2010,Carnegie Mellon University,cmuWiki10,99,1000,744,256,1.20192307692308,2.90909090909091
2010,Carnegie Mellon University,cmuWiki10,100,1000,978,22,1.01112234580384,2
2010,Mugla University,irra10b,51,1000,816,184,1.11234705228031,2.21686746987952
2010,Mugla University,irra10b,52,1000,738,262,1.18063754427391,2.40366972477064
2010,Mugla University,irra10b,53,1000,677,323,1.26582278481013,2.85840707964602
2010,Mugla University,irra10b,54,1000,610,390,1.32802124833997,2.72727272727273
2010,Mugla University,irra10b,55,1000,724,276,1.20192307692308,2.55555555555556
2010,Mugla University,irra10b,56,1000,693,307,1.2531328320802,2.92380952380952
2010,Mugla University,irra10b,57,1000,791,209,1.13507377979569,2.32222222222222
2010,Mugla University,irra10b,58,1000,743,257,1.17647058823529,2.4018691588785
2010,Mugla University,irra10b,59,1000,839,161,1.09529025191676,2.17567567567568
2010,Mugla University,irra10b,60,1000,661,339,1.22850122850123,2.2156862745098
2010,Mugla University,irra10b,61,1000,629,371,1.28700128700129,2.50675675675676
2010,Mugla University,irra10b,62,1000,825,175,1.11482720178372,2.43055555555556
2010,Mugla University,irra10b,63,1000,742,258,1.17924528301887,2.43396226415094
2010,Mugla University,irra10b,64,1000,733,267,1.18764845605701,2.44954128440367
2010,Mugla University,irra10b,65,1000,733,267,1.18203309692671,2.36283185840708
2010,Mugla University,irra10b,66,1000,815,185,1.13507377979569,2.8030303030303
2010,Mugla University,irra10b,67,1000,751,249,1.18906064209275,2.76666666666667
2010,Mugla University,irra10b,68,1000,825,175,1.10497237569061,2.1875
2010,Mugla University,irra10b,69,1000,865,135,1.08108108108108,2.25
2010,Mugla University,irra10b,70,1000,960,40,1.02040816326531,2
2010,Mugla University,irra10b,71,1000,775,225,1.16009280742459,2.58620689655172
2010,Mugla University,irra10b,72,1000,701,299,1.24069478908189,2.84761904761905
2010,Mugla University,irra10b,73,1000,698,302,1.21802679658953,2.45528455284553
2010,Mugla University,irra10b,74,1000,756,244,1.15606936416185,2.23853211009174
2010,Mugla University,irra10b,75,1000,711,289,1.20481927710843,2.42857142857143
2010,Mugla University,irra10b,76,1000,857,143,1.09649122807018,2.6
2010,Mugla University,irra10b,77,1000,785,215,1.13250283125708,2.19387755102041
2010,Mugla University,irra10b,78,1000,815,185,1.11607142857143,2.28395061728395
2010,Mugla University,irra10b,79,1000,724,276,1.18764845605701,2.33898305084746
2010,Mugla University,irra10b,80,1000,871,129,1.09170305676856,2.86666666666667
2010,Mugla University,irra10b,81,1000,677,323,1.27388535031847,2.99074074074074
2010,Mugla University,irra10b,82,1000,767,233,1.16822429906542,2.61797752808989
2010,Mugla University,irra10b,83,1000,659,341,1.2987012987013,3.07207207207207
2010,Mugla University,irra10b,84,1000,771,229,1.16550116550117,2.63218390804598
2010,Mugla University,irra10b,85,1000,760,240,1.16822429906542,2.5
2010,Mugla University,irra10b,86,1000,865,135,1.08225108225108,2.28813559322034
2010,Mugla University,irra10b,87,1000,810,190,1.13378684807256,2.63888888888889
2010,Mugla University,irra10b,88,1000,830,170,1.11856823266219,2.65625
2010,Mugla University,irra10b,89,1000,824,176,1.1037527593819,2.14634146341463
2010,Mugla University,irra10b,90,1000,675,325,1.23456790123457,2.40740740740741
2010,Mugla University,irra10b,91,1000,737,263,1.20481927710843,2.82795698924731
2010,Mugla University,irra10b,92,1000,802,198,1.13507377979569,2.50632911392405
2010,Mugla University,irra10b,93,1000,771,229,1.14155251141553,2.18095238095238
2010,Mugla University,irra10b,94,1000,688,312,1.21951219512195,2.36363636363636
2010,Mugla University,irra10b,95,1000,920,80,1.04712041884817,2.28571428571429
2010,Mugla University,irra10b,96,1000,740,260,1.18063754427391,2.42990654205607
2010,Mugla University,irra10b,97,1000,840,160,1.11234705228031,2.71186440677966
2010,Mugla University,irra10b,98,1000,804,196,1.13636363636364,2.57894736842105
2010,Mugla University,irra10b,99,1000,722,278,1.21951219512195,2.83673469387755
2010,Mugla University,irra10b,100,1000,826,174,1.12359550561798,2.71875
2010,Mugla University,irra10hp,51,1000,827,173,1.10987791342952,2.33783783783784
2010,Mugla University,irra10hp,52,1000,785,215,1.13507377979569,2.23958333333333
2010,Mugla University,irra10hp,53,1000,748,252,1.194743130227,2.8314606741573
2010,Mugla University,irra10hp,54,1000,816,184,1.11856823266219,2.35897435897436
2010,Mugla University,irra10hp,55,1000,737,263,1.19617224880383,2.65656565656566
2010,Mugla University,irra10hp,56,1000,746,254,1.20048019207683,2.91954022988506
2010,Mugla University,irra10hp,57,1000,855,145,1.09529025191676,2.5
2010,Mugla University,irra10hp,58,1000,803,197,1.12612612612613,2.31764705882353
2010,Mugla University,irra10hp,59,1000,863,137,1.08108108108108,2.20967741935484
2010,Mugla University,irra10hp,60,1000,798,202,1.11731843575419,2.08247422680412
2010,Mugla University,irra10hp,61,1000,721,279,1.20336943441637,2.53636363636364
2010,Mugla University,irra10hp,62,1000,840,160,1.10497237569061,2.46153846153846
2010,Mugla University,irra10hp,63,1000,816,184,1.12359550561798,2.48648648648649
2010,Mugla University,irra10hp,64,1000,774,226,1.15340253748558,2.43010752688172
2010,Mugla University,irra10hp,65,1000,794,206,1.12866817155756,2.23913043478261
2010,Mugla University,irra10hp,66,1000,907,93,1.06269925611052,2.73529411764706
2010,Mugla University,irra10hp,67,1000,793,207,1.15606936416185,2.875
2010,Mugla University,irra10hp,68,1000,835,165,1.09769484083425,2.17105263157895
2010,Mugla University,irra10hp,69,1000,803,197,1.16822429906542,3.71698113207547
2010,Mugla University,irra10hp,70,1000,947,53,1.02774922918808,2.03846153846154
2010,Mugla University,irra10hp,71,1000,895,105,1.06382978723404,2.33333333333333
2010,Mugla University,irra10hp,72,1000,736,264,1.21506682867558,3.03448275862069
2010,Mugla University,irra10hp,73,1000,819,181,1.11856823266219,2.41333333333333
2010,Mugla University,irra10hp,74,1000,807,193,1.11856823266219,2.2183908045977
2010,Mugla University,irra10hp,75,1000,745,255,1.16959064327485,2.31818181818182
2010,Mugla University,irra10hp,76,1000,893,107,1.06044538706257,2.14
2010,Mugla University,irra10hp,77,1000,838,162,1.09529025191676,2.16
2010,Mugla University,irra10hp,78,1000,947,53,1.03092783505155,2.30434782608696
2010,Mugla University,irra10hp,79,1000,785,215,1.1454753722795,2.44318181818182
2010,Mugla University,irra10hp,80,1000,981,19,1.01010101010101,2.11111111111111
2010,Mugla University,irra10hp,81,1000,777,223,1.17370892018779,2.97333333333333
2010,Mugla University,irra10hp,82,1000,824,176,1.11731843575419,2.47887323943662
2010,Mugla University,irra10hp,83,1000,875,125,1.08459869848156,2.65957446808511
2010,Mugla University,irra10hp,84,1000,813,187,1.12612612612613,2.49333333333333
2010,Mugla University,irra10hp,85,1000,839,161,1.10132158590308,2.33333333333333
2010,Mugla University,irra10hp,86,1000,900,100,1.05932203389831,2.27272727272727
2010,Mugla University,irra10hp,87,1000,921,79,1.04384133611691,2.13513513513514
2010,Mugla University,irra10hp,88,1000,855,145,1.09170305676856,2.37704918032787
2010,Mugla University,irra10hp,89,1000,853,147,1.08342361863489,2.1
2010,Mugla University,irra10hp,90,1000,753,247,1.16414435389988,2.33018867924528
2010,Mugla University,irra10hp,91,1000,907,93,1.05596620908131,2.325
2010,Mugla University,irra10hp,92,1000,849,151,1.09649122807018,2.3968253968254
2010,Mugla University,irra10hp,93,1000,776,224,1.13765642775882,2.1747572815534
2010,Mugla University,irra10hp,94,1000,833,167,1.10132158590308,2.22666666666667
2010,Mugla University,irra10hp,95,1000,855,145,1.13507377979569,5.57692307692308
2010,Mugla University,irra10hp,96,1000,802,198,1.12994350282486,2.3855421686747
2010,Mugla University,irra10hp,97,1000,935,65,1.0351966873706,2.09677419354839
2010,Mugla University,irra10hp,98,1000,714,286,1.20627261761158,2.48695652173913
2010,Mugla University,irra10hp,99,1000,853,147,1.10987791342952,3.0625
2010,Mugla University,irra10hp,100,1000,921,79,1.04384133611691,2.13513513513514
2010,Mugla University,irra10rob,51,1000,832,168,1.10253583241455,2.24
2010,Mugla University,irra10rob,52,1000,783,217,1.14285714285714,2.35869565217391
2010,Mugla University,irra10rob,53,1000,701,299,1.23915737298637,2.82075471698113
2010,Mugla University,irra10rob,54,1000,755,245,1.16550116550117,2.37864077669903
2010,Mugla University,irra10rob,55,1000,764,236,1.16686114352392,2.53763440860215
2010,Mugla University,irra10rob,56,1000,723,277,1.21802679658953,2.8265306122449
2010,Mugla University,irra10rob,57,1000,826,174,1.11234705228031,2.38356164383562
2010,Mugla University,irra10rob,58,1000,766,234,1.15207373271889,2.29411764705882
2010,Mugla University,irra10rob,59,1000,855,145,1.08459869848156,2.16417910447761
2010,Mugla University,irra10rob,60,1000,675,325,1.21506682867558,2.19594594594595
2010,Mugla University,irra10rob,61,1000,617,383,1.29198966408269,2.43949044585987
2010,Mugla University,irra10rob,62,1000,849,151,1.0989010989011,2.47540983606557
2010,Mugla University,irra10rob,63,1000,741,259,1.18203309692671,2.46666666666667
2010,Mugla University,irra10rob,64,1000,723,277,1.19617224880383,2.45132743362832
2010,Mugla University,irra10rob,65,1000,759,241,1.15207373271889,2.21100917431193
2010,Mugla University,irra10rob,66,1000,849,151,1.10741971207087,2.7962962962963
2010,Mugla University,irra10rob,67,1000,786,214,1.16279069767442,2.89189189189189
2010,Mugla University,irra10rob,68,1000,819,181,1.10987791342952,2.20731707317073
2010,Mugla University,irra10rob,69,1000,867,133,1.07991360691145,2.25423728813559
2010,Mugla University,irra10rob,70,1000,943,57,1.02986611740474,2.03571428571429
2010,Mugla University,irra10rob,71,1000,857,143,1.08695652173913,2.26984126984127
2010,Mugla University,irra10rob,72,1000,548,452,1.50829562594268,3.9304347826087
2010,Mugla University,irra10rob,73,1000,774,226,1.15473441108545,2.45652173913043
2010,Mugla University,irra10rob,74,1000,775,225,1.14285714285714,2.25
2010,Mugla University,irra10rob,75,1000,738,262,1.17508813160987,2.31858407079646
2010,Mugla University,irra10rob,76,1000,871,129,1.08813928182807,2.6875
2010,Mugla University,irra10rob,77,1000,801,199,1.12233445566779,2.21111111111111
2010,Mugla University,irra10rob,78,1000,837,163,1.0989010989011,2.23287671232877
2010,Mugla University,irra10rob,79,1000,755,245,1.15606936416185,2.22727272727273
2010,Mugla University,irra10rob,80,1000,966,34,1.0183299389002,2.125
2010,Mugla University,irra10rob,81,1000,691,309,1.25786163522013,2.97115384615385
2010,Mugla University,irra10rob,82,1000,783,217,1.14942528735632,2.49425287356322
2010,Mugla University,irra10rob,83,1000,759,241,1.16009280742459,2.33980582524272
2010,Mugla University,irra10rob,84,1000,788,212,1.14942528735632,2.58536585365854
2010,Mugla University,irra10rob,85,1000,819,181,1.11482720178372,2.32051282051282
2010,Mugla University,irra10rob,86,1000,884,116,1.06951871657754,2.27450980392157
2010,Mugla University,irra10rob,87,1000,899,101,1.06157112526539,2.34883720930233
2010,Mugla University,irra10rob,88,1000,870,130,1.08225108225108,2.40740740740741
2010,Mugla University,irra10rob,89,1000,845,155,1.08932461873638,2.12328767123288
2010,Mugla University,irra10rob,90,1000,788,212,1.13895216400911,2.35555555555556
2010,Mugla University,irra10rob,91,1000,864,136,1.085776330076,2.3859649122807
2010,Mugla University,irra10rob,92,1000,796,204,1.13895216400911,2.48780487804878
2010,Mugla University,irra10rob,93,1000,774,226,1.14025085518814,2.19417475728155
2010,Mugla University,irra10rob,94,1000,728,272,1.17647058823529,2.22950819672131
2010,Mugla University,irra10rob,95,1000,912,88,1.06723585912487,3.52
2010,Mugla University,irra10rob,96,1000,738,262,1.18063754427391,2.40366972477064
2010,Mugla University,irra10rob,97,1000,872,128,1.08108108108108,2.41509433962264
2010,Mugla University,irra10rob,98,1000,806,194,1.12233445566779,2.28235294117647
2010,Mugla University,irra10rob,99,1000,737,263,1.20336943441637,2.79787234042553
2010,Mugla University,irra10rob,100,1000,881,119,1.08108108108108,2.70454545454545
2010,Microsoft Research,msrsv1,51,1000,994,6,1.00300902708124,2
2010,Microsoft Research,msrsv1,52,1000,979,21,1.01214574898785,2.33333333333333
2010,Microsoft Research,msrsv1,53,1000,992,8,1.00401606425703,2
2010,Microsoft Research,msrsv1,54,1000,962,38,1.02145045965271,2.23529411764706
2010,Microsoft Research,msrsv1,55,1000,986,14,1.00704934541793,2
2010,Microsoft Research,msrsv1,56,1000,967,33,1.01729399796541,2.0625
2010,Microsoft Research,msrsv1,57,1000,992,8,1.00401606425703,2
2010,Microsoft Research,msrsv1,58,1000,984,16,1.00806451612903,2
2010,Microsoft Research,msrsv1,59,1000,967,33,1.01936799184506,2.35714285714286
2010,Microsoft Research,msrsv1,60,1000,990,10,1.00502512562814,2
2010,Microsoft Research,msrsv1,61,1000,990,10,1.00502512562814,2
2010,Microsoft Research,msrsv1,62,1000,994,6,1.00300902708124,2
2010,Microsoft Research,msrsv1,63,1000,994,6,1.00300902708124,2
2010,Microsoft Research,msrsv1,64,1000,990,10,1.00502512562814,2
2010,Microsoft Research,msrsv1,65,1000,998,2,1.001001001001,2
2010,Microsoft Research,msrsv1,66,1000,996,4,1.00200400801603,2
2010,Microsoft Research,msrsv1,67,1000,941,59,1.03734439834025,2.56521739130435
2010,Microsoft Research,msrsv1,68,1000,979,21,1.01112234580384,2.1
2010,Microsoft Research,msrsv1,69,1000,990,10,1.00502512562814,2
2010,Microsoft Research,msrsv1,70,1000,992,8,1.00401606425703,2
2010,Microsoft Research,msrsv1,71,1000,998,2,1.001001001001,2
2010,Microsoft Research,msrsv1,72,1000,998,2,1.001001001001,2
2010,Microsoft Research,msrsv1,73,1000,993,7,1.00401606425703,2.33333333333333
2010,Microsoft Research,msrsv1,74,1000,996,4,1.00200400801603,2
2010,Microsoft Research,msrsv1,75,1000,977,23,1.01214574898785,2.09090909090909
2010,Microsoft Research,msrsv1,76,1000,986,14,1.00704934541793,2
2010,Microsoft Research,msrsv1,77,1000,994,6,1.00300902708124,2
2010,Microsoft Research,msrsv1,78,1000,1000,0,1,
2010,Microsoft Research,msrsv1,79,1000,992,8,1.00401606425703,2
2010,Microsoft Research,msrsv1,80,1000,1000,0,1,
2010,Microsoft Research,msrsv1,81,1000,994,6,1.00300902708124,2
2010,Microsoft Research,msrsv1,82,1000,998,2,1.001001001001,2
2010,Microsoft Research,msrsv1,83,1000,992,8,1.00401606425703,2
2010,Microsoft Research,msrsv1,84,1000,856,144,1.12866817155756,4.8
2010,Microsoft Research,msrsv1,85,1000,990,10,1.00502512562814,2
2010,Microsoft Research,msrsv1,86,1000,973,27,1.01522842639594,2.25
2010,Microsoft Research,msrsv1,87,1000,998,2,1.001001001001,2
2010,Microsoft Research,msrsv1,88,1000,973,27,1.01626016260163,2.45454545454545
2010,Microsoft Research,msrsv1,89,1000,986,14,1.00704934541793,2
2010,Microsoft Research,msrsv1,90,1000,986,14,1.00704934541793,2
2010,Microsoft Research,msrsv1,91,1000,989,11,1.00603621730382,2.2
2010,Microsoft Research,msrsv1,92,1000,994,6,1.00300902708124,2
2010,Microsoft Research,msrsv1,93,1000,986,14,1.00704934541793,2
2010,Microsoft Research,msrsv1,94,1000,998,2,1.001001001001,2
2010,Microsoft Research,msrsv1,95,1000,994,6,1.00300902708124,2
2010,Microsoft Research,msrsv1,96,1000,986,14,1.00704934541793,2
2010,Microsoft Research,msrsv1,97,1000,1000,0,1,
2010,Microsoft Research,msrsv1,98,1000,996,4,1.00200400801603,2
2010,Microsoft Research,msrsv1,99,1000,1000,0,1,
2010,Microsoft Research,msrsv1,100,1000,986,14,1.00908173562059,2.8
2010,Microsoft Research,msrsv2,51,1000,994,6,1.00300902708124,2
2010,Microsoft Research,msrsv2,52,1000,975,25,1.01419878296146,2.27272727272727
2010,Microsoft Research,msrsv2,53,1000,992,8,1.00401606425703,2
2010,Microsoft Research,msrsv2,54,1000,962,38,1.02145045965271,2.23529411764706
2010,Microsoft Research,msrsv2,55,1000,986,14,1.00704934541793,2
2010,Microsoft Research,msrsv2,56,1000,967,33,1.01729399796541,2.0625
2010,Microsoft Research,msrsv2,57,1000,992,8,1.00401606425703,2
2010,Microsoft Research,msrsv2,58,1000,984,16,1.00806451612903,2
2010,Microsoft Research,msrsv2,59,1000,967,33,1.01936799184506,2.35714285714286
2010,Microsoft Research,msrsv2,60,1000,990,10,1.00502512562814,2
2010,Microsoft Research,msrsv2,61,1000,990,10,1.00502512562814,2
2010,Microsoft Research,msrsv2,62,1000,994,6,1.00300902708124,2
2010,Microsoft Research,msrsv2,63,1000,994,6,1.00300902708124,2
2010,Microsoft Research,msrsv2,64,1000,990,10,1.00502512562814,2
2010,Microsoft Research,msrsv2,65,1000,998,2,1.001001001001,2
2010,Microsoft Research,msrsv2,66,1000,996,4,1.00200400801603,2
2010,Microsoft Research,msrsv2,67,1000,941,59,1.03734439834025,2.56521739130435
2010,Microsoft Research,msrsv2,68,1000,979,21,1.01112234580384,2.1
2010,Microsoft Research,msrsv2,69,1000,990,10,1.00502512562814,2
2010,Microsoft Research,msrsv2,70,1000,992,8,1.00401606425703,2
2010,Microsoft Research,msrsv2,71,1000,998,2,1.001001001001,2
2010,Microsoft Research,msrsv2,72,1000,998,2,1.001001001001,2
2010,Microsoft Research,msrsv2,73,1000,991,9,1.00502512562814,2.25
2010,Microsoft Research,msrsv2,74,1000,995,5,1.00300902708124,2.5
2010,Microsoft Research,msrsv2,75,1000,975,25,1.01317122593718,2.08333333333333
2010,Microsoft Research,msrsv2,76,1000,986,14,1.00704934541793,2
2010,Microsoft Research,msrsv2,77,1000,994,6,1.00300902708124,2
2010,Microsoft Research,msrsv2,78,1000,1000,0,1,
2010,Microsoft Research,msrsv2,79,1000,992,8,1.00401606425703,2
2010,Microsoft Research,msrsv2,80,1000,1000,0,1,
2010,Microsoft Research,msrsv2,81,1000,994,6,1.00300902708124,2
2010,Microsoft Research,msrsv2,82,1000,996,4,1.00200400801603,2
2010,Microsoft Research,msrsv2,83,1000,992,8,1.00401606425703,2
2010,Microsoft Research,msrsv2,84,1000,856,144,1.12866817155756,4.8
2010,Microsoft Research,msrsv2,85,1000,990,10,1.00502512562814,2
2010,Microsoft Research,msrsv2,86,1000,973,27,1.01522842639594,2.25
2010,Microsoft Research,msrsv2,87,1000,998,2,1.001001001001,2
2010,Microsoft Research,msrsv2,88,1000,973,27,1.01626016260163,2.45454545454545
2010,Microsoft Research,msrsv2,89,1000,986,14,1.00704934541793,2
2010,Microsoft Research,msrsv2,90,1000,986,14,1.00704934541793,2
2010,Microsoft Research,msrsv2,91,1000,989,11,1.00603621730382,2.2
2010,Microsoft Research,msrsv2,92,1000,994,6,1.00300902708124,2
2010,Microsoft Research,msrsv2,93,1000,986,14,1.00704934541793,2
2010,Microsoft Research,msrsv2,94,1000,998,2,1.001001001001,2
2010,Microsoft Research,msrsv2,95,1000,994,6,1.00300902708124,2
2010,Microsoft Research,msrsv2,96,1000,986,14,1.00704934541793,2
2010,Microsoft Research,msrsv2,97,1000,1000,0,1,
2010,Microsoft Research,msrsv2,98,1000,996,4,1.00200400801603,2
2010,Microsoft Research,msrsv2,99,1000,998,2,1.001001001001,2
2010,Microsoft Research,msrsv2,100,1000,986,14,1.00908173562059,2.8
2010,Microsoft Research,msrsv3,51,1000,994,6,1.00300902708124,2
2010,Microsoft Research,msrsv3,52,1000,979,21,1.01214574898785,2.33333333333333
2010,Microsoft Research,msrsv3,53,1000,877,123,1.09289617486339,3.23684210526316
2010,Microsoft Research,msrsv3,54,1000,960,40,1.02249488752556,2.22222222222222
2010,Microsoft Research,msrsv3,55,1000,986,14,1.00704934541793,2
2010,Microsoft Research,msrsv3,56,1000,939,61,1.0351966873706,2.25925925925926
2010,Microsoft Research,msrsv3,57,1000,992,8,1.00401606425703,2
2010,Microsoft Research,msrsv3,58,1000,984,16,1.00806451612903,2
2010,Microsoft Research,msrsv3,59,1000,955,45,1.02564102564103,2.25
2010,Microsoft Research,msrsv3,60,1000,990,10,1.00502512562814,2
2010,Microsoft Research,msrsv3,61,1000,990,10,1.00502512562814,2
2010,Microsoft Research,msrsv3,62,1000,994,6,1.00300902708124,2
2010,Microsoft Research,msrsv3,63,1000,994,6,1.00300902708124,2
2010,Microsoft Research,msrsv3,64,1000,990,10,1.00502512562814,2
2010,Microsoft Research,msrsv3,65,1000,998,2,1.001001001001,2
2010,Microsoft Research,msrsv3,66,1000,990,10,1.00502512562814,2
2010,Microsoft Research,msrsv3,67,1000,941,59,1.03734439834025,2.56521739130435
2010,Microsoft Research,msrsv3,68,1000,979,21,1.01112234580384,2.1
2010,Microsoft Research,msrsv3,69,1000,990,10,1.00502512562814,2
2010,Microsoft Research,msrsv3,70,1000,998,2,1.001001001001,2
2010,Microsoft Research,msrsv3,71,1000,994,6,1.00300902708124,2
2010,Microsoft Research,msrsv3,72,1000,998,2,1.001001001001,2
2010,Microsoft Research,msrsv3,73,1000,993,7,1.00401606425703,2.33333333333333
2010,Microsoft Research,msrsv3,74,1000,996,4,1.00200400801603,2
2010,Microsoft Research,msrsv3,75,1000,977,23,1.01214574898785,2.09090909090909
2010,Microsoft Research,msrsv3,76,1000,986,14,1.00704934541793,2
2010,Microsoft Research,msrsv3,77,1000,994,6,1.00300902708124,2
2010,Microsoft Research,msrsv3,78,1000,1000,0,1,
2010,Microsoft Research,msrsv3,79,1000,992,8,1.00401606425703,2
2010,Microsoft Research,msrsv3,80,1000,1000,0,1,
2010,Microsoft Research,msrsv3,81,1000,994,6,1.00300902708124,2
2010,Microsoft Research,msrsv3,82,1000,998,2,1.001001001001,2
2010,Microsoft Research,msrsv3,83,1000,992,8,1.00401606425703,2
2010,Microsoft Research,msrsv3,84,1000,867,133,1.11482720178372,4.43333333333333
2010,Microsoft Research,msrsv3,85,1000,990,10,1.00502512562814,2
2010,Microsoft Research,msrsv3,86,1000,973,27,1.01522842639594,2.25
2010,Microsoft Research,msrsv3,87,1000,990,10,1.00502512562814,2
2010,Microsoft Research,msrsv3,88,1000,973,27,1.01626016260163,2.45454545454545
2010,Microsoft Research,msrsv3,89,1000,986,14,1.00704934541793,2
2010,Microsoft Research,msrsv3,90,1000,986,14,1.00704934541793,2
2010,Microsoft Research,msrsv3,91,1000,992,8,1.00401606425703,2
2010,Microsoft Research,msrsv3,92,1000,994,6,1.00300902708124,2
2010,Microsoft Research,msrsv3,93,1000,986,14,1.00704934541793,2
2010,Microsoft Research,msrsv3,94,1000,998,2,1.001001001001,2
2010,Microsoft Research,msrsv3,95,1000,992,8,1.00401606425703,2
2010,Microsoft Research,msrsv3,96,1000,986,14,1.00704934541793,2
2010,Microsoft Research,msrsv3,97,1000,1000,0,1,
2010,Microsoft Research,msrsv3,98,1000,996,4,1.00200400801603,2
2010,Microsoft Research,msrsv3,99,1000,1000,0,1,
2010,Microsoft Research,msrsv3,100,1000,986,14,1.00908173562059,2.8
2010,Peking University,pkusewm1,51,1000,787,213,1.14155251141553,2.39325842696629
2010,Peking University,pkusewm1,52,1000,694,306,1.21802679658953,2.40944881889764
2010,Peking University,pkusewm1,53,1000,489,511,1.64744645799012,4.33050847457627
2010,Peking University,pkusewm1,54,1000,592,408,1.32978723404255,2.55
2010,Peking University,pkusewm1,55,1000,570,430,1.44927536231884,3.58333333333333
2010,Peking University,pkusewm1,56,1000,764,236,1.15074798619102,2.24761904761905
2010,Peking University,pkusewm1,57,1000,826,174,1.11982082866741,2.59701492537313
2010,Peking University,pkusewm1,58,1000,691,309,1.21359223300971,2.32330827067669
2010,Peking University,pkusewm1,59,1000,861,139,1.08342361863489,2.24193548387097
2010,Peking University,pkusewm1,60,1000,671,329,1.23152709359606,2.33333333333333
2010,Peking University,pkusewm1,61,1000,578,422,1.36612021857924,2.74025974025974
2010,Peking University,pkusewm1,62,1000,770,230,1.16414435389988,2.58426966292135
2010,Peking University,pkusewm1,63,1000,701,299,1.22100122100122,2.53389830508475
2010,Peking University,pkusewm1,64,1000,659,341,1.26262626262626,2.56390977443609
2010,Peking University,pkusewm1,65,1000,668,332,1.26903553299492,2.76666666666667
2010,Peking University,pkusewm1,66,1000,794,206,1.1454753722795,2.60759493670886
2010,Peking University,pkusewm1,67,1000,719,281,1.23152709359606,3.02150537634409
2010,Peking University,pkusewm1,68,1000,744,256,1.16822429906542,2.28571428571429
2010,Peking University,pkusewm1,69,1000,767,233,1.19331742243437,3.28169014084507
2010,Peking University,pkusewm1,70,1000,669,331,1.23609394313968,2.36428571428571
2010,Peking University,pkusewm1,71,1000,761,239,1.22249388753056,4.19298245614035
2010,Peking University,pkusewm1,72,1000,604,396,1.3351134846462,2.73103448275862
2010,Peking University,pkusewm1,73,1000,769,231,1.16009280742459,2.48387096774194
2010,Peking University,pkusewm1,74,1000,708,292,1.19617224880383,2.28125
2010,Peking University,pkusewm1,75,1000,595,405,1.33333333333333,2.61290322580645
2010,Peking University,pkusewm1,76,1000,839,161,1.11482720178372,2.77586206896552
2010,Peking University,pkusewm1,77,1000,660,340,1.26582278481013,2.61538461538462
2010,Peking University,pkusewm1,78,1000,530,470,1.3869625520111,2.46073298429319
2010,Peking University,pkusewm1,79,1000,716,284,1.19189511323004,2.30894308943089
2010,Peking University,pkusewm1,80,1000,882,118,1.07642626480086,2.51063829787234
2010,Peking University,pkusewm1,81,1000,585,415,1.36612021857924,2.82312925170068
2010,Peking University,pkusewm1,82,1000,738,262,1.18623962040332,2.4952380952381
2010,Peking University,pkusewm1,83,1000,12,988,25.6410256410256,36.5925925925926
2010,Peking University,pkusewm1,84,1000,729,271,1.19904076738609,2.58095238095238
2010,Peking University,pkusewm1,85,1000,715,285,1.20918984280532,2.54464285714286
2010,Peking University,pkusewm1,86,1000,799,201,1.13122171945701,2.36470588235294
2010,Peking University,pkusewm1,87,1000,828,172,1.11111111111111,2.38888888888889
2010,Peking University,pkusewm1,88,1000,816,184,1.12233445566779,2.45333333333333
2010,Peking University,pkusewm1,89,1000,747,253,1.16144018583043,2.21929824561404
2010,Peking University,pkusewm1,90,1000,661,339,1.2453300124533,2.38732394366197
2010,Peking University,pkusewm1,91,1000,845,155,1.11234705228031,2.87037037037037
2010,Peking University,pkusewm1,92,1000,827,173,1.10619469026549,2.24675324675325
2010,Peking University,pkusewm1,93,1000,674,326,1.23304562268804,2.37956204379562
2010,Peking University,pkusewm1,94,1000,712,288,1.19760479041916,2.34146341463415
2010,Peking University,pkusewm1,95,1000,844,156,1.11358574610245,2.88888888888889
2010,Peking University,pkusewm1,96,1000,543,457,1.36798905608755,2.43085106382979
2010,Peking University,pkusewm1,97,1000,624,376,1.30718954248366,2.66666666666667
2010,Peking University,pkusewm1,98,1000,293,707,1.91938579654511,3.10087719298246
2010,Peking University,pkusewm1,99,1000,613,387,1.31752305665349,2.65068493150685
2010,Peking University,pkusewm1,100,1000,786,214,1.15340253748558,2.64197530864198
2010,"Computer and Automation Research Institute, Hungarian Academy of Scien",sztaki1,51,1000,992,8,1.00401606425703,2
2010,"Computer and Automation Research Institute, Hungarian Academy of Scien",sztaki1,52,1000,990,10,1.00502512562814,2
2010,"Computer and Automation Research Institute, Hungarian Academy of Scien",sztaki1,53,1000,757,243,1.16822429906542,2.45454545454545
2010,"Computer and Automation Research Institute, Hungarian Academy of Scien",sztaki1,54,1000,682,318,1.25944584382872,2.83928571428571
2010,"Computer and Automation Research Institute, Hungarian Academy of Scien",sztaki1,55,1000,736,264,1.21359223300971,3
2010,"Computer and Automation Research Institute, Hungarian Academy of Scien",sztaki1,56,1000,993,7,1.00401606425703,2.33333333333333
2010,"Computer and Automation Research Institute, Hungarian Academy of Scien",sztaki1,57,1000,724,276,1.18203309692671,2.26229508196721
2010,"Computer and Automation Research Institute, Hungarian Academy of Scien",sztaki1,58,1000,706,294,1.20918984280532,2.4297520661157
2010,"Computer and Automation Research Institute, Hungarian Academy of Scien",sztaki1,59,1000,772,228,1.14678899082569,2.28
2010,"Computer and Automation Research Institute, Hungarian Academy of Scien",sztaki1,60,1000,990,10,1.00502512562814,2
2010,"Computer and Automation Research Institute, Hungarian Academy of Scien",sztaki1,61,1000,750,250,1.17924528301887,2.55102040816327
2010,"Computer and Automation Research Institute, Hungarian Academy of Scien",sztaki1,62,1000,779,221,1.15074798619102,2.45555555555556
2010,"Computer and Automation Research Institute, Hungarian Academy of Scien",sztaki1,63,1000,749,251,1.18063754427391,2.56122448979592
2010,"Computer and Automation Research Institute, Hungarian Academy of Scien",sztaki1,64,1000,982,18,1.00908173562059,2
2010,"Computer and Automation Research Institute, Hungarian Academy of Scien",sztaki1,65,1000,739,261,1.17924528301887,2.39449541284404
2010,"Computer and Automation Research Institute, Hungarian Academy of Scien",sztaki1,66,1000,736,264,1.18623962040332,2.46728971962617
2010,"Computer and Automation Research Institute, Hungarian Academy of Scien",sztaki1,67,1000,992,8,1.00401606425703,2
2010,"Computer and Automation Research Institute, Hungarian Academy of Scien",sztaki1,68,1000,780,220,1.13378684807256,2.15686274509804
2010,"Computer and Automation Research Institute, Hungarian Academy of Scien",sztaki1,69,1000,792,208,1.13122171945701,2.26086956521739
2010,"Computer and Automation Research Institute, Hungarian Academy of Scien",sztaki1,70,1000,678,322,1.26742712294043,2.9009009009009
2010,"Computer and Automation Research Institute, Hungarian Academy of Scien",sztaki1,71,1000,688,312,1.24843945068664,2.76106194690265
2010,"Computer and Automation Research Institute, Hungarian Academy of Scien",sztaki1,72,1000,704,296,1.23609394313968,2.81904761904762
2010,"Computer and Automation Research Institute, Hungarian Academy of Scien",sztaki1,73,1000,763,237,1.15874855156431,2.37
2010,"Computer and Automation Research Institute, Hungarian Academy of Scien",sztaki1,74,1000,990,10,1.00502512562814,2
2010,"Computer and Automation Research Institute, Hungarian Academy of Scien",sztaki1,75,1000,778,222,1.14810562571757,2.38709677419355
2010,"Computer and Automation Research Institute, Hungarian Academy of Scien",sztaki1,76,1000,686,314,1.24223602484472,2.63865546218487
2010,"Computer and Automation Research Institute, Hungarian Academy of Scien",sztaki1,77,1000,964,36,1.02354145342886,2.76923076923077
2010,"Computer and Automation Research Institute, Hungarian Academy of Scien",sztaki1,78,1000,741,259,1.17508813160987,2.35454545454545
2010,"Computer and Automation Research Institute, Hungarian Academy of Scien",sztaki1,79,1000,770,230,1.15740740740741,2.4468085106383
2010,"Computer and Automation Research Institute, Hungarian Academy of Scien",sztaki1,80,1000,778,222,1.15074798619102,2.43956043956044
2010,"Computer and Automation Research Institute, Hungarian Academy of Scien",sztaki1,81,1000,708,292,1.21802679658953,2.58407079646018
2010,"Computer and Automation Research Institute, Hungarian Academy of Scien",sztaki1,82,1000,643,357,1.2987012987013,2.81102362204724
2010,"Computer and Automation Research Institute, Hungarian Academy of Scien",sztaki1,83,1000,761,239,1.18764845605701,2.95061728395062
2010,"Computer and Automation Research Institute, Hungarian Academy of Scien",sztaki1,84,1000,778,222,1.14678899082569,2.36170212765957
2010,"Computer and Automation Research Institute, Hungarian Academy of Scien",sztaki1,85,1000,998,2,1.001001001001,2
2010,"Computer and Automation Research Institute, Hungarian Academy of Scien",sztaki1,86,1000,990,10,1.00502512562814,2
2010,"Computer and Automation Research Institute, Hungarian Academy of Scien",sztaki1,87,1000,698,302,1.23304562268804,2.67256637168142
2010,"Computer and Automation Research Institute, Hungarian Academy of Scien",sztaki1,88,1000,971,29,1.01522842639594,2.07142857142857
2010,"Computer and Automation Research Institute, Hungarian Academy of Scien",sztaki1,89,1000,978,22,1.01112234580384,2
2010,"Computer and Automation Research Institute, Hungarian Academy of Scien",sztaki1,90,1000,990,10,1.00502512562814,2
2010,"Computer and Automation Research Institute, Hungarian Academy of Scien",sztaki1,91,1000,729,271,1.21065375302663,2.79381443298969
2010,"Computer and Automation Research Institute, Hungarian Academy of Scien",sztaki1,92,1000,658,342,1.30039011703511,3.08108108108108
2010,"Computer and Automation Research Institute, Hungarian Academy of Scien",sztaki1,93,1000,990,10,1.00502512562814,2
2010,"Computer and Automation Research Institute, Hungarian Academy of Scien",sztaki1,94,1000,790,210,1.13507377979569,2.30769230769231
2010,"Computer and Automation Research Institute, Hungarian Academy of Scien",sztaki1,95,1000,710,290,1.21359223300971,2.54385964912281
2010,"Computer and Automation Research Institute, Hungarian Academy of Scien",sztaki1,96,1000,723,277,1.20336943441637,2.56481481481482
2010,"Computer and Automation Research Institute, Hungarian Academy of Scien",sztaki1,97,1000,651,349,1.30890052356021,3.08849557522124
2010,"Computer and Automation Research Institute, Hungarian Academy of Scien",sztaki1,98,1000,726,274,1.20048019207683,2.5607476635514
2010,"Computer and Automation Research Institute, Hungarian Academy of Scien",sztaki1,99,1000,691,309,1.23304562268804,2.575
2010,"Computer and Automation Research Institute, Hungarian Academy of Scien",sztaki1,100,1000,1000,0,1,
2010,University of Delaware,udelIndriB,51,1000,923,77,1.04384133611691,2.2
2010,University of Delaware,udelIndriB,52,1000,904,96,1.05820105820106,2.34146341463415
2010,University of Delaware,udelIndriB,53,1000,872,128,1.0752688172043,2.20689655172414
2010,University of Delaware,udelIndriB,54,1000,771,229,1.15606936416185,2.43617021276596
2010,University of Delaware,udelIndriB,55,1000,821,179,1.12866817155756,2.75384615384615
2010,University of Delaware,udelIndriB,56,1000,775,225,1.19047619047619,3.46153846153846
2010,University of Delaware,udelIndriB,57,1000,879,121,1.07642626480086,2.42
2010,University of Delaware,udelIndriB,58,1000,828,172,1.11482720178372,2.49275362318841
2010,University of Delaware,udelIndriB,59,1000,894,106,1.06382978723404,2.30434782608696
2010,University of Delaware,udelIndriB,60,1000,909,91,1.05263157894737,2.21951219512195
2010,University of Delaware,udelIndriB,61,1000,801,199,1.14025085518814,2.61842105263158
2010,University of Delaware,udelIndriB,62,1000,904,96,1.06044538706257,2.46153846153846
2010,University of Delaware,udelIndriB,63,1000,854,146,1.08813928182807,2.24615384615385
2010,University of Delaware,udelIndriB,64,1000,723,277,1.2453300124533,3.4625
2010,University of Delaware,udelIndriB,65,1000,907,93,1.05485232067511,2.26829268292683
2010,University of Delaware,udelIndriB,66,1000,943,57,1.03626943005181,2.59090909090909
2010,University of Delaware,udelIndriB,67,1000,818,182,1.14025085518814,3.08474576271186
2010,University of Delaware,udelIndriB,68,1000,914,86,1.04712041884817,2.09756097560976
2010,University of Delaware,udelIndriB,69,1000,825,175,1.15473441108545,4.26829268292683
2010,University of Delaware,udelIndriB,70,1000,918,82,1.0515247108307,2.48484848484849
2010,University of Delaware,udelIndriB,71,1000,937,63,1.03626943005181,2.25
2010,University of Delaware,udelIndriB,72,1000,853,147,1.1001100110011,2.625
2010,University of Delaware,udelIndriB,73,1000,912,88,1.05596620908131,2.51428571428571
2010,University of Delaware,udelIndriB,74,1000,914,86,1.0482180293501,2.15
2010,University of Delaware,udelIndriB,75,1000,761,239,1.15606936416185,2.29807692307692
2010,University of Delaware,udelIndriB,76,1000,958,42,1.02145045965271,2
2010,University of Delaware,udelIndriB,77,1000,917,83,1.04931794333683,2.30555555555556
2010,University of Delaware,udelIndriB,78,1000,956,44,1.02354145342886,2.0952380952381
2010,University of Delaware,udelIndriB,79,1000,846,154,1.10497237569061,2.61016949152542
2010,University of Delaware,udelIndriB,80,1000,972,28,1.01522842639594,2.15384615384615
2010,University of Delaware,udelIndriB,81,1000,816,184,1.14285714285714,3.11864406779661
2010,University of Delaware,udelIndriB,82,1000,830,170,1.11607142857143,2.57575757575758
2010,University of Delaware,udelIndriB,83,1000,611,389,1.30208333333333,2.47770700636943
2010,University of Delaware,udelIndriB,84,1000,857,143,1.09409190371991,2.50877192982456
2010,University of Delaware,udelIndriB,85,1000,899,101,1.05485232067511,2.06122448979592
2010,University of Delaware,udelIndriB,86,1000,912,88,1.05374077976818,2.37837837837838
2010,University of Delaware,udelIndriB,87,1000,891,109,1.06496272630458,2.27083333333333
2010,University of Delaware,udelIndriB,88,1000,928,72,1.04602510460251,2.57142857142857
2010,University of Delaware,udelIndriB,89,1000,925,75,1.04384133611691,2.27272727272727
2010,University of Delaware,udelIndriB,90,1000,875,125,1.07411385606874,2.23214285714286
2010,University of Delaware,udelIndriB,91,1000,901,99,1.06951871657754,2.91176470588235
2010,University of Delaware,udelIndriB,92,1000,887,113,1.06609808102345,2.2156862745098
2010,University of Delaware,udelIndriB,93,1000,920,80,1.04384133611691,2.10526315789474
2010,University of Delaware,udelIndriB,94,1000,889,111,1.06837606837607,2.36170212765957
2010,University of Delaware,udelIndriB,95,1000,937,63,1.03305785123967,2.03225806451613
2010,University of Delaware,udelIndriB,96,1000,894,106,1.06723585912487,2.46511627906977
2010,University of Delaware,udelIndriB,97,1000,942,58,1.03626943005181,2.52173913043478
2010,University of Delaware,udelIndriB,98,1000,872,128,1.08695652173913,2.66666666666667
2010,University of Delaware,udelIndriB,99,1000,877,123,1.09409190371991,3.32432432432432
2010,University of Delaware,udelIndriB,100,1000,968,32,1.01626016260163,2
2010,University of Delaware,udelIndriB2,51,1000,924,76,1.04384133611691,2.23529411764706
2010,University of Delaware,udelIndriB2,52,1000,904,96,1.05820105820106,2.34146341463415
2010,University of Delaware,udelIndriB2,53,1000,874,126,1.07296137339056,2.17241379310345
2010,University of Delaware,udelIndriB2,54,1000,824,176,1.11482720178372,2.41095890410959
2010,University of Delaware,udelIndriB2,55,1000,852,148,1.10741971207087,2.90196078431373
2010,University of Delaware,udelIndriB2,56,1000,766,234,1.20048019207683,3.49253731343284
2010,University of Delaware,udelIndriB2,57,1000,875,125,1.07874865156419,2.40384615384615
2010,University of Delaware,udelIndriB2,58,1000,843,157,1.10497237569061,2.53225806451613
2010,University of Delaware,udelIndriB2,59,1000,881,119,1.07066381156317,2.24528301886792
2010,University of Delaware,udelIndriB2,60,1000,913,87,1.0515247108307,2.28947368421053
2010,University of Delaware,udelIndriB2,61,1000,809,191,1.13507377979569,2.65277777777778
2010,University of Delaware,udelIndriB2,62,1000,902,98,1.06157112526539,2.45
2010,University of Delaware,udelIndriB2,63,1000,854,146,1.08695652173913,2.21212121212121
2010,University of Delaware,udelIndriB2,64,1000,738,262,1.22699386503067,3.4025974025974
2010,University of Delaware,udelIndriB2,65,1000,900,100,1.05932203389831,2.27272727272727
2010,University of Delaware,udelIndriB2,66,1000,955,45,1.02986611740474,2.8125
2010,University of Delaware,udelIndriB2,67,1000,818,182,1.14025085518814,3.08474576271186
2010,University of Delaware,udelIndriB2,68,1000,913,87,1.04712041884817,2.07142857142857
2010,University of Delaware,udelIndriB2,69,1000,826,174,1.14810562571757,3.86666666666667
2010,University of Delaware,udelIndriB2,70,1000,941,59,1.03734439834025,2.56521739130435
2010,University of Delaware,udelIndriB2,71,1000,927,73,1.04166666666667,2.21212121212121
2010,University of Delaware,udelIndriB2,72,1000,890,110,1.06496272630458,2.24489795918367
2010,University of Delaware,udelIndriB2,73,1000,910,90,1.05708245243129,2.5
2010,University of Delaware,udelIndriB2,74,1000,912,88,1.04931794333683,2.14634146341463
2010,University of Delaware,udelIndriB2,75,1000,757,243,1.16009280742459,2.31428571428571
2010,University of Delaware,udelIndriB2,76,1000,949,51,1.02669404517454,2.04
2010,University of Delaware,udelIndriB2,77,1000,918,82,1.04931794333683,2.34285714285714
2010,University of Delaware,udelIndriB2,78,1000,967,33,1.0183299389002,2.2
2010,University of Delaware,udelIndriB2,79,1000,860,140,1.09409190371991,2.59259259259259
2010,University of Delaware,udelIndriB2,80,1000,982,18,1.00908173562059,2
2010,University of Delaware,udelIndriB2,81,1000,857,143,1.10987791342952,3.25
2010,University of Delaware,udelIndriB2,82,1000,848,152,1.1037527593819,2.62068965517241
2010,University of Delaware,udelIndriB2,83,1000,634,366,1.27551020408163,2.44
2010,University of Delaware,udelIndriB2,84,1000,857,143,1.09409190371991,2.50877192982456
2010,University of Delaware,udelIndriB2,85,1000,901,99,1.05374077976818,2.0625
2010,University of Delaware,udelIndriB2,86,1000,901,99,1.06044538706257,2.35714285714286
2010,University of Delaware,udelIndriB2,87,1000,884,116,1.06951871657754,2.27450980392157
2010,University of Delaware,udelIndriB2,88,1000,922,78,1.0482180293501,2.4375
2010,University of Delaware,udelIndriB2,89,1000,927,73,1.04275286757039,2.28125
2010,University of Delaware,udelIndriB2,90,1000,867,133,1.07874865156419,2.21666666666667
2010,University of Delaware,udelIndriB2,91,1000,886,114,1.07758620689655,2.71428571428571
2010,University of Delaware,udelIndriB2,92,1000,925,75,1.04384133611691,2.27272727272727
2010,University of Delaware,udelIndriB2,93,1000,922,78,1.04275286757039,2.10810810810811
2010,University of Delaware,udelIndriB2,94,1000,895,105,1.06269925611052,2.28260869565217
2010,University of Delaware,udelIndriB2,95,1000,951,49,1.02564102564103,2.04166666666667
2010,University of Delaware,udelIndriB2,96,1000,897,103,1.06496272630458,2.45238095238095
2010,University of Delaware,udelIndriB2,97,1000,958,42,1.02249488752556,2.1
2010,University of Delaware,udelIndriB2,98,1000,877,123,1.08342361863489,2.67391304347826
2010,University of Delaware,udelIndriB2,99,1000,887,113,1.085776330076,3.32352941176471
2010,University of Delaware,udelIndriB2,100,1000,978,22,1.01112234580384,2
2010,University of Delaware,udelIndriWP,51,1000,572,428,1.38888888888889,2.89189189189189
2010,University of Delaware,udelIndriWP,52,1000,614,386,1.32450331125828,2.73758865248227
2010,University of Delaware,udelIndriWP,53,1000,701,299,1.19904076738609,2.24812030075188
2010,University of Delaware,udelIndriWP,54,1000,658,342,1.25470514429109,2.46043165467626
2010,University of Delaware,udelIndriWP,55,1000,661,339,1.24378109452736,2.37062937062937
2010,University of Delaware,udelIndriWP,56,1000,767,233,1.15207373271889,2.30693069306931
2010,University of Delaware,udelIndriWP,57,1000,656,344,1.25628140703518,2.45714285714286
2010,University of Delaware,udelIndriWP,58,1000,692,308,1.230012300123,2.54545454545455
2010,University of Delaware,udelIndriWP,59,1000,676,324,1.24069478908189,2.49230769230769
2010,University of Delaware,udelIndriWP,60,1000,508,492,1.62337662337662,4.55555555555556
2010,University of Delaware,udelIndriWP,61,1000,605,395,1.32978723404255,2.68707482993197
2010,University of Delaware,udelIndriWP,62,1000,674,326,1.2531328320802,2.62903225806452
2010,University of Delaware,udelIndriWP,63,1000,494,506,1.51515151515152,3.04819277108434
2010,University of Delaware,udelIndriWP,64,1000,550,450,1.45137880986938,3.23741007194245
2010,University of Delaware,udelIndriWP,65,1000,581,419,1.35869565217391,2.70322580645161
2010,University of Delaware,udelIndriWP,66,1000,612,388,1.31926121372032,2.65753424657534
2010,University of Delaware,udelIndriWP,67,1000,509,491,1.4903129657228,3.03086419753086
2010,University of Delaware,udelIndriWP,68,1000,433,567,1.64203612479475,3.22159090909091
2010,University of Delaware,udelIndriWP,69,1000,646,354,1.30039011703511,2.87804878048781
2010,University of Delaware,udelIndriWP,70,1000,699,301,1.22249388753056,2.52941176470588
2010,University of Delaware,udelIndriWP,71,1000,708,292,1.19617224880383,2.28125
2010,University of Delaware,udelIndriWP,72,1000,673,327,1.25470514429109,2.63709677419355
2010,University of Delaware,udelIndriWP,73,1000,743,257,1.18063754427391,2.47115384615385
2010,University of Delaware,udelIndriWP,74,1000,652,348,1.25156445556946,2.36734693877551
2010,University of Delaware,udelIndriWP,75,1000,676,324,1.23609394313968,2.43609022556391
2010,University of Delaware,udelIndriWP,76,1000,714,286,1.20336943441637,2.44444444444444
2010,University of Delaware,udelIndriWP,77,1000,656,344,1.26103404791929,2.51094890510949
2010,University of Delaware,udelIndriWP,78,1000,548,452,1.40646976090014,2.77300613496933
2010,University of Delaware,udelIndriWP,79,1000,748,252,1.17233294255569,2.4
2010,University of Delaware,udelIndriWP,80,1000,653,347,1.29032258064516,2.84426229508197
2010,University of Delaware,udelIndriWP,81,1000,575,425,1.39470013947001,2.99295774647887
2010,University of Delaware,udelIndriWP,82,1000,626,374,1.29032258064516,2.51006711409396
2010,University of Delaware,udelIndriWP,83,1000,649,351,1.26582278481013,2.48936170212766
2010,University of Delaware,udelIndriWP,84,1000,567,433,1.40449438202247,2.98620689655172
2010,University of Delaware,udelIndriWP,85,1000,642,358,1.26262626262626,2.38666666666667
2010,University of Delaware,udelIndriWP,86,1000,637,363,1.26582278481013,2.37254901960784
2010,University of Delaware,udelIndriWP,87,1000,576,424,1.37362637362637,2.78947368421053
2010,University of Delaware,udelIndriWP,88,1000,592,408,1.35869565217391,2.83333333333333
2010,University of Delaware,udelIndriWP,89,1000,459,541,1.51975683890578,2.71859296482412
2010,University of Delaware,udelIndriWP,90,1000,523,477,1.43266475644699,2.72571428571429
2010,University of Delaware,udelIndriWP,91,1000,750,250,1.16279069767442,2.27272727272727
2010,University of Delaware,udelIndriWP,92,1000,688,312,1.22850122850123,2.47619047619048
2010,University of Delaware,udelIndriWP,93,1000,610,390,1.2970168612192,2.42236024844721
2010,University of Delaware,udelIndriWP,94,1000,678,322,1.25156445556946,2.66115702479339
2010,University of Delaware,udelIndriWP,95,1000,705,295,1.20481927710843,2.36
2010,University of Delaware,udelIndriWP,96,1000,685,315,1.23456790123457,2.52
2010,University of Delaware,udelIndriWP,97,1000,638,362,1.37174211248285,3.97802197802198
2010,University of Delaware,udelIndriWP,98,1000,596,404,1.36239782016349,2.92753623188406
2010,University of Delaware,udelIndriWP,99,1000,618,382,1.33155792276964,2.87218045112782
2010,University of Delaware,udelIndriWP,100,1000,754,246,1.15874855156431,2.25688073394495
2010,"Center of Intelligent Info Retrieval, UMass",umassSDM,51,1000,937,63,1.0351966873706,2.17241379310345
2010,"Center of Intelligent Info Retrieval, UMass",umassSDM,52,1000,933,67,1.0351966873706,2.03030303030303
2010,"Center of Intelligent Info Retrieval, UMass",umassSDM,53,1000,859,141,1.08225108225108,2.16923076923077
2010,"Center of Intelligent Info Retrieval, UMass",umassSDM,54,1000,926,74,1.04493207941484,2.38709677419355
2010,"Center of Intelligent Info Retrieval, UMass",umassSDM,55,1000,442,558,1.83150183150183,5.36538461538462
2010,"Center of Intelligent Info Retrieval, UMass",umassSDM,56,1000,937,63,1.03305785123967,2.03225806451613
2010,"Center of Intelligent Info Retrieval, UMass",umassSDM,57,1000,485,515,1.62337662337662,3.93129770992366
2010,"Center of Intelligent Info Retrieval, UMass",umassSDM,58,1000,833,167,1.0989010989011,2.16883116883117
2010,"Center of Intelligent Info Retrieval, UMass",umassSDM,59,1000,963,37,1.01936799184506,2.05555555555556
2010,"Center of Intelligent Info Retrieval, UMass",umassSDM,60,1000,852,148,1.085776330076,2.14492753623188
2010,"Center of Intelligent Info Retrieval, UMass",umassSDM,61,1000,893,107,1.05820105820106,2.05769230769231
2010,"Center of Intelligent Info Retrieval, UMass",umassSDM,62,1000,950,50,1.02564102564103,2
2010,"Center of Intelligent Info Retrieval, UMass",umassSDM,63,1000,873,127,1.08225108225108,2.49019607843137
2010,"Center of Intelligent Info Retrieval, UMass",umassSDM,64,1000,914,86,1.04493207941484,2
2010,"Center of Intelligent Info Retrieval, UMass",umassSDM,65,1000,898,102,1.05820105820106,2.17021276595745
2010,"Center of Intelligent Info Retrieval, UMass",umassSDM,66,1000,928,72,1.03842159916926,2.05714285714286
2010,"Center of Intelligent Info Retrieval, UMass",umassSDM,67,1000,950,50,1.02880658436214,2.27272727272727
2010,"Center of Intelligent Info Retrieval, UMass",umassSDM,68,1000,890,110,1.05932203389831,2.03703703703704
2010,"Center of Intelligent Info Retrieval, UMass",umassSDM,69,1000,934,66,1.03734439834025,2.2
2010,"Center of Intelligent Info Retrieval, UMass",umassSDM,70,1000,905,95,1.0515247108307,2.06521739130435
2010,"Center of Intelligent Info Retrieval, UMass",umassSDM,71,1000,827,173,1.10253583241455,2.1625
2010,"Center of Intelligent Info Retrieval, UMass",umassSDM,72,1000,952,48,1.02459016393443,2
2010,"Center of Intelligent Info Retrieval, UMass",umassSDM,73,1000,928,72,1.03842159916926,2.05714285714286
2010,"Center of Intelligent Info Retrieval, UMass",umassSDM,74,1000,831,169,1.10253583241455,2.22368421052632
2010,"Center of Intelligent Info Retrieval, UMass",umassSDM,75,1000,872,128,1.07066381156317,2.06451612903226
2010,"Center of Intelligent Info Retrieval, UMass",umassSDM,76,1000,940,60,1.03092783505155,2
2010,"Center of Intelligent Info Retrieval, UMass",umassSDM,77,1000,870,130,1.07296137339056,2.09677419354839
2010,"Center of Intelligent Info Retrieval, UMass",umassSDM,78,1000,893,107,1.05820105820106,2.05769230769231
2010,"Center of Intelligent Info Retrieval, UMass",umassSDM,79,1000,867,133,1.0752688172043,2.11111111111111
2010,"Center of Intelligent Info Retrieval, UMass",umassSDM,80,1000,911,89,1.04931794333683,2.11904761904762
2010,"Center of Intelligent Info Retrieval, UMass",umassSDM,81,1000,864,136,1.0752688172043,2.06060606060606
2010,"Center of Intelligent Info Retrieval, UMass",umassSDM,82,1000,895,105,1.06157112526539,2.23404255319149
2010,"Center of Intelligent Info Retrieval, UMass",umassSDM,83,1000,725,275,1.20192307692308,2.57009345794393
2010,"Center of Intelligent Info Retrieval, UMass",umassSDM,84,1000,893,107,1.06269925611052,2.22916666666667
2010,"Center of Intelligent Info Retrieval, UMass",umassSDM,85,1000,946,54,1.02774922918808,2
2010,"Center of Intelligent Info Retrieval, UMass",umassSDM,86,1000,934,66,1.03412616339193,2
2010,"Center of Intelligent Info Retrieval, UMass",umassSDM,87,1000,879,121,1.06837606837607,2.12280701754386
2010,"Center of Intelligent Info Retrieval, UMass",umassSDM,88,1000,943,57,1.03092783505155,2.11111111111111
2010,"Center of Intelligent Info Retrieval, UMass",umassSDM,89,1000,888,112,1.07066381156317,2.43478260869565
2010,"Center of Intelligent Info Retrieval, UMass",umassSDM,90,1000,856,144,1.08342361863489,2.14925373134328
2010,"Center of Intelligent Info Retrieval, UMass",umassSDM,91,1000,916,84,1.04384133611691,2
2010,"Center of Intelligent Info Retrieval, UMass",umassSDM,92,1000,743,257,1.17096018735363,2.31531531531532
2010,"Center of Intelligent Info Retrieval, UMass",umassSDM,93,1000,889,111,1.06157112526539,2.09433962264151
2010,"Center of Intelligent Info Retrieval, UMass",umassSDM,94,1000,929,71,1.03950103950104,2.15151515151515
2010,"Center of Intelligent Info Retrieval, UMass",umassSDM,95,1000,755,245,1.17924528301887,2.63440860215054
2010,"Center of Intelligent Info Retrieval, UMass",umassSDM,96,1000,905,95,1.05042016806723,2.02127659574468
2010,"Center of Intelligent Info Retrieval, UMass",umassSDM,97,1000,883,117,1.06496272630458,2.08928571428571
2010,"Center of Intelligent Info Retrieval, UMass",umassSDM,98,1000,840,160,1.09529025191676,2.19178082191781
2010,"Center of Intelligent Info Retrieval, UMass",umassSDM,99,1000,867,133,1.07991360691145,2.25423728813559
2010,"Center of Intelligent Info Retrieval, UMass",umassSDM,100,1000,934,66,1.03412616339193,2
2010,"Center of Intelligent Info Retrieval, UMass",umassSDMW,51,1000,937,63,1.0351966873706,2.17241379310345
2010,"Center of Intelligent Info Retrieval, UMass",umassSDMW,52,1000,925,75,1.04058272632674,2.08333333333333
2010,"Center of Intelligent Info Retrieval, UMass",umassSDMW,53,1000,879,121,1.06723585912487,2.08620689655172
2010,"Center of Intelligent Info Retrieval, UMass",umassSDMW,54,1000,779,221,1.12994350282486,2.08490566037736
2010,"Center of Intelligent Info Retrieval, UMass",umassSDMW,55,1000,595,405,1.48588410104012,5.19230769230769
2010,"Center of Intelligent Info Retrieval, UMass",umassSDMW,56,1000,885,115,1.06382978723404,2.09090909090909
2010,"Center of Intelligent Info Retrieval, UMass",umassSDMW,57,1000,485,515,1.62337662337662,3.93129770992366
2010,"Center of Intelligent Info Retrieval, UMass",umassSDMW,58,1000,860,140,1.08108108108108,2.15384615384615
2010,"Center of Intelligent Info Retrieval, UMass",umassSDMW,59,1000,947,53,1.02774922918808,2.03846153846154
2010,"Center of Intelligent Info Retrieval, UMass",umassSDMW,60,1000,864,136,1.07874865156419,2.15873015873016
2010,"Center of Intelligent Info Retrieval, UMass",umassSDMW,61,1000,903,97,1.05263157894737,2.06382978723404
2010,"Center of Intelligent Info Retrieval, UMass",umassSDMW,62,1000,938,62,1.03199174406605,2
2010,"Center of Intelligent Info Retrieval, UMass",umassSDMW,63,1000,821,179,1.13636363636364,3.03389830508475
2010,"Center of Intelligent Info Retrieval, UMass",umassSDMW,64,1000,902,98,1.05374077976818,2.08510638297872
2010,"Center of Intelligent Info Retrieval, UMass",umassSDMW,65,1000,889,111,1.06157112526539,2.09433962264151
2010,"Center of Intelligent Info Retrieval, UMass",umassSDMW,66,1000,892,108,1.05932203389831,2.07692307692308
2010,"Center of Intelligent Info Retrieval, UMass",umassSDMW,67,1000,936,64,1.03734439834025,2.28571428571429
2010,"Center of Intelligent Info Retrieval, UMass",umassSDMW,68,1000,888,112,1.06044538706257,2.03636363636364
2010,"Center of Intelligent Info Retrieval, UMass",umassSDMW,69,1000,936,64,1.03626943005181,2.20689655172414
2010,"Center of Intelligent Info Retrieval, UMass",umassSDMW,70,1000,883,117,1.06723585912487,2.16666666666667
2010,"Center of Intelligent Info Retrieval, UMass",umassSDMW,71,1000,859,141,1.08225108225108,2.16923076923077
2010,"Center of Intelligent Info Retrieval, UMass",umassSDMW,72,1000,933,67,1.0351966873706,2.03030303030303
2010,"Center of Intelligent Info Retrieval, UMass",umassSDMW,73,1000,919,81,1.04275286757039,2.025
2010,"Center of Intelligent Info Retrieval, UMass",umassSDMW,74,1000,840,160,1.09769484083425,2.25352112676056
2010,"Center of Intelligent Info Retrieval, UMass",umassSDMW,75,1000,892,108,1.05820105820106,2.0377358490566
2010,"Center of Intelligent Info Retrieval, UMass",umassSDMW,76,1000,930,70,1.03734439834025,2.05882352941176
2010,"Center of Intelligent Info Retrieval, UMass",umassSDMW,77,1000,880,120,1.06723585912487,2.10526315789474
2010,"Center of Intelligent Info Retrieval, UMass",umassSDMW,78,1000,882,118,1.06496272630458,2.07017543859649
2010,"Center of Intelligent Info Retrieval, UMass",umassSDMW,79,1000,865,135,1.07411385606874,2.04545454545455
2010,"Center of Intelligent Info Retrieval, UMass",umassSDMW,80,1000,912,88,1.0482180293501,2.0952380952381
2010,"Center of Intelligent Info Retrieval, UMass",umassSDMW,81,1000,829,171,1.10253583241455,2.19230769230769
2010,"Center of Intelligent Info Retrieval, UMass",umassSDMW,82,1000,875,125,1.07066381156317,2.11864406779661
2010,"Center of Intelligent Info Retrieval, UMass",umassSDMW,83,1000,803,197,1.11607142857143,2.11827956989247
2010,"Center of Intelligent Info Retrieval, UMass",umassSDMW,84,1000,878,122,1.07066381156317,2.17857142857143
2010,"Center of Intelligent Info Retrieval, UMass",umassSDMW,85,1000,938,62,1.03305785123967,2.06666666666667
2010,"Center of Intelligent Info Retrieval, UMass",umassSDMW,86,1000,926,74,1.03950103950104,2.05555555555556
2010,"Center of Intelligent Info Retrieval, UMass",umassSDMW,87,1000,796,204,1.12107623318386,2.125
2010,"Center of Intelligent Info Retrieval, UMass",umassSDMW,88,1000,934,66,1.03626943005181,2.12903225806452
2010,"Center of Intelligent Info Retrieval, UMass",umassSDMW,89,1000,892,108,1.06837606837607,2.45454545454545
2010,"Center of Intelligent Info Retrieval, UMass",umassSDMW,90,1000,866,134,1.07758620689655,2.16129032258065
2010,"Center of Intelligent Info Retrieval, UMass",umassSDMW,91,1000,852,148,1.08225108225108,2.05555555555556
2010,"Center of Intelligent Info Retrieval, UMass",umassSDMW,92,1000,881,119,1.06496272630458,2.05172413793103
2010,"Center of Intelligent Info Retrieval, UMass",umassSDMW,93,1000,900,100,1.05596620908131,2.12765957446809
2010,"Center of Intelligent Info Retrieval, UMass",umassSDMW,94,1000,904,96,1.05485232067511,2.18181818181818
2010,"Center of Intelligent Info Retrieval, UMass",umassSDMW,95,1000,751,249,1.18203309692671,2.62105263157895
2010,"Center of Intelligent Info Retrieval, UMass",umassSDMW,96,1000,905,95,1.0515247108307,2.06521739130435
2010,"Center of Intelligent Info Retrieval, UMass",umassSDMW,97,1000,807,193,1.12107623318386,2.27058823529412
2010,"Center of Intelligent Info Retrieval, UMass",umassSDMW,98,1000,851,149,1.08813928182807,2.19117647058824
2010,"Center of Intelligent Info Retrieval, UMass",umassSDMW,99,1000,834,166,1.1001100110011,2.21333333333333
2010,"Center of Intelligent Info Retrieval, UMass",umassSDMW,100,1000,928,72,1.03734439834025,2
2010,"Center of Intelligent Info Retrieval, UMass",umasswfb520,51,1000,967,33,1.01729399796541,2.0625
2010,"Center of Intelligent Info Retrieval, UMass",umasswfb520,52,1000,947,53,1.02774922918808,2.03846153846154
2010,"Center of Intelligent Info Retrieval, UMass",umasswfb520,53,1000,892,108,1.05820105820106,2.0377358490566
2010,"Center of Intelligent Info Retrieval, UMass",umasswfb520,54,1000,886,114,1.06157112526539,2.03571428571429
2010,"Center of Intelligent Info Retrieval, UMass",umasswfb520,55,1000,887,113,1.06723585912487,2.26
2010,"Center of Intelligent Info Retrieval, UMass",umasswfb520,56,1000,923,77,1.04058272632674,2.02631578947368
2010,"Center of Intelligent Info Retrieval, UMass",umasswfb520,57,1000,602,398,1.3531799729364,2.90510948905109
2010,"Center of Intelligent Info Retrieval, UMass",umasswfb520,58,1000,909,91,1.04931794333683,2.06818181818182
2010,"Center of Intelligent Info Retrieval, UMass",umasswfb520,59,1000,904,96,1.0515247108307,2.04255319148936
2010,"Center of Intelligent Info Retrieval, UMass",umasswfb520,60,1000,895,105,1.05820105820106,2.1
2010,"Center of Intelligent Info Retrieval, UMass",umasswfb520,61,1000,941,59,1.03092783505155,2.03448275862069
2010,"Center of Intelligent Info Retrieval, UMass",umasswfb520,62,1000,950,50,1.02564102564103,2
2010,"Center of Intelligent Info Retrieval, UMass",umasswfb520,63,1000,921,79,1.0515247108307,2.63333333333333
2010,"Center of Intelligent Info Retrieval, UMass",umasswfb520,64,1000,902,98,1.0515247108307,2
2010,"Center of Intelligent Info Retrieval, UMass",umasswfb520,65,1000,899,101,1.05596620908131,2.10416666666667
2010,"Center of Intelligent Info Retrieval, UMass",umasswfb520,66,1000,905,95,1.05042016806723,2.02127659574468
2010,"Center of Intelligent Info Retrieval, UMass",umasswfb520,67,1000,912,88,1.05042016806723,2.2
2010,"Center of Intelligent Info Retrieval, UMass",umasswfb520,68,1000,960,40,1.02145045965271,2.10526315789474
2010,"Center of Intelligent Info Retrieval, UMass",umasswfb520,69,1000,960,40,1.02145045965271,2.10526315789474
2010,"Center of Intelligent Info Retrieval, UMass",umasswfb520,70,1000,900,100,1.05485232067511,2.08333333333333
2010,"Center of Intelligent Info Retrieval, UMass",umasswfb520,71,1000,892,108,1.05932203389831,2.07692307692308
2010,"Center of Intelligent Info Retrieval, UMass",umasswfb520,72,1000,912,88,1.04602510460251,2
2010,"Center of Intelligent Info Retrieval, UMass",umasswfb520,73,1000,939,61,1.03199174406605,2.03333333333333
2010,"Center of Intelligent Info Retrieval, UMass",umasswfb520,74,1000,933,67,1.0351966873706,2.03030303030303
2010,"Center of Intelligent Info Retrieval, UMass",umasswfb520,75,1000,915,85,1.04493207941484,2.02380952380952
2010,"Center of Intelligent Info Retrieval, UMass",umasswfb520,76,1000,948,52,1.02669404517454,2
2010,"Center of Intelligent Info Retrieval, UMass",umasswfb520,77,1000,945,55,1.03305785123967,2.39130434782609
2010,"Center of Intelligent Info Retrieval, UMass",umasswfb520,78,1000,954,46,1.02354145342886,2
2010,"Center of Intelligent Info Retrieval, UMass",umasswfb520,79,1000,900,100,1.05263157894737,2
2010,"Center of Intelligent Info Retrieval, UMass",umasswfb520,80,1000,936,64,1.0351966873706,2.13333333333333
2010,"Center of Intelligent Info Retrieval, UMass",umasswfb520,81,1000,891,109,1.06496272630458,2.27083333333333
2010,"Center of Intelligent Info Retrieval, UMass",umasswfb520,82,1000,880,120,1.06496272630458,2.03389830508475
2010,"Center of Intelligent Info Retrieval, UMass",umasswfb520,83,1000,892,108,1.07296137339056,2.7
2010,"Center of Intelligent Info Retrieval, UMass",umasswfb520,84,1000,931,69,1.03842159916926,2.15625
2010,"Center of Intelligent Info Retrieval, UMass",umasswfb520,85,1000,949,51,1.02669404517454,2.04
2010,"Center of Intelligent Info Retrieval, UMass",umasswfb520,86,1000,923,77,1.04166666666667,2.08108108108108
2010,"Center of Intelligent Info Retrieval, UMass",umasswfb520,87,1000,925,75,1.04166666666667,2.14285714285714
2010,"Center of Intelligent Info Retrieval, UMass",umasswfb520,88,1000,966,34,1.01729399796541,2
2010,"Center of Intelligent Info Retrieval, UMass",umasswfb520,89,1000,955,45,1.02459016393443,2.14285714285714
2010,"Center of Intelligent Info Retrieval, UMass",umasswfb520,90,1000,907,93,1.05263157894737,2.16279069767442
2010,"Center of Intelligent Info Retrieval, UMass",umasswfb520,91,1000,874,126,1.08695652173913,2.73913043478261
2010,"Center of Intelligent Info Retrieval, UMass",umasswfb520,92,1000,924,76,1.04058272632674,2.05405405405405
2010,"Center of Intelligent Info Retrieval, UMass",umasswfb520,93,1000,910,90,1.0515247108307,2.19512195121951
2010,"Center of Intelligent Info Retrieval, UMass",umasswfb520,94,1000,937,63,1.03305785123967,2.03225806451613
2010,"Center of Intelligent Info Retrieval, UMass",umasswfb520,95,1000,821,179,1.12994350282486,2.796875
2010,"Center of Intelligent Info Retrieval, UMass",umasswfb520,96,1000,950,50,1.02564102564103,2
2010,"Center of Intelligent Info Retrieval, UMass",umasswfb520,97,1000,928,72,1.03734439834025,2
2010,"Center of Intelligent Info Retrieval, UMass",umasswfb520,98,1000,816,184,1.12739571589628,2.59154929577465
2010,"Center of Intelligent Info Retrieval, UMass",umasswfb520,99,1000,902,98,1.05263157894737,2.04166666666667
2010,"Center of Intelligent Info Retrieval, UMass",umasswfb520,100,1000,942,58,1.02986611740474,2
2010,University of Glasgow (Terrier Team),uogTrA40n,51,1000,1000,0,1,
2010,University of Glasgow (Terrier Team),uogTrA40n,52,1000,1000,0,1,
2010,University of Glasgow (Terrier Team),uogTrA40n,53,1000,1000,0,1,
2010,University of Glasgow (Terrier Team),uogTrA40n,54,1000,1000,0,1,
2010,University of Glasgow (Terrier Team),uogTrA40n,55,1000,998,2,1.001001001001,2
2010,University of Glasgow (Terrier Team),uogTrA40n,56,1000,1000,0,1,
2010,University of Glasgow (Terrier Team),uogTrA40n,57,1000,998,2,1.001001001001,2
2010,University of Glasgow (Terrier Team),uogTrA40n,58,1000,1000,0,1,
2010,University of Glasgow (Terrier Team),uogTrA40n,59,1000,998,2,1.001001001001,2
2010,University of Glasgow (Terrier Team),uogTrA40n,60,1000,1000,0,1,
2010,University of Glasgow (Terrier Team),uogTrA40n,61,1000,1000,0,1,
2010,University of Glasgow (Terrier Team),uogTrA40n,62,1000,1000,0,1,
2010,University of Glasgow (Terrier Team),uogTrA40n,63,1000,1000,0,1,
2010,University of Glasgow (Terrier Team),uogTrA40n,64,1000,1000,0,1,
2010,University of Glasgow (Terrier Team),uogTrA40n,65,1000,1000,0,1,
2010,University of Glasgow (Terrier Team),uogTrA40n,66,1000,996,4,1.00200400801603,2
2010,University of Glasgow (Terrier Team),uogTrA40n,67,1000,970,30,1.01729399796541,2.30769230769231
2010,University of Glasgow (Terrier Team),uogTrA40n,68,1000,998,2,1.001001001001,2
2010,University of Glasgow (Terrier Team),uogTrA40n,69,1000,993,7,1.00401606425703,2.33333333333333
2010,University of Glasgow (Terrier Team),uogTrA40n,70,1000,1000,0,1,
2010,University of Glasgow (Terrier Team),uogTrA40n,71,1000,1000,0,1,
2010,University of Glasgow (Terrier Team),uogTrA40n,72,1000,1000,0,1,
2010,University of Glasgow (Terrier Team),uogTrA40n,73,1000,1000,0,1,
2010,University of Glasgow (Terrier Team),uogTrA40n,74,1000,1000,0,1,
2010,University of Glasgow (Terrier Team),uogTrA40n,75,1000,1000,0,1,
2010,University of Glasgow (Terrier Team),uogTrA40n,76,1000,1000,0,1,
2010,University of Glasgow (Terrier Team),uogTrA40n,77,1000,1000,0,1,
2010,University of Glasgow (Terrier Team),uogTrA40n,78,1000,1000,0,1,
2010,University of Glasgow (Terrier Team),uogTrA40n,79,1000,1000,0,1,
2010,University of Glasgow (Terrier Team),uogTrA40n,80,1000,979,21,1.01419878296146,3
2010,University of Glasgow (Terrier Team),uogTrA40n,81,1000,986,14,1.00704934541793,2
2010,University of Glasgow (Terrier Team),uogTrA40n,82,1000,1000,0,1,
2010,University of Glasgow (Terrier Team),uogTrA40n,83,1000,998,2,1.001001001001,2
2010,University of Glasgow (Terrier Team),uogTrA40n,84,1000,1000,0,1,
2010,University of Glasgow (Terrier Team),uogTrA40n,85,1000,1000,0,1,
2010,University of Glasgow (Terrier Team),uogTrA40n,86,1000,1000,0,1,
2010,University of Glasgow (Terrier Team),uogTrA40n,87,1000,1000,0,1,
2010,University of Glasgow (Terrier Team),uogTrA40n,88,1000,1000,0,1,
2010,University of Glasgow (Terrier Team),uogTrA40n,89,1000,1000,0,1,
2010,University of Glasgow (Terrier Team),uogTrA40n,90,1000,998,2,1.001001001001,2
2010,University of Glasgow (Terrier Team),uogTrA40n,91,1000,1000,0,1,
2010,University of Glasgow (Terrier Team),uogTrA40n,92,1000,994,6,1.00300902708124,2
2010,University of Glasgow (Terrier Team),uogTrA40n,93,1000,998,2,1.001001001001,2
2010,University of Glasgow (Terrier Team),uogTrA40n,94,1000,972,28,1.01522842639594,2.15384615384615
2010,University of Glasgow (Terrier Team),uogTrA40n,95,1000,1000,0,1,
2010,University of Glasgow (Terrier Team),uogTrA40n,96,1000,1000,0,1,
2010,University of Glasgow (Terrier Team),uogTrA40n,97,1000,1000,0,1,
2010,University of Glasgow (Terrier Team),uogTrA40n,98,1000,971,29,1.01522842639594,2.07142857142857
2010,University of Glasgow (Terrier Team),uogTrA40n,99,1000,961,39,1.02354145342886,2.4375
2010,University of Glasgow (Terrier Team),uogTrA40n,100,1000,1000,0,1,
2010,University of Glasgow (Terrier Team),uogTrA42,51,1000,1000,0,1,
2010,University of Glasgow (Terrier Team),uogTrA42,52,1000,1000,0,1,
2010,University of Glasgow (Terrier Team),uogTrA42,53,1000,1000,0,1,
2010,University of Glasgow (Terrier Team),uogTrA42,54,1000,1000,0,1,
2010,University of Glasgow (Terrier Team),uogTrA42,55,1000,1000,0,1,
2010,University of Glasgow (Terrier Team),uogTrA42,56,1000,1000,0,1,
2010,University of Glasgow (Terrier Team),uogTrA42,57,1000,1000,0,1,
2010,University of Glasgow (Terrier Team),uogTrA42,58,1000,1000,0,1,
2010,University of Glasgow (Terrier Team),uogTrA42,59,1000,1000,0,1,
2010,University of Glasgow (Terrier Team),uogTrA42,60,1000,1000,0,1,
2010,University of Glasgow (Terrier Team),uogTrA42,61,1000,1000,0,1,
2010,University of Glasgow (Terrier Team),uogTrA42,62,1000,1000,0,1,
2010,University of Glasgow (Terrier Team),uogTrA42,63,1000,1000,0,1,
2010,University of Glasgow (Terrier Team),uogTrA42,64,1000,1000,0,1,
2010,University of Glasgow (Terrier Team),uogTrA42,65,1000,1000,0,1,
2010,University of Glasgow (Terrier Team),uogTrA42,66,1000,1000,0,1,
2010,University of Glasgow (Terrier Team),uogTrA42,67,1000,1000,0,1,
2010,University of Glasgow (Terrier Team),uogTrA42,68,1000,1000,0,1,
2010,University of Glasgow (Terrier Team),uogTrA42,69,1000,1000,0,1,
2010,University of Glasgow (Terrier Team),uogTrA42,70,1000,1000,0,1,
2010,University of Glasgow (Terrier Team),uogTrA42,71,1000,1000,0,1,
2010,University of Glasgow (Terrier Team),uogTrA42,72,1000,1000,0,1,
2010,University of Glasgow (Terrier Team),uogTrA42,73,1000,1000,0,1,
2010,University of Glasgow (Terrier Team),uogTrA42,74,1000,1000,0,1,
2010,University of Glasgow (Terrier Team),uogTrA42,75,1000,1000,0,1,
2010,University of Glasgow (Terrier Team),uogTrA42,76,1000,1000,0,1,
2010,University of Glasgow (Terrier Team),uogTrA42,77,1000,1000,0,1,
2010,University of Glasgow (Terrier Team),uogTrA42,78,1000,1000,0,1,
2010,University of Glasgow (Terrier Team),uogTrA42,79,1000,998,2,1.001001001001,2
2010,University of Glasgow (Terrier Team),uogTrA42,80,1000,998,2,1.001001001001,2
2010,University of Glasgow (Terrier Team),uogTrA42,81,1000,1000,0,1,
2010,University of Glasgow (Terrier Team),uogTrA42,82,1000,1000,0,1,
2010,University of Glasgow (Terrier Team),uogTrA42,83,1000,996,4,1.00200400801603,2
2010,University of Glasgow (Terrier Team),uogTrA42,84,1000,1000,0,1,
2010,University of Glasgow (Terrier Team),uogTrA42,85,1000,1000,0,1,
2010,University of Glasgow (Terrier Team),uogTrA42,86,1000,1000,0,1,
2010,University of Glasgow (Terrier Team),uogTrA42,87,1000,1000,0,1,
2010,University of Glasgow (Terrier Team),uogTrA42,88,1000,1000,0,1,
2010,University of Glasgow (Terrier Team),uogTrA42,89,1000,1000,0,1,
2010,University of Glasgow (Terrier Team),uogTrA42,90,1000,1000,0,1,
2010,University of Glasgow (Terrier Team),uogTrA42,91,1000,1000,0,1,
2010,University of Glasgow (Terrier Team),uogTrA42,92,1000,1000,0,1,
2010,University of Glasgow (Terrier Team),uogTrA42,93,1000,998,2,1.001001001001,2
2010,University of Glasgow (Terrier Team),uogTrA42,94,1000,1000,0,1,
2010,University of Glasgow (Terrier Team),uogTrA42,95,1000,1000,0,1,
2010,University of Glasgow (Terrier Team),uogTrA42,96,1000,1000,0,1,
2010,University of Glasgow (Terrier Team),uogTrA42,97,1000,1000,0,1,
2010,University of Glasgow (Terrier Team),uogTrA42,98,1000,1000,0,1,
2010,University of Glasgow (Terrier Team),uogTrA42,99,1000,1000,0,1,
2010,University of Glasgow (Terrier Team),uogTrA42,100,1000,1000,0,1,
2010,University of Glasgow (Terrier Team),uogTrB67,51,1000,998,2,1.001001001001,2
2010,University of Glasgow (Terrier Team),uogTrB67,52,1000,1000,0,1,
2010,University of Glasgow (Terrier Team),uogTrB67,53,1000,1000,0,1,
2010,University of Glasgow (Terrier Team),uogTrB67,54,1000,1000,0,1,
2010,University of Glasgow (Terrier Team),uogTrB67,55,1000,1000,0,1,
2010,University of Glasgow (Terrier Team),uogTrB67,56,1000,1000,0,1,
2010,University of Glasgow (Terrier Team),uogTrB67,57,1000,1000,0,1,
2010,University of Glasgow (Terrier Team),uogTrB67,58,1000,1000,0,1,
2010,University of Glasgow (Terrier Team),uogTrB67,59,1000,1000,0,1,
2010,University of Glasgow (Terrier Team),uogTrB67,60,1000,1000,0,1,
2010,University of Glasgow (Terrier Team),uogTrB67,61,1000,1000,0,1,
2010,University of Glasgow (Terrier Team),uogTrB67,62,1000,1000,0,1,
2010,University of Glasgow (Terrier Team),uogTrB67,63,1000,1000,0,1,
2010,University of Glasgow (Terrier Team),uogTrB67,64,1000,1000,0,1,
2010,University of Glasgow (Terrier Team),uogTrB67,65,1000,1000,0,1,
2010,University of Glasgow (Terrier Team),uogTrB67,66,1000,998,2,1.001001001001,2
2010,University of Glasgow (Terrier Team),uogTrB67,67,1000,1000,0,1,
2010,University of Glasgow (Terrier Team),uogTrB67,68,1000,1000,0,1,
2010,University of Glasgow (Terrier Team),uogTrB67,69,1000,1000,0,1,
2010,University of Glasgow (Terrier Team),uogTrB67,70,1000,1000,0,1,
2010,University of Glasgow (Terrier Team),uogTrB67,71,1000,1000,0,1,
2010,University of Glasgow (Terrier Team),uogTrB67,72,1000,1000,0,1,
2010,University of Glasgow (Terrier Team),uogTrB67,73,1000,1000,0,1,
2010,University of Glasgow (Terrier Team),uogTrB67,74,1000,1000,0,1,
2010,University of Glasgow (Terrier Team),uogTrB67,75,1000,1000,0,1,
2010,University of Glasgow (Terrier Team),uogTrB67,76,1000,1000,0,1,
2010,University of Glasgow (Terrier Team),uogTrB67,77,1000,1000,0,1,
2010,University of Glasgow (Terrier Team),uogTrB67,78,1000,1000,0,1,
2010,University of Glasgow (Terrier Team),uogTrB67,79,1000,1000,0,1,
2010,University of Glasgow (Terrier Team),uogTrB67,80,1000,1000,0,1,
2010,University of Glasgow (Terrier Team),uogTrB67,81,1000,998,2,1.001001001001,2
2010,University of Glasgow (Terrier Team),uogTrB67,82,1000,1000,0,1,
2010,University of Glasgow (Terrier Team),uogTrB67,83,1000,1000,0,1,
2010,University of Glasgow (Terrier Team),uogTrB67,84,1000,998,2,1.001001001001,2
2010,University of Glasgow (Terrier Team),uogTrB67,85,1000,1000,0,1,
2010,University of Glasgow (Terrier Team),uogTrB67,86,1000,1000,0,1,
2010,University of Glasgow (Terrier Team),uogTrB67,87,1000,1000,0,1,
2010,University of Glasgow (Terrier Team),uogTrB67,88,1000,1000,0,1,
2010,University of Glasgow (Terrier Team),uogTrB67,89,1000,1000,0,1,
2010,University of Glasgow (Terrier Team),uogTrB67,90,1000,1000,0,1,
2010,University of Glasgow (Terrier Team),uogTrB67,91,1000,1000,0,1,
2010,University of Glasgow (Terrier Team),uogTrB67,92,1000,1000,0,1,
2010,University of Glasgow (Terrier Team),uogTrB67,93,1000,1000,0,1,
2010,University of Glasgow (Terrier Team),uogTrB67,94,1000,998,2,1.001001001001,2
2010,University of Glasgow (Terrier Team),uogTrB67,95,1000,991,9,1.00502512562814,2.25
2010,University of Glasgow (Terrier Team),uogTrB67,96,1000,998,2,1.001001001001,2
2010,University of Glasgow (Terrier Team),uogTrB67,97,1000,1000,0,1,
2010,University of Glasgow (Terrier Team),uogTrB67,98,1000,1000,0,1,
2010,University of Glasgow (Terrier Team),uogTrB67,99,1000,1000,0,1,
2010,University of Glasgow (Terrier Team),uogTrB67,100,1000,1000,0,1,
2010,University of Glasgow  (Terrier Team),uogTrB67LTS,51,1000,998,2,1.001001001001,2
2010,University of Glasgow  (Terrier Team),uogTrB67LTS,52,1000,1000,0,1,
2010,University of Glasgow  (Terrier Team),uogTrB67LTS,53,1000,1000,0,1,
2010,University of Glasgow  (Terrier Team),uogTrB67LTS,54,1000,1000,0,1,
2010,University of Glasgow  (Terrier Team),uogTrB67LTS,55,1000,1000,0,1,
2010,University of Glasgow  (Terrier Team),uogTrB67LTS,56,1000,1000,0,1,
2010,University of Glasgow  (Terrier Team),uogTrB67LTS,57,1000,1000,0,1,
2010,University of Glasgow  (Terrier Team),uogTrB67LTS,58,1000,1000,0,1,
2010,University of Glasgow  (Terrier Team),uogTrB67LTS,59,1000,1000,0,1,
2010,University of Glasgow  (Terrier Team),uogTrB67LTS,60,1000,1000,0,1,
2010,University of Glasgow  (Terrier Team),uogTrB67LTS,61,1000,1000,0,1,
2010,University of Glasgow  (Terrier Team),uogTrB67LTS,62,1000,1000,0,1,
2010,University of Glasgow  (Terrier Team),uogTrB67LTS,63,1000,1000,0,1,
2010,University of Glasgow  (Terrier Team),uogTrB67LTS,64,1000,1000,0,1,
2010,University of Glasgow  (Terrier Team),uogTrB67LTS,65,1000,1000,0,1,
2010,University of Glasgow  (Terrier Team),uogTrB67LTS,66,1000,1000,0,1,
2010,University of Glasgow  (Terrier Team),uogTrB67LTS,67,1000,1000,0,1,
2010,University of Glasgow  (Terrier Team),uogTrB67LTS,68,1000,1000,0,1,
2010,University of Glasgow  (Terrier Team),uogTrB67LTS,69,1000,1000,0,1,
2010,University of Glasgow  (Terrier Team),uogTrB67LTS,70,1000,1000,0,1,
2010,University of Glasgow  (Terrier Team),uogTrB67LTS,71,1000,1000,0,1,
2010,University of Glasgow  (Terrier Team),uogTrB67LTS,72,1000,1000,0,1,
2010,University of Glasgow  (Terrier Team),uogTrB67LTS,73,1000,1000,0,1,
2010,University of Glasgow  (Terrier Team),uogTrB67LTS,74,1000,1000,0,1,
2010,University of Glasgow  (Terrier Team),uogTrB67LTS,75,1000,1000,0,1,
2010,University of Glasgow  (Terrier Team),uogTrB67LTS,76,1000,1000,0,1,
2010,University of Glasgow  (Terrier Team),uogTrB67LTS,77,1000,1000,0,1,
2010,University of Glasgow  (Terrier Team),uogTrB67LTS,78,1000,1000,0,1,
2010,University of Glasgow  (Terrier Team),uogTrB67LTS,79,1000,1000,0,1,
2010,University of Glasgow  (Terrier Team),uogTrB67LTS,80,1000,1000,0,1,
2010,University of Glasgow  (Terrier Team),uogTrB67LTS,81,1000,998,2,1.001001001001,2
2010,University of Glasgow  (Terrier Team),uogTrB67LTS,82,1000,1000,0,1,
2010,University of Glasgow  (Terrier Team),uogTrB67LTS,83,1000,1000,0,1,
2010,University of Glasgow  (Terrier Team),uogTrB67LTS,84,1000,998,2,1.001001001001,2
2010,University of Glasgow  (Terrier Team),uogTrB67LTS,85,1000,1000,0,1,
2010,University of Glasgow  (Terrier Team),uogTrB67LTS,86,1000,1000,0,1,
2010,University of Glasgow  (Terrier Team),uogTrB67LTS,87,1000,1000,0,1,
2010,University of Glasgow  (Terrier Team),uogTrB67LTS,88,1000,1000,0,1,
2010,University of Glasgow  (Terrier Team),uogTrB67LTS,89,1000,1000,0,1,
2010,University of Glasgow  (Terrier Team),uogTrB67LTS,90,1000,1000,0,1,
2010,University of Glasgow  (Terrier Team),uogTrB67LTS,91,1000,1000,0,1,
2010,University of Glasgow  (Terrier Team),uogTrB67LTS,92,1000,1000,0,1,
2010,University of Glasgow  (Terrier Team),uogTrB67LTS,93,1000,1000,0,1,
2010,University of Glasgow  (Terrier Team),uogTrB67LTS,94,1000,998,2,1.001001001001,2
2010,University of Glasgow  (Terrier Team),uogTrB67LTS,95,1000,991,9,1.00502512562814,2.25
2010,University of Glasgow  (Terrier Team),uogTrB67LTS,96,1000,998,2,1.001001001001,2
2010,University of Glasgow  (Terrier Team),uogTrB67LTS,97,1000,1000,0,1,
2010,University of Glasgow  (Terrier Team),uogTrB67LTS,98,1000,1000,0,1,
2010,University of Glasgow  (Terrier Team),uogTrB67LTS,99,1000,1000,0,1,
2010,University of Glasgow  (Terrier Team),uogTrB67LTS,100,1000,1000,0,1,
2010,University of Twente,utwente3,51,1000,827,173,1.11982082866741,2.62121212121212
2010,University of Twente,utwente3,52,1000,712,288,1.21506682867558,2.59459459459459
2010,University of Twente,utwente3,53,1000,772,228,1.17785630153121,2.96103896103896
2010,University of Twente,utwente3,54,1000,872,128,1.09170305676856,2.90909090909091
2010,University of Twente,utwente3,55,1000,972,28,1.01419878296146,2
2010,University of Twente,utwente3,56,1000,670,330,1.33868808567604,4.28571428571429
2010,University of Twente,utwente3,57,1000,462,538,1.68067226890756,4.04511278195489
2010,University of Twente,utwente3,58,1000,914,86,1.05485232067511,2.52941176470588
2010,University of Twente,utwente3,59,1000,758,242,1.20918984280532,3.50724637681159
2010,University of Twente,utwente3,60,1000,809,191,1.12866817155756,2.48051948051948
2010,University of Twente,utwente3,61,1000,868,132,1.10619469026549,3.66666666666667
2010,University of Twente,utwente3,62,1000,701,299,1.24069478908189,2.84761904761905
2010,University of Twente,utwente3,63,1000,889,111,1.06157112526539,2.09433962264151
2010,University of Twente,utwente3,64,1000,740,260,1.19331742243437,2.6530612244898
2010,University of Twente,utwente3,65,1000,629,371,1.29032258064516,2.54109589041096
2010,University of Twente,utwente3,66,1000,433,567,1.78571428571429,4.46456692913386
2010,University of Twente,utwente3,67,1000,888,112,1.085776330076,3.39393939393939
2010,University of Twente,utwente3,68,1000,866,134,1.09289617486339,2.73469387755102
2010,University of Twente,utwente3,69,1000,645,355,1.3869625520111,4.67105263157895
2010,University of Twente,utwente3,70,1000,780,220,1.16686114352392,2.85714285714286
2010,University of Twente,utwente3,71,1000,917,83,1.05596620908131,2.76666666666667
2010,University of Twente,utwente3,72,1000,979,21,1.01112234580384,2.1
2010,University of Twente,utwente3,73,1000,730,270,1.22100122100122,3.03370786516854
2010,University of Twente,utwente3,74,1000,859,141,1.08695652173913,2.31147540983607
2010,University of Twente,utwente3,75,1000,804,196,1.12739571589628,2.36144578313253
2010,University of Twente,utwente3,76,1000,948,52,1.03305785123967,2.6
2010,University of Twente,utwente3,77,1000,756,244,1.17233294255569,2.51546391752577
2010,University of Twente,utwente3,78,1000,823,177,1.13378684807256,3
2010,University of Twente,utwente3,79,1000,897,103,1.06382978723404,2.3953488372093
2010,University of Twente,utwente3,80,1000,496,504,1.6025641025641,3.9375
2010,University of Twente,utwente3,81,1000,946,54,1.02986611740474,2.16
2010,University of Twente,utwente3,82,1000,850,150,1.09529025191676,2.38095238095238
2010,University of Twente,utwente3,83,1000,927,73,1.0515247108307,3.04166666666667
2010,University of Twente,utwente3,84,1000,950,50,1.02880658436214,2.27272727272727
2010,University of Twente,utwente3,85,1000,435,565,1.81159420289855,4.82905982905983
2010,University of Twente,utwente3,86,1000,968,32,1.0183299389002,2.28571428571429
2010,University of Twente,utwente3,87,1000,444,556,1.84162062615101,5.61616161616162
2010,University of Twente,utwente3,88,1000,865,135,1.09051254089422,2.59615384615385
2010,University of Twente,utwente3,89,1000,822,178,1.12612612612613,2.6969696969697
2010,University of Twente,utwente3,90,1000,517,483,1.53139356814701,3.55147058823529
2010,University of Twente,utwente3,91,1000,905,95,1.05932203389831,2.43589743589744
2010,University of Twente,utwente3,92,1000,968,32,1.0183299389002,2.28571428571429
2010,University of Twente,utwente3,93,1000,727,273,1.19760479041916,2.52777777777778
2010,University of Twente,utwente3,94,1000,927,73,1.04058272632674,2.14705882352941
2010,University of Twente,utwente3,95,1000,806,194,1.14810562571757,2.98461538461538
2010,University of Twente,utwente3,96,1000,962,38,1.02249488752556,2.375
2010,University of Twente,utwente3,97,1000,959,41,1.02249488752556,2.15789473684211
2010,University of Twente,utwente3,98,1000,897,103,1.07066381156317,2.78378378378378
2010,University of Twente,utwente3,99,1000,888,112,1.07296137339056,2.54545454545455
2010,University of Twente,utwente3,100,1000,540,460,1.53374233128834,4.10714285714286
2010,University of Twente,utwente4,51,1000,755,245,1.18906064209275,2.84883720930233
2010,University of Twente,utwente4,52,1000,725,275,1.18764845605701,2.35042735042735
2010,University of Twente,utwente4,53,1000,496,504,1.6750418760469,4.99009900990099
2010,University of Twente,utwente4,54,1000,900,100,1.06723585912487,2.7027027027027
2010,University of Twente,utwente4,55,1000,976,24,1.01214574898785,2
2010,University of Twente,utwente4,56,1000,654,346,1.3550135501355,4.11904761904762
2010,University of Twente,utwente4,57,1000,496,504,1.60513643659711,3.96850393700787
2010,University of Twente,utwente4,58,1000,928,72,1.04602510460251,2.57142857142857
2010,University of Twente,utwente4,59,1000,744,256,1.25628140703518,4.92307692307692
2010,University of Twente,utwente4,60,1000,833,167,1.10253583241455,2.25675675675676
2010,University of Twente,utwente4,61,1000,884,116,1.09409190371991,3.86666666666667
2010,University of Twente,utwente4,62,1000,734,266,1.20772946859903,2.82978723404255
2010,University of Twente,utwente4,63,1000,879,121,1.06723585912487,2.08620689655172
2010,University of Twente,utwente4,64,1000,765,235,1.16414435389988,2.5
2010,University of Twente,utwente4,65,1000,665,335,1.25628140703518,2.55725190839695
2010,University of Twente,utwente4,66,1000,530,470,1.57977883096367,4.56310679611651
2010,University of Twente,utwente4,67,1000,808,192,1.16144018583043,3.62264150943396
2010,University of Twente,utwente4,68,1000,881,119,1.07874865156419,2.58695652173913
2010,University of Twente,utwente4,69,1000,434,566,1.84162062615101,5.19266055045872
2010,University of Twente,utwente4,70,1000,836,164,1.10864745011086,2.48484848484849
2010,University of Twente,utwente4,71,1000,840,160,1.11731843575419,2.90909090909091
2010,University of Twente,utwente4,72,1000,988,12,1.00603621730382,2
2010,University of Twente,utwente4,73,1000,766,234,1.16959064327485,2.62921348314607
2010,University of Twente,utwente4,74,1000,892,108,1.06496272630458,2.29787234042553
2010,University of Twente,utwente4,75,1000,824,176,1.10864745011086,2.25641025641026
2010,University of Twente,utwente4,76,1000,907,93,1.06609808102345,3
2010,University of Twente,utwente4,77,1000,794,206,1.13765642775882,2.42352941176471
2010,University of Twente,utwente4,78,1000,878,122,1.09289617486339,3.2972972972973
2010,University of Twente,utwente4,79,1000,900,100,1.06157112526539,2.38095238095238
2010,University of Twente,utwente4,80,1000,501,499,1.66112956810631,4.94059405940594
2010,University of Twente,utwente4,81,1000,975,25,1.01317122593718,2.08333333333333
2010,University of Twente,utwente4,82,1000,880,120,1.07066381156317,2.22222222222222
2010,University of Twente,utwente4,83,1000,943,57,1.03734439834025,2.71428571428571
2010,University of Twente,utwente4,84,1000,941,59,1.03199174406605,2.10714285714286
2010,University of Twente,utwente4,85,1000,463,537,1.70357751277683,4.33064516129032
2010,University of Twente,utwente4,86,1000,977,23,1.01317122593718,2.3
2010,University of Twente,utwente4,87,1000,497,503,1.70357751277683,5.58888888888889
2010,University of Twente,utwente4,88,1000,874,126,1.08342361863489,2.57142857142857
2010,University of Twente,utwente4,89,1000,833,167,1.11234705228031,2.53030303030303
2010,University of Twente,utwente4,90,1000,536,464,1.4792899408284,3.31428571428571
2010,University of Twente,utwente4,91,1000,888,112,1.08108108108108,3.02702702702703
2010,University of Twente,utwente4,92,1000,975,25,1.01419878296146,2.27272727272727
2010,University of Twente,utwente4,93,1000,761,239,1.16550116550117,2.4639175257732
2010,University of Twente,utwente4,94,1000,935,65,1.03626943005181,2.16666666666667
2010,University of Twente,utwente4,95,1000,812,188,1.13250283125708,2.64788732394366
2010,University of Twente,utwente4,96,1000,975,25,1.01419878296146,2.27272727272727
2010,University of Twente,utwente4,97,1000,967,33,1.0183299389002,2.2
2010,University of Twente,utwente4,98,1000,904,96,1.06496272630458,2.74285714285714
2010,University of Twente,utwente4,99,1000,896,104,1.06723585912487,2.53658536585366
2010,University of Twente,utwente4,100,1000,420,580,1.7825311942959,4.11347517730496
2010,University of Twente,utwente4SF,51,1000,746,254,1.21951219512195,3.43243243243243
2010,University of Twente,utwente4SF,52,1000,520,480,1.53374233128834,3.63636363636364
2010,University of Twente,utwente4SF,53,1000,728,272,1.21359223300971,2.83333333333333
2010,University of Twente,utwente4SF,54,1000,813,187,1.13895216400911,2.87692307692308
2010,University of Twente,utwente4SF,55,1000,978,22,1.01112234580384,2
2010,University of Twente,utwente4SF,56,1000,783,217,1.15740740740741,2.67901234567901
2010,University of Twente,utwente4SF,57,1000,356,644,2.1505376344086,5.90825688073395
2010,University of Twente,utwente4SF,58,1000,846,154,1.08932461873638,2.13888888888889
2010,University of Twente,utwente4SF,59,1000,712,288,1.28369704749679,4.29850746268657
2010,University of Twente,utwente4SF,60,1000,780,220,1.14025085518814,2.2680412371134
2010,University of Twente,utwente4SF,61,1000,910,90,1.0515247108307,2.19512195121951
2010,University of Twente,utwente4SF,62,1000,548,452,1.49476831091181,3.73553719008264
2010,University of Twente,utwente4SF,63,1000,801,199,1.11982082866741,2.16304347826087
2010,University of Twente,utwente4SF,64,1000,583,417,1.39664804469274,3.13533834586466
2010,University of Twente,utwente4SF,65,1000,715,285,1.20192307692308,2.43589743589744
2010,University of Twente,utwente4SF,66,1000,754,246,1.22549019607843,3.96774193548387
2010,University of Twente,utwente4SF,67,1000,879,121,1.09289617486339,3.36111111111111
2010,University of Twente,utwente4SF,68,1000,869,131,1.08459869848156,2.47169811320755
2010,University of Twente,utwente4SF,69,1000,939,61,1.0351966873706,2.25925925925926
2010,University of Twente,utwente4SF,70,1000,876,124,1.08813928182807,2.88372093023256
2010,University of Twente,utwente4SF,71,1000,931,69,1.04275286757039,2.46428571428571
2010,University of Twente,utwente4SF,72,1000,988,12,1.00603621730382,2
2010,University of Twente,utwente4SF,73,1000,488,512,1.6260162601626,4.03149606299213
2010,University of Twente,utwente4SF,74,1000,813,187,1.11982082866741,2.3375
2010,University of Twente,utwente4SF,75,1000,625,375,1.30718954248366,2.67857142857143
2010,University of Twente,utwente4SF,76,1000,969,31,1.0183299389002,2.38461538461538
2010,University of Twente,utwente4SF,77,1000,556,444,1.47058823529412,3.58064516129032
2010,University of Twente,utwente4SF,78,1000,649,351,1.29533678756477,2.85365853658537
2010,University of Twente,utwente4SF,79,1000,876,124,1.07296137339056,2.21428571428571
2010,University of Twente,utwente4SF,80,1000,602,398,1.41643059490085,3.82692307692308
2010,University of Twente,utwente4SF,81,1000,978,22,1.01112234580384,2
2010,University of Twente,utwente4SF,82,1000,784,216,1.13636363636364,2.25
2010,University of Twente,utwente4SF,83,1000,961,39,1.02249488752556,2.29411764705882
2010,University of Twente,utwente4SF,84,1000,961,39,1.02564102564103,2.78571428571429
2010,University of Twente,utwente4SF,85,1000,597,403,1.4367816091954,4.07070707070707
2010,University of Twente,utwente4SF,86,1000,974,26,1.01522842639594,2.36363636363636
2010,University of Twente,utwente4SF,87,1000,651,349,1.31233595800525,3.14414414414414
2010,University of Twente,utwente4SF,88,1000,765,235,1.17647058823529,2.76470588235294
2010,University of Twente,utwente4SF,89,1000,754,246,1.17096018735363,2.46
2010,University of Twente,utwente4SF,90,987,293,694,2.37259615384615,5.64227642276423
2010,University of Twente,utwente4SF,91,1000,912,88,1.05374077976818,2.37837837837838
2010,University of Twente,utwente4SF,92,1000,980,20,1.01010101010101,2
2010,University of Twente,utwente4SF,93,1000,562,438,1.4265335235378,3.15107913669065
2010,University of Twente,utwente4SF,94,1000,872,128,1.07642626480086,2.24561403508772
2010,University of Twente,utwente4SF,95,650,548,102,1.11683848797251,3
2010,University of Twente,utwente4SF,96,1000,961,39,1.02249488752556,2.29411764705882
2010,University of Twente,utwente4SF,97,1000,965,35,1.01936799184506,2.1875
2010,University of Twente,utwente4SF,98,1000,929,71,1.03950103950104,2.15151515151515
2010,University of Twente,utwente4SF,99,1000,952,48,1.02880658436214,2.4
2010,University of Twente,utwente4SF,100,1000,679,321,1.31061598951507,3.82142857142857
2010,York University,york10wA1,51,1000,838,162,1.09529025191676,2.16
2010,York University,york10wA1,52,1000,744,256,1.16550116550117,2.24561403508772
2010,York University,york10wA1,53,1000,812,188,1.11856823266219,2.29268292682927
2010,York University,york10wA1,54,1000,785,215,1.14942528735632,2.52941176470588
2010,York University,york10wA1,55,1000,729,271,1.20627261761158,2.71
2010,York University,york10wA1,56,1000,783,217,1.1441647597254,2.38461538461538
2010,York University,york10wA1,57,1000,828,172,1.11111111111111,2.38888888888889
2010,York University,york10wA1,58,1000,789,211,1.13895216400911,2.37078651685393
2010,York University,york10wA1,59,1000,859,141,1.09170305676856,2.47368421052632
2010,York University,york10wA1,60,1000,770,230,1.13765642775882,2.11009174311927
2010,York University,york10wA1,61,1000,742,258,1.18483412322275,2.52941176470588
2010,York University,york10wA1,62,1000,838,162,1.10741971207087,2.49230769230769
2010,York University,york10wA1,63,1000,817,183,1.11856823266219,2.37662337662338
2010,York University,york10wA1,64,1000,748,252,1.17233294255569,2.4
2010,York University,york10wA1,65,1000,774,226,1.15074798619102,2.37894736842105
2010,York University,york10wA1,66,1000,854,146,1.09289617486339,2.39344262295082
2010,York University,york10wA1,67,1000,787,213,1.15874855156431,2.80263157894737
2010,York University,york10wA1,68,1000,839,161,1.09649122807018,2.20547945205479
2010,York University,york10wA1,69,1000,897,103,1.05708245243129,2.10204081632653
2010,York University,york10wA1,70,1000,888,112,1.06723585912487,2.28571428571429
2010,York University,york10wA1,71,1000,716,284,1.25786163522013,3.59493670886076
2010,York University,york10wA1,72,1000,711,289,1.31406044678055,5.78
2010,York University,york10wA1,73,1000,874,126,1.07411385606874,2.21052631578947
2010,York University,york10wA1,74,1000,795,205,1.12739571589628,2.22826086956522
2010,York University,york10wA1,75,1000,743,257,1.17096018735363,2.31531531531532
2010,York University,york10wA1,76,1000,876,124,1.07181136120043,2.17543859649123
2010,York University,york10wA1,77,1000,827,173,1.10619469026549,2.24675324675325
2010,York University,york10wA1,78,1000,945,55,1.02986611740474,2.11538461538462
2010,York University,york10wA1,79,1000,821,179,1.11111111111111,2.26582278481013
2010,York University,york10wA1,80,1000,972,28,1.01522842639594,2.15384615384615
2010,York University,york10wA1,81,1000,783,217,1.15207373271889,2.55294117647059
2010,York University,york10wA1,82,1000,821,179,1.11982082866741,2.48611111111111
2010,York University,york10wA1,83,1000,746,254,1.23304562268804,3.90769230769231
2010,York University,york10wA1,84,1000,808,192,1.12485939257593,2.37037037037037
2010,York University,york10wA1,85,1000,806,194,1.12612612612613,2.36585365853659
2010,York University,york10wA1,86,1000,857,143,1.085776330076,2.234375
2010,York University,york10wA1,87,1000,867,133,1.085776330076,2.46296296296296
2010,York University,york10wA1,88,1000,825,175,1.11482720178372,2.43055555555556
2010,York University,york10wA1,89,1000,828,172,1.10132158590308,2.15
2010,York University,york10wA1,90,1000,700,300,1.20918984280532,2.36220472440945
2010,York University,york10wA1,91,1000,911,89,1.06269925611052,2.96666666666667
2010,York University,york10wA1,92,1000,852,148,1.08932461873638,2.24242424242424
2010,York University,york10wA1,93,1000,771,229,1.1441647597254,2.22330097087379
2010,York University,york10wA1,94,1000,795,205,1.13507377979569,2.38372093023256
2010,York University,york10wA1,95,1000,923,77,1.04384133611691,2.2
2010,York University,york10wA1,96,1000,808,192,1.11731843575419,2.20689655172414
2010,York University,york10wA1,97,1000,927,73,1.03950103950104,2.08571428571429
2010,York University,york10wA1,98,1000,722,278,1.30039011703511,5.91489361702128
2010,York University,york10wA1,99,1000,861,139,1.10253583241455,3.02173913043478
2010,York University,york10wA1,100,1000,831,169,1.11982082866741,2.7258064516129
2010,York University,york10wA2,51,1000,820,180,1.11234705228031,2.27848101265823
2010,York University,york10wA2,52,1000,761,239,1.16144018583043,2.39
2010,York University,york10wA2,53,1000,827,173,1.11358574610245,2.43661971830986
2010,York University,york10wA2,54,1000,726,274,1.20048019207683,2.5607476635514
2010,York University,york10wA2,55,1000,702,298,1.23304562268804,2.73394495412844
2010,York University,york10wA2,56,1000,742,258,1.19760479041916,2.7741935483871
2010,York University,york10wA2,57,1000,931,69,1.03734439834025,2.09090909090909
2010,York University,york10wA2,58,1000,785,215,1.14155251141553,2.36263736263736
2010,York University,york10wA2,59,1000,865,135,1.09289617486339,2.7
2010,York University,york10wA2,60,1000,810,190,1.11358574610245,2.15909090909091
2010,York University,york10wA2,61,1000,781,219,1.15340253748558,2.54651162790698
2010,York University,york10wA2,62,1000,810,190,1.13378684807256,2.63888888888889
2010,York University,york10wA2,63,1000,823,177,1.12107623318386,2.56521739130435
2010,York University,york10wA2,64,1000,796,204,1.13250283125708,2.3448275862069
2010,York University,york10wA2,65,1000,794,206,1.13507377979569,2.36781609195402
2010,York University,york10wA2,66,1000,852,148,1.10497237569061,2.79245283018868
2010,York University,york10wA2,67,1000,804,196,1.14810562571757,2.92537313432836
2010,York University,york10wA2,68,1000,881,119,1.06951871657754,2.2037037037037
2010,York University,york10wA2,69,1000,934,66,1.0351966873706,2.0625
2010,York University,york10wA2,70,1000,904,96,1.05708245243129,2.28571428571429
2010,York University,york10wA2,71,1000,888,112,1.06496272630458,2.19607843137255
2010,York University,york10wA2,72,1000,807,193,1.14810562571757,3.015625
2010,York University,york10wA2,73,1000,843,157,1.1037527593819,2.49206349206349
2010,York University,york10wA2,74,1000,866,134,1.08225108225108,2.31034482758621
2010,York University,york10wA2,75,1000,708,292,1.20627261761158,2.41322314049587
2010,York University,york10wA2,76,1000,912,88,1.04931794333683,2.14634146341463
2010,York University,york10wA2,77,1000,825,175,1.10619469026549,2.21518987341772
2010,York University,york10wA2,78,1000,948,52,1.03092783505155,2.36363636363636
2010,York University,york10wA2,79,1000,803,197,1.12739571589628,2.3452380952381
2010,York University,york10wA2,80,1000,956,44,1.02459016393443,2.2
2010,York University,york10wA2,81,1000,744,256,1.21359223300971,3.2
2010,York University,york10wA2,82,1000,819,181,1.12612612612613,2.6231884057971
2010,York University,york10wA2,83,1000,761,239,1.22100122100122,4.12068965517241
2010,York University,york10wA2,84,1000,764,236,1.16959064327485,2.59340659340659
2010,York University,york10wA2,85,1000,822,178,1.10987791342952,2.25316455696203
2010,York University,york10wA2,86,1000,888,112,1.06723585912487,2.28571428571429
2010,York University,york10wA2,87,1000,863,137,1.09170305676856,2.58490566037736
2010,York University,york10wA2,88,1000,887,113,1.06382978723404,2.13207547169811
2010,York University,york10wA2,89,1000,859,141,1.08108108108108,2.13636363636364
2010,York University,york10wA2,90,1000,767,233,1.15606936416185,2.37755102040816
2010,York University,york10wA2,91,1000,898,102,1.06269925611052,2.37209302325581
2010,York University,york10wA2,92,1000,866,134,1.085776330076,2.43636363636364
2010,York University,york10wA2,93,1000,822,178,1.10741971207087,2.19753086419753
2010,York University,york10wA2,94,1000,760,240,1.17508813160987,2.63736263736264
2010,York University,york10wA2,95,1000,906,94,1.07296137339056,3.61538461538462
2010,York University,york10wA2,96,1000,808,192,1.13122171945701,2.52631578947368
2010,York University,york10wA2,97,1000,892,108,1.06609808102345,2.34782608695652
2010,York University,york10wA2,98,1000,679,321,1.23609394313968,2.46923076923077
2010,York University,york10wA2,99,1000,842,158,1.11731843575419,2.9811320754717
2010,York University,york10wA2,100,1000,917,83,1.04602510460251,2.12820512820513
2010,York University,york10wA3,51,1000,838,162,1.09529025191676,2.16
2010,York University,york10wA3,52,1000,744,256,1.16550116550117,2.24561403508772
2010,York University,york10wA3,53,1000,807,193,1.12359550561798,2.32530120481928
2010,York University,york10wA3,54,1000,769,231,1.16144018583043,2.51086956521739
2010,York University,york10wA3,55,1000,729,271,1.20627261761158,2.71
2010,York University,york10wA3,56,1000,785,215,1.1454753722795,2.44318181818182
2010,York University,york10wA3,57,1000,815,185,1.11856823266219,2.34177215189873
2010,York University,york10wA3,58,1000,789,211,1.13895216400911,2.37078651685393
2010,York University,york10wA3,59,1000,850,150,1.09170305676856,2.27272727272727
2010,York University,york10wA3,60,1000,770,230,1.13765642775882,2.11009174311927
2010,York University,york10wA3,61,1000,742,258,1.18483412322275,2.52941176470588
2010,York University,york10wA3,62,1000,845,155,1.1037527593819,2.54098360655738
2010,York University,york10wA3,63,1000,817,183,1.11856823266219,2.37662337662338
2010,York University,york10wA3,64,1000,748,252,1.17233294255569,2.4
2010,York University,york10wA3,65,1000,787,213,1.14025085518814,2.36666666666667
2010,York University,york10wA3,66,1000,867,133,1.085776330076,2.46296296296296
2010,York University,york10wA3,67,1000,777,223,1.16550116550117,2.75308641975309
2010,York University,york10wA3,68,1000,839,161,1.09649122807018,2.20547945205479
2010,York University,york10wA3,69,1000,885,115,1.06382978723404,2.09090909090909
2010,York University,york10wA3,70,1000,888,112,1.06723585912487,2.28571428571429
2010,York University,york10wA3,71,1000,850,150,1.09529025191676,2.38095238095238
2010,York University,york10wA3,72,1000,711,289,1.31406044678055,5.78
2010,York University,york10wA3,73,1000,881,119,1.06951871657754,2.2037037037037
2010,York University,york10wA3,74,1000,795,205,1.12739571589628,2.22826086956522
2010,York University,york10wA3,75,1000,743,257,1.17096018735363,2.31531531531532
2010,York University,york10wA3,76,1000,873,127,1.07296137339056,2.15254237288136
2010,York University,york10wA3,77,1000,827,173,1.10619469026549,2.24675324675325
2010,York University,york10wA3,78,1000,945,55,1.02986611740474,2.11538461538462
2010,York University,york10wA3,79,1000,821,179,1.11111111111111,2.26582278481013
2010,York University,york10wA3,80,1000,974,26,1.01419878296146,2.16666666666667
2010,York University,york10wA3,81,1000,783,217,1.15207373271889,2.55294117647059
2010,York University,york10wA3,82,1000,821,179,1.11982082866741,2.48611111111111
2010,York University,york10wA3,83,1000,746,254,1.23304562268804,3.90769230769231
2010,York University,york10wA3,84,1000,805,195,1.12739571589628,2.37804878048781
2010,York University,york10wA3,85,1000,802,198,1.12866817155756,2.35714285714286
2010,York University,york10wA3,86,1000,861,139,1.08342361863489,2.24193548387097
2010,York University,york10wA3,87,1000,850,150,1.10253583241455,2.63157894736842
2010,York University,york10wA3,88,1000,804,196,1.13507377979569,2.54545454545455
2010,York University,york10wA3,89,1000,828,172,1.10132158590308,2.15
2010,York University,york10wA3,90,1000,700,300,1.20918984280532,2.36220472440945
2010,York University,york10wA3,91,1000,916,84,1.06044538706257,3.11111111111111
2010,York University,york10wA3,92,1000,852,148,1.08932461873638,2.24242424242424
2010,York University,york10wA3,93,1000,771,229,1.1441647597254,2.22330097087379
2010,York University,york10wA3,94,1000,795,205,1.13507377979569,2.38372093023256
2010,York University,york10wA3,95,1000,921,79,1.04493207941484,2.19444444444444
2010,York University,york10wA3,96,1000,808,192,1.11731843575419,2.20689655172414
2010,York University,york10wA3,97,1000,927,73,1.03950103950104,2.08571428571429
2010,York University,york10wA3,98,1000,722,278,1.30039011703511,5.91489361702128
2010,York University,york10wA3,99,1000,861,139,1.10253583241455,3.02173913043478
2010,York University,york10wA3,100,1000,822,178,1.12739571589628,2.73846153846154
