year,group,sys,topic,n,n_u,n_t,avg,avg_t,p_i
2009,"ICT, Chinese Academy of Sciences",ICTNETADRun3,1,995,903,92,1.05514316012725,2.3,0.000862316349975126
2009,"ICT, Chinese Academy of Sciences",ICTNETADRun3,2,999,973,26,1.01421319796954,2.16666666666667,0.0352252528763421
2009,"ICT, Chinese Academy of Sciences",ICTNETADRun3,3,999,950,49,1.02777777777778,2.22727272727273,0.000411216766219866
2009,"ICT, Chinese Academy of Sciences",ICTNETADRun3,4,996,895,101,1.05844845908608,2.19565217391304,0.133778499597894
2009,"ICT, Chinese Academy of Sciences",ICTNETADRun3,5,999,923,76,1.04279749478079,2.17142857142857,0.0437957807962552
2009,"ICT, Chinese Academy of Sciences",ICTNETADRun3,6,1000,883,117,1.0752688172043,2.48936170212766,0.091851014597219
2009,"ICT, Chinese Academy of Sciences",ICTNETADRun3,7,1000,967,33,1.01936799184506,2.35714285714286,0.20814840441094
2009,"ICT, Chinese Academy of Sciences",ICTNETADRun3,8,998,816,182,1.11259754738016,2.24691358024691,0.00238671426047829
2009,"ICT, Chinese Academy of Sciences",ICTNETADRun3,9,1000,940,60,1.03842159916926,2.60869565217391,0.0158657238023662
2009,"ICT, Chinese Academy of Sciences",ICTNETADRun3,10,1000,953,47,1.02459016393443,2.04347826086957,0.0762848098111042
2009,"ICT, Chinese Academy of Sciences",ICTNETADRun3,11,1000,935,65,1.0351966873706,2.09677419354839,0.0664992955216998
2009,"ICT, Chinese Academy of Sciences",ICTNETADRun3,12,1000,910,90,1.05932203389831,2.64705882352941,0.034778910864831
2009,"ICT, Chinese Academy of Sciences",ICTNETADRun3,13,1000,726,274,1.20481927710843,2.63461538461538,0.235164635989157
2009,"ICT, Chinese Academy of Sciences",ICTNETADRun3,14,998,917,81,1.04284221525601,2.025,0.0265038510861828
2009,"ICT, Chinese Academy of Sciences",ICTNETADRun3,15,998,915,83,1.0461215932914,2.12820512820513,0.125893248921991
2009,"ICT, Chinese Academy of Sciences",ICTNETADRun3,16,999,941,58,1.03095975232198,2.07142857142857,0.0168574558972262
2009,"ICT, Chinese Academy of Sciences",ICTNETADRun3,17,998,955,43,1.02254098360656,2.04761904761905,0.0231064870969662
2009,"ICT, Chinese Academy of Sciences",ICTNETADRun3,18,1000,958,42,1.02145045965271,2,0.0429378299755316
2009,"ICT, Chinese Academy of Sciences",ICTNETADRun3,19,996,903,93,1.05063291139241,2.06666666666667,0.0261548504607092
2009,"ICT, Chinese Academy of Sciences",ICTNETADRun3,20,1000,921,79,1.04275286757039,2.07894736842105,0.00914866499231503
2009,"ICT, Chinese Academy of Sciences",ICTNETADRun3,21,999,928,71,1.04388714733542,2.44827586206897,0.00155756190598153
2009,"ICT, Chinese Academy of Sciences",ICTNETADRun3,22,1000,956,44,1.03199174406605,3.38461538461538,2.93462289256776e-07
2009,"ICT, Chinese Academy of Sciences",ICTNETADRun3,23,1000,828,172,1.12233445566779,2.73015873015873,0.702034211193134
2009,"ICT, Chinese Academy of Sciences",ICTNETADRun3,24,998,897,101,1.05832449628844,2.19565217391304,0.047623523892561
2009,"ICT, Chinese Academy of Sciences",ICTNETADRun3,25,999,830,169,1.10876803551609,2.38028169014085,0.0426841536646699
2009,"ICT, Chinese Academy of Sciences",ICTNETADRun3,26,999,920,79,1.04497907949791,2.19444444444444,0.102061809685813
2009,"ICT, Chinese Academy of Sciences",ICTNETADRun3,27,998,949,49,1.02780638516993,2.22727272727273,0.331704186855091
2009,"ICT, Chinese Academy of Sciences",ICTNETADRun3,28,1000,850,150,1.09409190371991,2.34375,0.0114603894028978
2009,"ICT, Chinese Academy of Sciences",ICTNETADRun3,29,1000,950,50,1.03305785123967,2.77777777777778,2.30581710634224e-09
2009,"ICT, Chinese Academy of Sciences",ICTNETADRun3,30,1000,913,87,1.0482180293501,2.1219512195122,0.0140241006008638
2009,"ICT, Chinese Academy of Sciences",ICTNETADRun3,31,999,866,133,1.09539473684211,2.89130434782609,0.000643173380505894
2009,"ICT, Chinese Academy of Sciences",ICTNETADRun3,32,1000,885,115,1.06837606837607,2.25490196078431,0.341682037687349
2009,"ICT, Chinese Academy of Sciences",ICTNETADRun3,33,997,951,46,1.02466598150051,2.09090909090909,0.00662042991178384
2009,"ICT, Chinese Academy of Sciences",ICTNETADRun3,34,999,962,37,1.02251791197544,2.46666666666667,0.000240051519220901
2009,"ICT, Chinese Academy of Sciences",ICTNETADRun3,35,1000,902,98,1.05820105820106,2.27906976744186,7.25081883820268e-10
2009,"ICT, Chinese Academy of Sciences",ICTNETADRun3,36,1000,938,62,1.0351966873706,2.21428571428571,0.0813672620666628
2009,"ICT, Chinese Academy of Sciences",ICTNETADRun3,37,999,945,54,1.02989690721649,2.16,0.0136424756837608
2009,"ICT, Chinese Academy of Sciences",ICTNETADRun3,38,997,962,35,1.01838610827375,2.05882352941176,1.17955276958297e-05
2009,"ICT, Chinese Academy of Sciences",ICTNETADRun3,39,998,928,70,1.04175365344468,2.33333333333333,0.111605615152475
2009,"ICT, Chinese Academy of Sciences",ICTNETADRun3,40,124,118,6,1.02479338842975,2,0.0996910326419846
2009,"ICT, Chinese Academy of Sciences",ICTNETADRun3,41,999,930,69,1.03630705394191,2.02941176470588,0.00452488801805044
2009,"ICT, Chinese Academy of Sciences",ICTNETADRun3,42,1000,971,29,1.01522842639594,2.07142857142857,0.00212875035360643
2009,"ICT, Chinese Academy of Sciences",ICTNETADRun3,43,999,935,64,1.03309203722854,2,0.00152276860240242
2009,"ICT, Chinese Academy of Sciences",ICTNETADRun3,44,999,913,86,1.05379746835443,2.45714285714286,0.141095895780236
2009,"ICT, Chinese Academy of Sciences",ICTNETADRun3,45,995,947,48,1.02789256198347,2.28571428571429,2.89021464671061e-08
2009,"ICT, Chinese Academy of Sciences",ICTNETADRun3,46,392,371,21,1.02887139107612,2.1,0.0352234663833808
2009,"ICT, Chinese Academy of Sciences",ICTNETADRun3,47,998,920,78,1.04284221525601,2.10810810810811,0.118138568737651
2009,"ICT, Chinese Academy of Sciences",ICTNETADRun3,48,1000,932,68,1.04058272632674,2.3448275862069,0.000380729497060493
2009,"ICT, Chinese Academy of Sciences",ICTNETADRun3,49,999,918,81,1.04716981132075,2.25,0.309521724930004
2009,"ICT, Chinese Academy of Sciences",ICTNETADRun3,50,998,953,45,1.02358974358974,2.04545454545455,6.23045452510784e-06
2009,"ICT, Chinese Academy of Sciences",ICTNETADRun4,1,1000,898,102,1.06951871657754,2.75675675675676,0.29346745029765
2009,"ICT, Chinese Academy of Sciences",ICTNETADRun4,2,1000,967,33,1.0183299389002,2.2,0.0123241089612919
2009,"ICT, Chinese Academy of Sciences",ICTNETADRun4,3,1000,967,33,1.01729399796541,2.0625,0.0604171792618385
2009,"ICT, Chinese Academy of Sciences",ICTNETADRun4,4,1000,857,143,1.085776330076,2.234375,0.352505843398851
2009,"ICT, Chinese Academy of Sciences",ICTNETADRun4,5,1000,917,83,1.04602510460251,2.12820512820513,0.000105370376329291
2009,"ICT, Chinese Academy of Sciences",ICTNETADRun4,6,1000,815,185,1.12107623318386,2.4025974025974,0.0950019149730836
2009,"ICT, Chinese Academy of Sciences",ICTNETADRun4,7,1000,954,46,1.02459016393443,2.09090909090909,0.0284398488718861
2009,"ICT, Chinese Academy of Sciences",ICTNETADRun4,8,1000,820,180,1.10619469026549,2.14285714285714,0.0238422025015006
2009,"ICT, Chinese Academy of Sciences",ICTNETADRun4,9,1000,928,72,1.04275286757039,2.32258064516129,0.0327202141349203
2009,"ICT, Chinese Academy of Sciences",ICTNETADRun4,10,1000,887,113,1.06382978723404,2.13207547169811,0.227664134934867
2009,"ICT, Chinese Academy of Sciences",ICTNETADRun4,11,1000,926,74,1.04058272632674,2.11428571428571,0.100220669983379
2009,"ICT, Chinese Academy of Sciences",ICTNETADRun4,12,1000,798,202,1.15207373271889,2.88571428571429,0.458069686248891
2009,"ICT, Chinese Academy of Sciences",ICTNETADRun4,13,1000,639,361,1.29533678756477,2.71428571428571,0.40146770802201
2009,"ICT, Chinese Academy of Sciences",ICTNETADRun4,14,1000,899,101,1.05374077976818,2.02,0.0449371404015469
2009,"ICT, Chinese Academy of Sciences",ICTNETADRun4,15,1000,919,81,1.05263157894737,2.61290322580645,0.0451662364636651
2009,"ICT, Chinese Academy of Sciences",ICTNETADRun4,16,1000,933,67,1.03626943005181,2.09375,4.74530183315978e-07
2009,"ICT, Chinese Academy of Sciences",ICTNETADRun4,17,1000,952,48,1.02564102564103,2.08695652173913,0.000227343585578394
2009,"ICT, Chinese Academy of Sciences",ICTNETADRun4,18,1000,924,76,1.04275286757039,2.17142857142857,0.132293089954559
2009,"ICT, Chinese Academy of Sciences",ICTNETADRun4,19,1000,923,77,1.04493207941484,2.26470588235294,0.0841460977330037
2009,"ICT, Chinese Academy of Sciences",ICTNETADRun4,20,1000,902,98,1.05374077976818,2.08510638297872,0.00683484952945943
2009,"ICT, Chinese Academy of Sciences",ICTNETADRun4,21,1000,919,81,1.04931794333683,2.38235294117647,0.028970067904604
2009,"ICT, Chinese Academy of Sciences",ICTNETADRun4,22,1000,976,24,1.01214574898785,2,1.01927989196192e-10
2009,"ICT, Chinese Academy of Sciences",ICTNETADRun4,23,1000,810,190,1.13636363636364,2.71428571428571,0.705902111198929
2009,"ICT, Chinese Academy of Sciences",ICTNETADRun4,24,1000,887,113,1.06723585912487,2.26,0.0571803735117261
2009,"ICT, Chinese Academy of Sciences",ICTNETADRun4,25,1000,822,178,1.11482720178372,2.37333333333333,0.0518962085187064
2009,"ICT, Chinese Academy of Sciences",ICTNETADRun4,26,1000,895,105,1.06723585912487,2.5,0.0082287262183482
2009,"ICT, Chinese Academy of Sciences",ICTNETADRun4,27,1000,930,70,1.04058272632674,2.25806451612903,0.569535414812763
2009,"ICT, Chinese Academy of Sciences",ICTNETADRun4,28,1000,760,240,1.16822429906542,2.5,0.027894233674014
2009,"ICT, Chinese Academy of Sciences",ICTNETADRun4,29,1000,945,55,1.03092783505155,2.2,0.00255738399328562
2009,"ICT, Chinese Academy of Sciences",ICTNETADRun4,30,1000,909,91,1.0515247108307,2.16666666666667,0.00373653332939797
2009,"ICT, Chinese Academy of Sciences",ICTNETADRun4,31,1000,854,146,1.10497237569061,2.86274509803922,4.69905293719866e-05
2009,"ICT, Chinese Academy of Sciences",ICTNETADRun4,32,1000,885,115,1.06382978723404,2.09090909090909,0.309546357278011
2009,"ICT, Chinese Academy of Sciences",ICTNETADRun4,33,1000,956,44,1.02459016393443,2.2,0.000383066895366274
2009,"ICT, Chinese Academy of Sciences",ICTNETADRun4,34,1000,980,20,1.01010101010101,2,3.20441637364921e-15
2009,"ICT, Chinese Academy of Sciences",ICTNETADRun4,35,1000,873,127,1.07642626480086,2.26785714285714,8.28872810681872e-08
2009,"ICT, Chinese Academy of Sciences",ICTNETADRun4,36,1000,928,72,1.04058272632674,2.18181818181818,0.16360311736187
2009,"ICT, Chinese Academy of Sciences",ICTNETADRun4,37,1000,927,73,1.04275286757039,2.28125,0.0256670245321921
2009,"ICT, Chinese Academy of Sciences",ICTNETADRun4,38,1000,932,68,1.04602510460251,2.83333333333333,0.00934373558485055
2009,"ICT, Chinese Academy of Sciences",ICTNETADRun4,39,1000,909,91,1.05485232067511,2.33333333333333,0.0603824079818725
2009,"ICT, Chinese Academy of Sciences",ICTNETADRun4,40,124,116,8,1.03333333333333,2,0.0819115251324035
2009,"ICT, Chinese Academy of Sciences",ICTNETADRun4,41,1000,908,92,1.0515247108307,2.13953488372093,0.00977190661487714
2009,"ICT, Chinese Academy of Sciences",ICTNETADRun4,42,1000,898,102,1.06382978723404,2.42857142857143,0.156253734029584
2009,"ICT, Chinese Academy of Sciences",ICTNETADRun4,43,1000,936,64,1.03734439834025,2.28571428571429,0.118634400533511
2009,"ICT, Chinese Academy of Sciences",ICTNETADRun4,44,1000,755,245,1.17647058823529,2.57894736842105,0.0319403318974475
2009,"ICT, Chinese Academy of Sciences",ICTNETADRun4,45,1000,910,90,1.05596620908131,2.43243243243243,3.56782912962515e-08
2009,"ICT, Chinese Academy of Sciences",ICTNETADRun4,46,392,366,26,1.03703703703704,2.16666666666667,0.0596284650951384
2009,"ICT, Chinese Academy of Sciences",ICTNETADRun4,47,1000,905,95,1.05374077976818,2.15909090909091,0.1008210744402
2009,"ICT, Chinese Academy of Sciences",ICTNETADRun4,48,1000,925,75,1.04493207941484,2.34375,0.0095652676644453
2009,"ICT, Chinese Academy of Sciences",ICTNETADRun4,49,1000,910,90,1.05042016806723,2.14285714285714,0.16448686853785
2009,"ICT, Chinese Academy of Sciences",ICTNETADRun4,50,1000,944,56,1.03199174406605,2.24,0.000358164075012326
2009,"ICT, Chinese Academy of Sciences",ICTNETADRun5,1,1000,939,61,1.03305785123967,2.10344827586207,0.151045447424215
2009,"ICT, Chinese Academy of Sciences",ICTNETADRun5,2,1000,978,22,1.01214574898785,2.2,0.0536616453192225
2009,"ICT, Chinese Academy of Sciences",ICTNETADRun5,3,1000,943,57,1.03092783505155,2.11111111111111,2.7235717721794e-05
2009,"ICT, Chinese Academy of Sciences",ICTNETADRun5,4,1000,872,128,1.0752688172043,2.20689655172414,0.179456270288571
2009,"ICT, Chinese Academy of Sciences",ICTNETADRun5,5,1000,923,77,1.04275286757039,2.13888888888889,1.56052155236046e-07
2009,"ICT, Chinese Academy of Sciences",ICTNETADRun5,6,1000,854,146,1.09409190371991,2.43333333333333,0.0950019831448851
2009,"ICT, Chinese Academy of Sciences",ICTNETADRun5,7,1000,949,51,1.02774922918808,2.125,0.0803540817559727
2009,"ICT, Chinese Academy of Sciences",ICTNETADRun5,8,1000,847,153,1.08932461873638,2.15492957746479,0.0193146314154071
2009,"ICT, Chinese Academy of Sciences",ICTNETADRun5,9,1000,950,50,1.02880658436214,2.27272727272727,0.0581859849763378
2009,"ICT, Chinese Academy of Sciences",ICTNETADRun5,10,1000,920,80,1.04493207941484,2.16216216216216,0.22430969742652
2009,"ICT, Chinese Academy of Sciences",ICTNETADRun5,11,1000,931,69,1.03734439834025,2.09090909090909,0.023100847167134
2009,"ICT, Chinese Academy of Sciences",ICTNETADRun5,12,1000,798,202,1.15207373271889,2.88571428571429,0.411631080891702
2009,"ICT, Chinese Academy of Sciences",ICTNETADRun5,13,1000,662,338,1.27388535031847,2.7479674796748,0.398962476330736
2009,"ICT, Chinese Academy of Sciences",ICTNETADRun5,14,1000,951,49,1.02564102564103,2.04166666666667,2.6106862527179e-13
2009,"ICT, Chinese Academy of Sciences",ICTNETADRun5,15,1000,949,51,1.02986611740474,2.31818181818182,0.00157036185088272
2009,"ICT, Chinese Academy of Sciences",ICTNETADRun5,16,1000,948,52,1.02669404517454,2,2.43730439852484e-06
2009,"ICT, Chinese Academy of Sciences",ICTNETADRun5,17,1000,967,33,1.01936799184506,2.35714285714286,0.000165478358679017
2009,"ICT, Chinese Academy of Sciences",ICTNETADRun5,18,1000,825,175,1.11856823266219,2.53623188405797,0.135406774006481
2009,"ICT, Chinese Academy of Sciences",ICTNETADRun5,19,1000,963,37,1.02040816326531,2.17647058823529,3.84152014411719e-19
2009,"ICT, Chinese Academy of Sciences",ICTNETADRun5,20,1000,915,85,1.04712041884817,2.125,0.00682715735870946
2009,"ICT, Chinese Academy of Sciences",ICTNETADRun5,21,1000,929,71,1.04384133611691,2.44827586206897,0.0245805793439798
2009,"ICT, Chinese Academy of Sciences",ICTNETADRun5,22,1000,980,20,1.01010101010101,2,6.41140270912648e-11
2009,"ICT, Chinese Academy of Sciences",ICTNETADRun5,23,1000,830,170,1.12233445566779,2.78688524590164,0.77695846684008
2009,"ICT, Chinese Academy of Sciences",ICTNETADRun5,24,1000,904,96,1.05485232067511,2.18181818181818,0.0463090695209799
2009,"ICT, Chinese Academy of Sciences",ICTNETADRun5,25,1000,844,156,1.09769484083425,2.32835820895522,0.0126854359090086
2009,"ICT, Chinese Academy of Sciences",ICTNETADRun5,26,1000,931,69,1.03734439834025,2.09090909090909,0.00696949285631563
2009,"ICT, Chinese Academy of Sciences",ICTNETADRun5,27,1000,939,61,1.0351966873706,2.25925925925926,0.569534936472017
2009,"ICT, Chinese Academy of Sciences",ICTNETADRun5,28,1000,789,211,1.1454753722795,2.51190476190476,0.0194529301021841
2009,"ICT, Chinese Academy of Sciences",ICTNETADRun5,29,1000,919,81,1.04712041884817,2.25,0.00179309080895293
2009,"ICT, Chinese Academy of Sciences",ICTNETADRun5,30,1000,908,92,1.05042016806723,2.09090909090909,0.00807639108424656
2009,"ICT, Chinese Academy of Sciences",ICTNETADRun5,31,1000,873,127,1.08932461873638,2.82222222222222,4.62322433969797e-05
2009,"ICT, Chinese Academy of Sciences",ICTNETADRun5,32,1000,907,93,1.0515247108307,2.11363636363636,0.207353242788186
2009,"ICT, Chinese Academy of Sciences",ICTNETADRun5,33,1000,963,37,1.02040816326531,2.17647058823529,4.96999845066082e-07
2009,"ICT, Chinese Academy of Sciences",ICTNETADRun5,34,1000,988,12,1.00603621730382,2,3.75048348165781e-33
2009,"ICT, Chinese Academy of Sciences",ICTNETADRun5,35,1000,885,115,1.06951871657754,2.3,8.28872809171149e-08
2009,"ICT, Chinese Academy of Sciences",ICTNETADRun5,36,1000,934,66,1.03734439834025,2.2,0.163603117329175
2009,"ICT, Chinese Academy of Sciences",ICTNETADRun5,37,1000,924,76,1.04493207941484,2.3030303030303,0.0207943121015917
2009,"ICT, Chinese Academy of Sciences",ICTNETADRun5,38,1000,940,60,1.04166666666667,3,0.000507424840714434
2009,"ICT, Chinese Academy of Sciences",ICTNETADRun5,39,1000,915,85,1.0515247108307,2.36111111111111,0.0053981887866108
2009,"ICT, Chinese Academy of Sciences",ICTNETADRun5,40,126,118,8,1.0327868852459,2,0.0819114921584874
2009,"ICT, Chinese Academy of Sciences",ICTNETADRun5,41,1000,951,49,1.02669404517454,2.1304347826087,0.00123326057326278
2009,"ICT, Chinese Academy of Sciences",ICTNETADRun5,42,1000,916,84,1.0515247108307,2.4,0.172021336776494
2009,"ICT, Chinese Academy of Sciences",ICTNETADRun5,43,1000,958,42,1.02354145342886,2.21052631578947,0.109136960714972
2009,"ICT, Chinese Academy of Sciences",ICTNETADRun5,44,1000,820,180,1.11111111111111,2.25,0.0257056176450532
2009,"ICT, Chinese Academy of Sciences",ICTNETADRun5,45,1000,922,78,1.04602510460251,2.29411764705882,2.17242562600624e-06
2009,"ICT, Chinese Academy of Sciences",ICTNETADRun5,46,392,366,26,1.03703703703704,2.16666666666667,2.89862773424388e-05
2009,"ICT, Chinese Academy of Sciences",ICTNETADRun5,47,1000,923,77,1.04275286757039,2.13888888888889,0.0483121734023949
2009,"ICT, Chinese Academy of Sciences",ICTNETADRun5,48,1000,935,65,1.03734439834025,2.24137931034483,0.0033350919840181
2009,"ICT, Chinese Academy of Sciences",ICTNETADRun5,49,1000,931,69,1.03734439834025,2.09090909090909,0.203151624960076
2009,"ICT, Chinese Academy of Sciences",ICTNETADRun5,50,1000,939,61,1.03412616339193,2.17857142857143,0.000668041475200153
2009,Information retrieval lab,IE09,1,1000,629,371,1.37741046831956,3.82474226804124,0.251416916560477
2009,Information retrieval lab,IE09,2,1000,933,67,1.03950103950104,2.31034482758621,0.0838822045725649
2009,Information retrieval lab,IE09,3,1000,850,150,1.1001100110011,2.54237288135593,0.00504684569158924
2009,Information retrieval lab,IE09,4,1000,816,184,1.14678899082569,3.28571428571429,0.189605086062356
2009,Information retrieval lab,IE09,5,1000,789,211,1.13378684807256,2.26881720430108,0.0229628004201933
2009,Information retrieval lab,IE09,6,1000,342,658,2.23214285714286,6.20754716981132,0.00804671579750906
2009,Information retrieval lab,IE09,7,1000,905,95,1.06496272630458,2.79411764705882,0.000361336883969714
2009,Information retrieval lab,IE09,8,1000,756,244,1.18764845605701,2.83720930232558,0.0916553496850632
2009,Information retrieval lab,IE09,9,1000,791,209,1.16279069767442,3.02898550724638,0.00127661666547336
2009,Information retrieval lab,IE09,10,1000,820,180,1.15874855156431,4.18604651162791,0.0111948444455152
2009,Information retrieval lab,IE09,11,1000,884,116,1.06837606837607,2.23076923076923,0.0337282869624279
2009,Information retrieval lab,IE09,12,1000,667,333,1.27226463104326,2.79831932773109,0.00666229179269637
2009,Information retrieval lab,IE09,13,1000,590,410,1.45985401459854,4.31578947368421,0.565709509435399
2009,Information retrieval lab,IE09,14,1000,793,207,1.14285714285714,2.52439024390244,0.112244783392238
2009,Information retrieval lab,IE09,15,1000,787,213,1.14678899082569,2.50588235294118,0.00101742566843877
2009,Information retrieval lab,IE09,16,1000,784,216,1.15074798619102,2.54117647058824,0.186608098701038
2009,Information retrieval lab,IE09,17,1000,962,38,1.02040816326531,2.11111111111111,0.00199370287112236
2009,Information retrieval lab,IE09,18,1000,879,121,1.08108108108108,2.6304347826087,6.03076848528649e-05
2009,Information retrieval lab,IE09,19,1000,733,267,1.21951219512195,3.06896551724138,0.0576908949089258
2009,Information retrieval lab,IE09,20,1000,834,166,1.12359550561798,2.96428571428571,0.19603720813065
2009,Information retrieval lab,IE09,21,1000,854,146,1.10619469026549,2.92,0.00926363183470224
2009,Information retrieval lab,IE09,22,1000,889,111,1.07642626480086,2.775,0.00596490697314471
2009,Information retrieval lab,IE09,23,1000,815,185,1.14025085518814,2.98387096774194,0.0931466645756311
2009,Information retrieval lab,IE09,24,1000,812,188,1.13122171945701,2.61111111111111,0.054286572739457
2009,Information retrieval lab,IE09,25,1000,625,375,1.3262599469496,2.90697674418605,0.0103700599775301
2009,Information retrieval lab,IE09,26,1000,887,113,1.07296137339056,2.51111111111111,0.0136641312823013
2009,Information retrieval lab,IE09,27,1000,681,319,1.35869565217391,5.8,0.0339708638212669
2009,Information retrieval lab,IE09,28,1000,593,407,1.45985401459854,4.42391304347826,0.0672160553009604
2009,Information retrieval lab,IE09,29,1000,800,200,1.14155251141553,2.63157894736842,0.0139095662638599
2009,Information retrieval lab,IE09,30,1000,880,120,1.07066381156317,2.22222222222222,0.132888376509274
2009,Information retrieval lab,IE09,31,1000,719,281,1.23609394313968,3.12222222222222,0.227096077684643
2009,Information retrieval lab,IE09,32,1000,859,141,1.07991360691145,2.1044776119403,0.0953699489962752
2009,Information retrieval lab,IE09,33,1000,948,52,1.02986611740474,2.26086956521739,4.61224015712864e-05
2009,Information retrieval lab,IE09,34,1000,850,150,1.10741971207087,2.83018867924528,0.286732181309235
2009,Information retrieval lab,IE09,35,1000,719,281,1.20772946859903,2.57798165137615,0.0013725821216654
2009,Information retrieval lab,IE09,36,1000,902,98,1.07411385606874,3.37931034482759,0.15567897750879
2009,Information retrieval lab,IE09,37,1000,806,194,1.13895216400911,2.69444444444444,0.0974745406346931
2009,Information retrieval lab,IE09,38,1000,837,163,1.11234705228031,2.62903225806452,0.154993670270072
2009,Information retrieval lab,IE09,39,1000,892,108,1.07066381156317,2.57142857142857,0.0736109348924215
2009,Information retrieval lab,IE09,40,1000,718,282,1.20481927710843,2.51785714285714,0.427314028088949
2009,Information retrieval lab,IE09,41,1000,833,167,1.09769484083425,2.14102564102564,0.0623159240670474
2009,Information retrieval lab,IE09,42,1000,900,100,1.06382978723404,2.5,0.280067316741296
2009,Information retrieval lab,IE09,43,1000,851,149,1.10987791342952,2.98,0.0303301112471139
2009,Information retrieval lab,IE09,44,1000,588,412,1.53139356814701,6.33846153846154,0.00834122687303665
2009,Information retrieval lab,IE09,45,1000,831,169,1.12233445566779,2.81666666666667,0.0424955548597818
2009,Information retrieval lab,IE09,46,1000,711,289,1.26582278481013,3.65822784810127,0.0108803821495269
2009,Information retrieval lab,IE09,47,1000,705,295,1.2987012987013,4.53846153846154,0.0385282725729246
2009,Information retrieval lab,IE09,48,1000,875,125,1.07991360691145,2.45098039215686,0.0012414136214991
2009,Information retrieval lab,IE09,49,1000,839,161,1.10132158590308,2.33333333333333,0.0198353770554813
2009,Information retrieval lab,IE09,50,1000,912,88,1.05708245243129,2.58823529411765,0.0734813960479339
2009,Microsoft Research Cambridge,MS1,1,1000,971,29,1.01936799184506,2.9,0.000283929575062468
2009,Microsoft Research Cambridge,MS1,2,1000,987,13,1.00704934541793,2.16666666666667,0.00110790228829417
2009,Microsoft Research Cambridge,MS1,3,1000,970,30,1.01729399796541,2.30769230769231,4.27157583914886e-10
2009,Microsoft Research Cambridge,MS1,4,1000,996,4,1.00200400801603,2,5.92560976525314e-23
2009,Microsoft Research Cambridge,MS1,5,1000,980,20,1.01010101010101,2,2.33601953638579e-15
2009,Microsoft Research Cambridge,MS1,6,1000,979,21,1.01112234580384,2.1,1.42430872952236e-05
2009,Microsoft Research Cambridge,MS1,7,1000,989,11,1.00603621730382,2.2,1.48285866641748e-26
2009,Microsoft Research Cambridge,MS1,8,1000,984,16,1.00806451612903,2,0.000642464463569505
2009,Microsoft Research Cambridge,MS1,9,1000,868,132,1.09170305676856,2.75,2.58604034261574e-13
2009,Microsoft Research Cambridge,MS1,10,1000,994,6,1.00300902708124,2,8.89402946372194e-24
2009,Microsoft Research Cambridge,MS1,11,1000,919,81,1.05374077976818,2.7,0.0257415728707112
2009,Microsoft Research Cambridge,MS1,12,1000,991,9,1.00502512562814,2.25,2.72389744210187e-26
2009,Microsoft Research Cambridge,MS1,13,1000,1000,0,1,,0
2009,Microsoft Research Cambridge,MS1,14,1000,994,6,1.00300902708124,2,7.44404288922034e-15
2009,Microsoft Research Cambridge,MS1,15,1000,998,2,1.001001001001,2,8.49383519838397e-27
2009,Microsoft Research Cambridge,MS1,16,1000,964,36,1.02040816326531,2.25,8.78918195679873e-12
2009,Microsoft Research Cambridge,MS1,17,1000,994,6,1.00300902708124,2,2.32640219553113e-29
2009,Microsoft Research Cambridge,MS1,18,1000,986,14,1.00704934541793,2,3.74986418029091e-21
2009,Microsoft Research Cambridge,MS1,19,1000,996,4,1.00200400801603,2,1.06703744355534e-18
2009,Microsoft Research Cambridge,MS1,20,1000,1000,0,1,,0
2009,Microsoft Research Cambridge,MS1,21,1000,991,9,1.00502512562814,2.25,4.99978270847918e-05
2009,Microsoft Research Cambridge,MS1,22,1000,998,2,1.001001001001,2,1.90564525834121e-42
2009,Microsoft Research Cambridge,MS1,23,1000,998,2,1.001001001001,2,1.80331276369366e-25
2009,Microsoft Research Cambridge,MS1,24,1000,998,2,1.001001001001,2,1.21250213412174e-44
2009,Microsoft Research Cambridge,MS1,25,1000,855,145,1.08342361863489,2.13235294117647,9.25343184998483e-07
2009,Microsoft Research Cambridge,MS1,26,1000,992,8,1.00401606425703,2,8.38175753982286e-21
2009,Microsoft Research Cambridge,MS1,27,1000,1000,0,1,,0
2009,Microsoft Research Cambridge,MS1,28,1000,936,64,1.05932203389831,8,7.03691356258226e-19
2009,Microsoft Research Cambridge,MS1,29,1000,927,73,1.04166666666667,2.21212121212121,1.04887118323599e-08
2009,Microsoft Research Cambridge,MS1,30,1000,990,10,1.00502512562814,2,2.04308036982856e-10
2009,Microsoft Research Cambridge,MS1,31,1000,982,18,1.00908173562059,2,4.8941381881177e-08
2009,Microsoft Research Cambridge,MS1,32,1000,1000,0,1,,0
2009,Microsoft Research Cambridge,MS1,33,1000,998,2,1.001001001001,2,3.94791567216798e-22
2009,Microsoft Research Cambridge,MS1,34,1000,1000,0,1,,0
2009,Microsoft Research Cambridge,MS1,35,1000,986,14,1.00704934541793,2,5.41552218428126e-22
2009,Microsoft Research Cambridge,MS1,36,1000,1000,0,1,,0
2009,Microsoft Research Cambridge,MS1,37,1000,998,2,1.001001001001,2,0.0285179807064298
2009,Microsoft Research Cambridge,MS1,38,1000,988,12,1.00704934541793,2.4,3.25399969515266e-14
2009,Microsoft Research Cambridge,MS1,39,1000,966,34,1.02774922918808,4.85714285714286,8.5816913115031e-30
2009,Microsoft Research Cambridge,MS1,40,1000,679,321,1.26103404791929,2.81578947368421,0.000279467271738186
2009,Microsoft Research Cambridge,MS1,41,1000,982,18,1.00908173562059,2,9.3063035516331e-07
2009,Microsoft Research Cambridge,MS1,42,1000,962,38,1.02774922918808,3.45454545454545,1.89612469336925e-08
2009,Microsoft Research Cambridge,MS1,43,1000,973,27,1.02145045965271,4.5,3.59321383694979e-35
2009,Microsoft Research Cambridge,MS1,44,1000,940,60,1.05485232067511,7.5,3.20398018422049e-19
2009,Microsoft Research Cambridge,MS1,45,1000,998,2,1.001001001001,2,2.51193455701356e-24
2009,Microsoft Research Cambridge,MS1,46,1000,998,2,1.001001001001,2,9.25559658132909e-42
2009,Microsoft Research Cambridge,MS1,47,1000,950,50,1.04493207941484,7.14285714285714,1.56522029423374e-12
2009,Microsoft Research Cambridge,MS1,48,1000,917,83,1.05263157894737,2.51515151515152,0.00994603779296066
2009,Microsoft Research Cambridge,MS1,49,1000,970,30,1.01626016260163,2.14285714285714,5.30703303726021e-15
2009,Microsoft Research Cambridge,MS1,50,1000,941,59,1.03412616339193,2.26923076923077,8.1943103080978e-12
2009,Microsoft Research Cambridge,MS2,1,1000,986,14,1.00908173562059,2.8,1.81115272393139e-07
2009,Microsoft Research Cambridge,MS2,2,1000,989,11,1.00603621730382,2.2,0.000384979409661608
2009,Microsoft Research Cambridge,MS2,3,1000,978,22,1.01317122593718,2.44444444444444,4.47283918910677e-07
2009,Microsoft Research Cambridge,MS2,4,1000,1000,0,1,,0
2009,Microsoft Research Cambridge,MS2,5,1000,990,10,1.00502512562814,2,7.76267014144765e-26
2009,Microsoft Research Cambridge,MS2,6,1000,988,12,1.00603621730382,2,0.153937359862985
2009,Microsoft Research Cambridge,MS2,7,1000,1000,0,1,,0
2009,Microsoft Research Cambridge,MS2,8,1000,996,4,1.00200400801603,2,9.64304693507191e-05
2009,Microsoft Research Cambridge,MS2,9,1000,927,73,1.0515247108307,3.04166666666667,8.77678612203773e-18
2009,Microsoft Research Cambridge,MS2,10,1000,1000,0,1,,0
2009,Microsoft Research Cambridge,MS2,11,1000,943,57,1.03412616339193,2.375,8.56401237099515e-05
2009,Microsoft Research Cambridge,MS2,12,1000,998,2,1.001001001001,2,7.61297192499574e-41
2009,Microsoft Research Cambridge,MS2,13,1000,1000,0,1,,0
2009,Microsoft Research Cambridge,MS2,14,1000,1000,0,1,,0
2009,Microsoft Research Cambridge,MS2,15,1000,1000,0,1,,0
2009,Microsoft Research Cambridge,MS2,16,1000,972,28,1.01626016260163,2.33333333333333,1.88791688850359e-19
2009,Microsoft Research Cambridge,MS2,17,1000,998,2,1.001001001001,2,2.44103941378878e-19
2009,Microsoft Research Cambridge,MS2,18,1000,990,10,1.00502512562814,2,5.7958322815045e-33
2009,Microsoft Research Cambridge,MS2,19,1000,998,2,1.001001001001,2,1.57717555473192e-20
2009,Microsoft Research Cambridge,MS2,20,1000,998,2,1.001001001001,2,4.70718375673333e-38
2009,Microsoft Research Cambridge,MS2,21,1000,991,9,1.00502512562814,2.25,4.01724867003893e-14
2009,Microsoft Research Cambridge,MS2,22,1000,998,2,1.001001001001,2,7.55916210837878e-14
2009,Microsoft Research Cambridge,MS2,23,1000,996,4,1.00200400801603,2,9.15233137837487e-29
2009,Microsoft Research Cambridge,MS2,24,1000,1000,0,1,,0
2009,Microsoft Research Cambridge,MS2,25,1000,978,22,1.01112234580384,2,1.72604635614249e-10
2009,Microsoft Research Cambridge,MS2,26,1000,998,2,1.001001001001,2,2.87209856546103e-29
2009,Microsoft Research Cambridge,MS2,27,1000,997,3,1.00200400801603,3,6.8742584756263e-09
2009,Microsoft Research Cambridge,MS2,28,1000,980,20,1.01626016260163,5,0.124668997413013
2009,Microsoft Research Cambridge,MS2,29,1000,991,9,1.00502512562814,2.25,9.5441287361602e-40
2009,Microsoft Research Cambridge,MS2,30,1000,996,4,1.00200400801603,2,1.83877233284571e-10
2009,Microsoft Research Cambridge,MS2,31,1000,988,12,1.00603621730382,2,0.102127873631097
2009,Microsoft Research Cambridge,MS2,32,1000,1000,0,1,,0
2009,Microsoft Research Cambridge,MS2,33,1000,998,2,1.001001001001,2,1.0551324477833e-05
2009,Microsoft Research Cambridge,MS2,34,1000,1000,0,1,,0
2009,Microsoft Research Cambridge,MS2,35,1000,1000,0,1,,0
2009,Microsoft Research Cambridge,MS2,36,1000,1000,0,1,,0
2009,Microsoft Research Cambridge,MS2,37,1000,987,13,1.00806451612903,2.6,2.01607944444482e-05
2009,Microsoft Research Cambridge,MS2,38,1000,994,6,1.00300902708124,2,9.0129496324972e-30
2009,Microsoft Research Cambridge,MS2,39,1000,985,15,1.01112234580384,3.75,2.37704453564918e-07
2009,Microsoft Research Cambridge,MS2,40,1000,713,287,1.22699386503067,2.81372549019608,4.02591018900919e-05
2009,Microsoft Research Cambridge,MS2,41,1000,984,16,1.00806451612903,2,7.01156482783744e-11
2009,Microsoft Research Cambridge,MS2,42,1000,1000,0,1,,0
2009,Microsoft Research Cambridge,MS2,43,1000,985,15,1.00806451612903,2.14285714285714,3.35990160360135e-10
2009,Microsoft Research Cambridge,MS2,44,1000,973,27,1.02459016393443,9,0.0492915105805656
2009,Microsoft Research Cambridge,MS2,45,1000,998,2,1.001001001001,2,3.7205295134717e-19
2009,Microsoft Research Cambridge,MS2,46,1000,998,2,1.001001001001,2,1.23125300659591e-43
2009,Microsoft Research Cambridge,MS2,47,1000,984,16,1.01010101010101,2.66666666666667,9.84183579040431e-14
2009,Microsoft Research Cambridge,MS2,48,1000,929,71,1.04602510460251,2.62962962962963,1.28287165170868e-06
2009,Microsoft Research Cambridge,MS2,49,1000,979,21,1.01112234580384,2.1,2.3006604141805e-16
2009,Microsoft Research Cambridge,MS2,50,1000,943,57,1.03305785123967,2.28,1.40276391145143e-11
2009,Microsoft Research Asia,MSRAAF,1,993,993,0,1,,0
2009,Microsoft Research Asia,MSRAAF,2,1000,1000,0,1,,0
2009,Microsoft Research Asia,MSRAAF,3,1000,1000,0,1,,0
2009,Microsoft Research Asia,MSRAAF,4,998,998,0,1,,0
2009,Microsoft Research Asia,MSRAAF,5,999,999,0,1,,0
2009,Microsoft Research Asia,MSRAAF,6,999,999,0,1,,0
2009,Microsoft Research Asia,MSRAAF,7,1000,1000,0,1,,0
2009,Microsoft Research Asia,MSRAAF,8,1000,1000,0,1,,0
2009,Microsoft Research Asia,MSRAAF,9,1000,1000,0,1,,0
2009,Microsoft Research Asia,MSRAAF,10,1000,1000,0,1,,0
2009,Microsoft Research Asia,MSRAAF,11,1000,1000,0,1,,0
2009,Microsoft Research Asia,MSRAAF,12,1000,1000,0,1,,0
2009,Microsoft Research Asia,MSRAAF,13,998,998,0,1,,0
2009,Microsoft Research Asia,MSRAAF,14,1000,1000,0,1,,0
2009,Microsoft Research Asia,MSRAAF,15,998,998,0,1,,0
2009,Microsoft Research Asia,MSRAAF,16,1000,1000,0,1,,0
2009,Microsoft Research Asia,MSRAAF,17,1000,1000,0,1,,0
2009,Microsoft Research Asia,MSRAAF,18,1000,1000,0,1,,0
2009,Microsoft Research Asia,MSRAAF,19,1000,1000,0,1,,0
2009,Microsoft Research Asia,MSRAAF,20,1000,1000,0,1,,0
2009,Microsoft Research Asia,MSRAAF,21,999,999,0,1,,0
2009,Microsoft Research Asia,MSRAAF,22,1000,1000,0,1,,0
2009,Microsoft Research Asia,MSRAAF,23,1000,1000,0,1,,0
2009,Microsoft Research Asia,MSRAAF,24,998,998,0,1,,0
2009,Microsoft Research Asia,MSRAAF,25,1000,1000,0,1,,0
2009,Microsoft Research Asia,MSRAAF,26,996,996,0,1,,0
2009,Microsoft Research Asia,MSRAAF,27,998,998,0,1,,0
2009,Microsoft Research Asia,MSRAAF,28,1000,1000,0,1,,0
2009,Microsoft Research Asia,MSRAAF,29,1000,1000,0,1,,0
2009,Microsoft Research Asia,MSRAAF,30,999,999,0,1,,0
2009,Microsoft Research Asia,MSRAAF,31,1000,1000,0,1,,0
2009,Microsoft Research Asia,MSRAAF,32,1000,1000,0,1,,0
2009,Microsoft Research Asia,MSRAAF,33,1000,1000,0,1,,0
2009,Microsoft Research Asia,MSRAAF,34,1000,1000,0,1,,0
2009,Microsoft Research Asia,MSRAAF,35,999,999,0,1,,0
2009,Microsoft Research Asia,MSRAAF,36,998,998,0,1,,0
2009,Microsoft Research Asia,MSRAAF,37,997,997,0,1,,0
2009,Microsoft Research Asia,MSRAAF,38,999,999,0,1,,0
2009,Microsoft Research Asia,MSRAAF,39,1000,1000,0,1,,0
2009,Microsoft Research Asia,MSRAAF,40,1000,1000,0,1,,0
2009,Microsoft Research Asia,MSRAAF,41,1000,1000,0,1,,0
2009,Microsoft Research Asia,MSRAAF,42,999,999,0,1,,0
2009,Microsoft Research Asia,MSRAAF,43,997,997,0,1,,0
2009,Microsoft Research Asia,MSRAAF,44,1000,1000,0,1,,0
2009,Microsoft Research Asia,MSRAAF,45,999,999,0,1,,0
2009,Microsoft Research Asia,MSRAAF,46,999,999,0,1,,0
2009,Microsoft Research Asia,MSRAAF,47,1000,1000,0,1,,0
2009,Microsoft Research Asia,MSRAAF,48,1000,1000,0,1,,0
2009,Microsoft Research Asia,MSRAAF,49,999,999,0,1,,0
2009,Microsoft Research Asia,MSRAAF,50,1000,1000,0,1,,0
2009,Microsoft Research Asia,MSRAC,1,993,993,0,1,,0
2009,Microsoft Research Asia,MSRAC,2,1000,1000,0,1,,0
2009,Microsoft Research Asia,MSRAC,3,1000,1000,0,1,,0
2009,Microsoft Research Asia,MSRAC,4,998,998,0,1,,0
2009,Microsoft Research Asia,MSRAC,5,999,999,0,1,,0
2009,Microsoft Research Asia,MSRAC,6,999,999,0,1,,0
2009,Microsoft Research Asia,MSRAC,7,1000,1000,0,1,,0
2009,Microsoft Research Asia,MSRAC,8,1000,1000,0,1,,0
2009,Microsoft Research Asia,MSRAC,9,1000,1000,0,1,,0
2009,Microsoft Research Asia,MSRAC,10,1000,1000,0,1,,0
2009,Microsoft Research Asia,MSRAC,11,1000,1000,0,1,,0
2009,Microsoft Research Asia,MSRAC,12,1000,1000,0,1,,0
2009,Microsoft Research Asia,MSRAC,13,998,998,0,1,,0
2009,Microsoft Research Asia,MSRAC,14,1000,1000,0,1,,0
2009,Microsoft Research Asia,MSRAC,15,998,998,0,1,,0
2009,Microsoft Research Asia,MSRAC,16,1000,1000,0,1,,0
2009,Microsoft Research Asia,MSRAC,17,1000,1000,0,1,,0
2009,Microsoft Research Asia,MSRAC,18,1000,1000,0,1,,0
2009,Microsoft Research Asia,MSRAC,19,1000,1000,0,1,,0
2009,Microsoft Research Asia,MSRAC,20,1000,1000,0,1,,0
2009,Microsoft Research Asia,MSRAC,21,999,999,0,1,,0
2009,Microsoft Research Asia,MSRAC,22,1000,1000,0,1,,0
2009,Microsoft Research Asia,MSRAC,23,1000,1000,0,1,,0
2009,Microsoft Research Asia,MSRAC,24,998,998,0,1,,0
2009,Microsoft Research Asia,MSRAC,25,1000,1000,0,1,,0
2009,Microsoft Research Asia,MSRAC,26,996,996,0,1,,0
2009,Microsoft Research Asia,MSRAC,27,998,998,0,1,,0
2009,Microsoft Research Asia,MSRAC,28,1000,1000,0,1,,0
2009,Microsoft Research Asia,MSRAC,29,1000,1000,0,1,,0
2009,Microsoft Research Asia,MSRAC,30,999,999,0,1,,0
2009,Microsoft Research Asia,MSRAC,31,1000,1000,0,1,,0
2009,Microsoft Research Asia,MSRAC,32,1000,1000,0,1,,0
2009,Microsoft Research Asia,MSRAC,33,1000,1000,0,1,,0
2009,Microsoft Research Asia,MSRAC,34,1000,1000,0,1,,0
2009,Microsoft Research Asia,MSRAC,35,999,999,0,1,,0
2009,Microsoft Research Asia,MSRAC,36,998,998,0,1,,0
2009,Microsoft Research Asia,MSRAC,37,997,997,0,1,,0
2009,Microsoft Research Asia,MSRAC,38,999,999,0,1,,0
2009,Microsoft Research Asia,MSRAC,39,1000,1000,0,1,,0
2009,Microsoft Research Asia,MSRAC,40,1000,1000,0,1,,0
2009,Microsoft Research Asia,MSRAC,41,1000,1000,0,1,,0
2009,Microsoft Research Asia,MSRAC,42,999,999,0,1,,0
2009,Microsoft Research Asia,MSRAC,43,997,997,0,1,,0
2009,Microsoft Research Asia,MSRAC,44,1000,1000,0,1,,0
2009,Microsoft Research Asia,MSRAC,45,999,999,0,1,,0
2009,Microsoft Research Asia,MSRAC,46,999,999,0,1,,0
2009,Microsoft Research Asia,MSRAC,47,1000,1000,0,1,,0
2009,Microsoft Research Asia,MSRAC,48,1000,1000,0,1,,0
2009,Microsoft Research Asia,MSRAC,49,999,999,0,1,,0
2009,Microsoft Research Asia,MSRAC,50,1000,1000,0,1,,0
2009,Microsoft Research Asia,MSRANORM,1,1000,1000,0,1,,0
2009,Microsoft Research Asia,MSRANORM,2,1000,1000,0,1,,0
2009,Microsoft Research Asia,MSRANORM,3,1000,1000,0,1,,0
2009,Microsoft Research Asia,MSRANORM,4,1000,1000,0,1,,0
2009,Microsoft Research Asia,MSRANORM,5,1000,1000,0,1,,0
2009,Microsoft Research Asia,MSRANORM,6,1000,1000,0,1,,0
2009,Microsoft Research Asia,MSRANORM,7,1000,1000,0,1,,0
2009,Microsoft Research Asia,MSRANORM,8,1000,1000,0,1,,0
2009,Microsoft Research Asia,MSRANORM,9,1000,1000,0,1,,0
2009,Microsoft Research Asia,MSRANORM,10,1000,1000,0,1,,0
2009,Microsoft Research Asia,MSRANORM,11,1000,1000,0,1,,0
2009,Microsoft Research Asia,MSRANORM,12,1000,1000,0,1,,0
2009,Microsoft Research Asia,MSRANORM,13,1000,1000,0,1,,0
2009,Microsoft Research Asia,MSRANORM,14,1000,1000,0,1,,0
2009,Microsoft Research Asia,MSRANORM,15,1000,1000,0,1,,0
2009,Microsoft Research Asia,MSRANORM,16,1000,1000,0,1,,0
2009,Microsoft Research Asia,MSRANORM,17,1000,1000,0,1,,0
2009,Microsoft Research Asia,MSRANORM,18,1000,1000,0,1,,0
2009,Microsoft Research Asia,MSRANORM,19,1000,1000,0,1,,0
2009,Microsoft Research Asia,MSRANORM,20,1000,1000,0,1,,0
2009,Microsoft Research Asia,MSRANORM,21,1000,1000,0,1,,0
2009,Microsoft Research Asia,MSRANORM,22,1000,1000,0,1,,0
2009,Microsoft Research Asia,MSRANORM,23,1000,1000,0,1,,0
2009,Microsoft Research Asia,MSRANORM,24,1000,1000,0,1,,0
2009,Microsoft Research Asia,MSRANORM,25,1000,1000,0,1,,0
2009,Microsoft Research Asia,MSRANORM,26,1000,1000,0,1,,0
2009,Microsoft Research Asia,MSRANORM,27,1000,1000,0,1,,0
2009,Microsoft Research Asia,MSRANORM,28,1000,1000,0,1,,0
2009,Microsoft Research Asia,MSRANORM,29,1000,1000,0,1,,0
2009,Microsoft Research Asia,MSRANORM,30,1000,1000,0,1,,0
2009,Microsoft Research Asia,MSRANORM,31,1000,1000,0,1,,0
2009,Microsoft Research Asia,MSRANORM,32,1000,1000,0,1,,0
2009,Microsoft Research Asia,MSRANORM,33,1000,1000,0,1,,0
2009,Microsoft Research Asia,MSRANORM,34,1000,1000,0,1,,0
2009,Microsoft Research Asia,MSRANORM,35,1000,1000,0,1,,0
2009,Microsoft Research Asia,MSRANORM,36,1000,1000,0,1,,0
2009,Microsoft Research Asia,MSRANORM,37,1000,1000,0,1,,0
2009,Microsoft Research Asia,MSRANORM,38,1000,1000,0,1,,0
2009,Microsoft Research Asia,MSRANORM,39,1000,1000,0,1,,0
2009,Microsoft Research Asia,MSRANORM,40,1000,1000,0,1,,0
2009,Microsoft Research Asia,MSRANORM,41,1000,1000,0,1,,0
2009,Microsoft Research Asia,MSRANORM,42,1000,1000,0,1,,0
2009,Microsoft Research Asia,MSRANORM,43,1000,1000,0,1,,0
2009,Microsoft Research Asia,MSRANORM,44,1000,1000,0,1,,0
2009,Microsoft Research Asia,MSRANORM,45,1000,1000,0,1,,0
2009,Microsoft Research Asia,MSRANORM,46,1000,1000,0,1,,0
2009,Microsoft Research Asia,MSRANORM,47,1000,1000,0,1,,0
2009,Microsoft Research Asia,MSRANORM,48,1000,1000,0,1,,0
2009,Microsoft Research Asia,MSRANORM,49,1000,1000,0,1,,0
2009,Microsoft Research Asia,MSRANORM,50,1000,1000,0,1,,0
2009,Northeastern University,NeuLMWeb300,1,1000,831,169,1.0989010989011,2.13924050632911,0.282471520684569
2009,Northeastern University,NeuLMWeb300,2,1000,920,80,1.04493207941484,2.16216216216216,0.00894924465888997
2009,Northeastern University,NeuLMWeb300,3,1000,966,34,1.01729399796541,2,0.00528444050201198
2009,Northeastern University,NeuLMWeb300,4,1000,947,53,1.02880658436214,2.12,0.00805730025773927
2009,Northeastern University,NeuLMWeb300,5,1000,929,71,1.03734439834025,2.02857142857143,0.0818048080408951
2009,Northeastern University,NeuLMWeb300,6,1000,755,245,1.15074798619102,2.14912280701754,0.0510410084198319
2009,Northeastern University,NeuLMWeb300,7,1000,646,354,1.48588410104012,13.1111111111111,8.56363759366164e-06
2009,Northeastern University,NeuLMWeb300,8,1000,938,62,1.03305785123967,2.06666666666667,0.00393309140634331
2009,Northeastern University,NeuLMWeb300,9,1000,968,32,1.01626016260163,2,1.54872276354814e-06
2009,Northeastern University,NeuLMWeb300,10,1000,927,73,1.04166666666667,2.21212121212121,0.0136400617666705
2009,Northeastern University,NeuLMWeb300,11,1000,968,32,1.01626016260163,2,0.112835564463786
2009,Northeastern University,NeuLMWeb300,12,1000,787,213,1.13636363636364,2.29032258064516,0.013774877454317
2009,Northeastern University,NeuLMWeb300,13,1000,654,346,1.25156445556946,2.38620689655172,0.0189462106602751
2009,Northeastern University,NeuLMWeb300,14,1000,925,75,1.03950103950104,2.02702702702703,2.60095600871435e-08
2009,Northeastern University,NeuLMWeb300,15,1000,677,323,1.28205128205128,3.13592233009709,0.0635439555628316
2009,Northeastern University,NeuLMWeb300,16,1000,940,60,1.03092783505155,2,5.69415085393113e-05
2009,Northeastern University,NeuLMWeb300,17,1000,974,26,1.01317122593718,2,8.66085433264007e-12
2009,Northeastern University,NeuLMWeb300,18,1000,963,37,1.01936799184506,2.05555555555556,1.85570105168185e-19
2009,Northeastern University,NeuLMWeb300,19,1000,876,124,1.07642626480086,2.33962264150943,4.56499261203947e-06
2009,Northeastern University,NeuLMWeb300,20,1000,928,72,1.03842159916926,2.05714285714286,0.00994360502873869
2009,Northeastern University,NeuLMWeb300,21,1000,931,69,1.04058272632674,2.3,0.000641848347287568
2009,Northeastern University,NeuLMWeb300,22,1000,982,18,1.00908173562059,2,6.32680309477065e-05
2009,Northeastern University,NeuLMWeb300,23,1000,684,316,1.25786163522013,2.84684684684685,7.02978138281573e-05
2009,Northeastern University,NeuLMWeb300,24,1000,944,56,1.02880658436214,2,2.05507658617793e-05
2009,Northeastern University,NeuLMWeb300,25,1000,883,117,1.06382978723404,2.05263157894737,0.0294149168564082
2009,Northeastern University,NeuLMWeb300,26,1000,974,26,1.01317122593718,2,5.3568403354933e-16
2009,Northeastern University,NeuLMWeb300,27,1000,961,39,1.02040816326531,2.05263157894737,0.0316871422103287
2009,Northeastern University,NeuLMWeb300,28,1000,898,102,1.05596620908131,2.08163265306122,7.35895018002055e-05
2009,Northeastern University,NeuLMWeb300,29,1000,960,40,1.02040816326531,2,1.58384615256615e-06
2009,Northeastern University,NeuLMWeb300,30,1000,963,37,1.01936799184506,2.05555555555556,0.0012141733758007
2009,Northeastern University,NeuLMWeb300,31,1000,923,77,1.04275286757039,2.13888888888889,0.0901062279270964
2009,Northeastern University,NeuLMWeb300,32,1000,974,26,1.01317122593718,2,0.100973790027599
2009,Northeastern University,NeuLMWeb300,33,1000,959,41,1.02249488752556,2.15789473684211,4.38424368028013e-11
2009,Northeastern University,NeuLMWeb300,34,1000,823,177,1.11731843575419,2.45833333333333,6.04285819987262e-10
2009,Northeastern University,NeuLMWeb300,35,1000,909,91,1.04931794333683,2.06818181818182,7.31733186354206e-05
2009,Northeastern University,NeuLMWeb300,36,1000,970,30,1.01522842639594,2,2.92857428060683e-14
2009,Northeastern University,NeuLMWeb300,37,1000,938,62,1.03305785123967,2.06666666666667,1.10063036417578e-16
2009,Northeastern University,NeuLMWeb300,38,1000,964,36,1.0183299389002,2,0.000308714166268808
2009,Northeastern University,NeuLMWeb300,39,1000,957,43,1.02249488752556,2.04761904761905,1.5845328262667e-06
2009,Northeastern University,NeuLMWeb300,40,135,127,8,1.03053435114504,2,0.0312286137029318
2009,Northeastern University,NeuLMWeb300,41,1000,896,104,1.06723585912487,2.53658536585366,8.58389839733126e-05
2009,Northeastern University,NeuLMWeb300,42,1000,917,83,1.04384133611691,2.02439024390244,0.00312204086759299
2009,Northeastern University,NeuLMWeb300,43,1000,967,33,1.01729399796541,2.0625,0.112451906525874
2009,Northeastern University,NeuLMWeb300,44,1000,926,74,1.03950103950104,2.05555555555556,0.0476164021435246
2009,Northeastern University,NeuLMWeb300,45,1000,937,63,1.03412616339193,2.1,2.72527722019964e-05
2009,Northeastern University,NeuLMWeb300,46,1000,937,63,1.03305785123967,2.03225806451613,0.0122760694119822
2009,Northeastern University,NeuLMWeb300,47,1000,979,21,1.01112234580384,2.1,0.00037936884110923
2009,Northeastern University,NeuLMWeb300,48,1000,937,63,1.03842159916926,2.42307692307692,0.00280836857535764
2009,Northeastern University,NeuLMWeb300,49,1000,939,61,1.03626943005181,2.34615384615385,9.48863161448322e-07
2009,Northeastern University,NeuLMWeb300,50,1000,925,75,1.04602510460251,2.41935483870968,1.08590274628242e-10
2009,Northeastern University,NeuLMWeb600,1,1000,835,165,1.09649122807018,2.14285714285714,0.253728115199386
2009,Northeastern University,NeuLMWeb600,2,1000,922,78,1.04384133611691,2.16666666666667,0.00805432007930994
2009,Northeastern University,NeuLMWeb600,3,1000,966,34,1.01729399796541,2,0.00528444020320954
2009,Northeastern University,NeuLMWeb600,4,1000,947,53,1.02880658436214,2.12,0.00528528108217837
2009,Northeastern University,NeuLMWeb600,5,1000,929,71,1.03734439834025,2.02857142857143,0.0817923571090421
2009,Northeastern University,NeuLMWeb600,6,1000,757,243,1.14942528735632,2.15044247787611,0.051040812495906
2009,Northeastern University,NeuLMWeb600,7,1000,646,354,1.48588410104012,13.1111111111111,4.47757485524077e-07
2009,Northeastern University,NeuLMWeb600,8,1000,938,62,1.03305785123967,2.06666666666667,0.00393309122463508
2009,Northeastern University,NeuLMWeb600,9,1000,968,32,1.01626016260163,2,1.10066365133298e-06
2009,Northeastern University,NeuLMWeb600,10,1000,927,73,1.04166666666667,2.21212121212121,0.00994360502765339
2009,Northeastern University,NeuLMWeb600,11,1000,972,28,1.01419878296146,2,0.0665561923803891
2009,Northeastern University,NeuLMWeb600,12,1000,787,213,1.13636363636364,2.29032258064516,0.0100418856641971
2009,Northeastern University,NeuLMWeb600,13,1000,659,341,1.24688279301746,2.38461538461538,0.0111872536582912
2009,Northeastern University,NeuLMWeb600,14,1000,921,79,1.04166666666667,2.02564102564103,0.000307295261383169
2009,Northeastern University,NeuLMWeb600,15,1000,675,325,1.28369704749679,3.125,0.0627091172555887
2009,Northeastern University,NeuLMWeb600,16,1000,938,62,1.03199174406605,2,5.12473380702458e-05
2009,Northeastern University,NeuLMWeb600,17,1000,974,26,1.01317122593718,2,1.16995299517617e-12
2009,Northeastern University,NeuLMWeb600,18,1000,964,36,1.01936799184506,2.11764705882353,9.11563103324105e-20
2009,Northeastern University,NeuLMWeb600,19,1000,884,116,1.07066381156317,2.32,4.4766049124326e-07
2009,Northeastern University,NeuLMWeb600,20,1000,922,78,1.04166666666667,2.05263157894737,0.00805432007276686
2009,Northeastern University,NeuLMWeb600,21,1000,931,69,1.04058272632674,2.3,0.000421116700654536
2009,Northeastern University,NeuLMWeb600,22,1000,982,18,1.00908173562059,2,5.69412278501106e-05
2009,Northeastern University,NeuLMWeb600,23,1000,696,304,1.24688279301746,2.86792452830189,6.32680324927572e-05
2009,Northeastern University,NeuLMWeb600,24,1000,944,56,1.02880658436214,2,8.84994430405405e-06
2009,Northeastern University,NeuLMWeb600,25,1000,881,119,1.06496272630458,2.05172413793103,0.029323815555317
2009,Northeastern University,NeuLMWeb600,26,1000,976,24,1.01214574898785,2,5.85874427185258e-17
2009,Northeastern University,NeuLMWeb600,27,1000,961,39,1.02040816326531,2.05263157894737,0.0207898218689956
2009,Northeastern University,NeuLMWeb600,28,1000,870,130,1.0752688172043,2.16666666666667,5.36467467740077e-05
2009,Northeastern University,NeuLMWeb600,29,1000,956,44,1.02249488752556,2,8.41720783165909e-07
2009,Northeastern University,NeuLMWeb600,30,1000,965,35,1.0183299389002,2.05882352941176,0.000716644787498894
2009,Northeastern University,NeuLMWeb600,31,1000,923,77,1.04275286757039,2.13888888888889,0.0729859203457547
2009,Northeastern University,NeuLMWeb600,32,1000,974,26,1.01317122593718,2,0.0434659056701083
2009,Northeastern University,NeuLMWeb600,33,1000,959,41,1.02249488752556,2.15789473684211,3.94581931225212e-11
2009,Northeastern University,NeuLMWeb600,34,1000,827,173,1.11482720178372,2.47142857142857,1.48957307274826e-12
2009,Northeastern University,NeuLMWeb600,35,1000,910,90,1.04931794333683,2.09302325581395,2.06663064360672e-05
2009,Northeastern University,NeuLMWeb600,36,1000,972,28,1.01419878296146,2,1.40072799982688e-14
2009,Northeastern University,NeuLMWeb600,37,1000,940,60,1.03199174406605,2.06896551724138,3.45389470656723e-17
2009,Northeastern University,NeuLMWeb600,38,1000,964,36,1.0183299389002,2,0.00016391942521842
2009,Northeastern University,NeuLMWeb600,39,1000,951,49,1.02564102564103,2.04166666666667,1.03955712083246e-06
2009,Northeastern University,NeuLMWeb600,40,136,128,8,1.03030303030303,2,0.031228611626624
2009,Northeastern University,NeuLMWeb600,41,1000,896,104,1.06723585912487,2.53658536585366,2.99302030315835e-05
2009,Northeastern University,NeuLMWeb600,42,1000,919,81,1.04275286757039,2.025,0.00204767206285827
2009,Northeastern University,NeuLMWeb600,43,1000,969,31,1.01626016260163,2.06666666666667,0.0819263102891115
2009,Northeastern University,NeuLMWeb600,44,1000,928,72,1.03842159916926,2.05714285714286,0.0346925565115106
2009,Northeastern University,NeuLMWeb600,45,1000,937,63,1.03412616339193,2.1,2.20732906518611e-05
2009,Northeastern University,NeuLMWeb600,46,1000,939,61,1.03199174406605,2.03333333333333,0.0122760622007664
2009,Northeastern University,NeuLMWeb600,47,1000,979,21,1.01112234580384,2.1,0.00034143195699436
2009,Northeastern University,NeuLMWeb600,48,1000,937,63,1.03842159916926,2.42307692307692,0.0020473005712194
2009,Northeastern University,NeuLMWeb600,49,1000,949,51,1.02774922918808,2.125,2.97759500982508e-07
2009,Northeastern University,NeuLMWeb600,50,1000,927,73,1.04493207941484,2.43333333333333,3.7862647947537e-11
2009,Northeastern University,NeuLMWebBase,1,1000,845,155,1.09170305676856,2.1830985915493,0.154741349606388
2009,Northeastern University,NeuLMWebBase,2,1000,920,80,1.04493207941484,2.16216216216216,0.0058715993360573
2009,Northeastern University,NeuLMWebBase,3,1000,962,38,1.01936799184506,2,0.00346712121732446
2009,Northeastern University,NeuLMWebBase,4,1000,947,53,1.02880658436214,2.12,0.00312085591976809
2009,Northeastern University,NeuLMWebBase,5,1000,929,71,1.03734439834025,2.02857142857143,0.0596257290079875
2009,Northeastern University,NeuLMWebBase,6,1000,757,243,1.14942528735632,2.15044247787611,0.051040812495906
2009,Northeastern University,NeuLMWebBase,7,1000,654,346,1.47275405007364,13.84,5.44258936390275e-08
2009,Northeastern University,NeuLMWebBase,8,1000,938,62,1.03305785123967,2.06666666666667,0.0025805011352925
2009,Northeastern University,NeuLMWebBase,9,1000,966,34,1.01729399796541,2,1.83541243574973e-07
2009,Northeastern University,NeuLMWebBase,10,1000,939,61,1.03305785123967,2.10344827586207,0.00184257008660653
2009,Northeastern University,NeuLMWebBase,11,1000,972,28,1.01419878296146,2,0.0664978075157167
2009,Northeastern University,NeuLMWebBase,12,1000,787,213,1.13636363636364,2.29032258064516,0.0100418856641971
2009,Northeastern University,NeuLMWebBase,13,1000,665,335,1.24223602484472,2.39285714285714,0.00167911107512089
2009,Northeastern University,NeuLMWebBase,14,1000,921,79,1.04166666666667,2.02564102564103,0.00022401824554833
2009,Northeastern University,NeuLMWebBase,15,1000,675,325,1.28369704749679,3.125,0.0457149430151483
2009,Northeastern University,NeuLMWebBase,16,1000,940,60,1.03092783505155,2,3.73592510364444e-05
2009,Northeastern University,NeuLMWebBase,17,1000,974,26,1.01317122593718,2,3.3042928213216e-13
2009,Northeastern University,NeuLMWebBase,18,1000,966,34,1.0183299389002,2.125,1.68914471111139e-20
2009,Northeastern University,NeuLMWebBase,19,1000,892,108,1.06496272630458,2.29787234042553,1.56042315339584e-07
2009,Northeastern University,NeuLMWebBase,20,1000,922,78,1.04166666666667,2.05263157894737,0.00587159933304704
2009,Northeastern University,NeuLMWebBase,21,1000,931,69,1.04058272632674,2.3,0.000341104527530174
2009,Northeastern University,NeuLMWebBase,22,1000,982,18,1.00908173562059,2,3.73591395924575e-05
2009,Northeastern University,NeuLMWebBase,23,1000,698,302,1.2453300124533,2.87619047619048,3.02609037361653e-05
2009,Northeastern University,NeuLMWebBase,24,1000,944,56,1.02880658436214,2,6.45160939765541e-06
2009,Northeastern University,NeuLMWebBase,25,1000,883,117,1.06382978723404,2.05263157894737,0.029323815555317
2009,Northeastern University,NeuLMWebBase,26,1000,974,26,1.01317122593718,2,7.57477461034707e-07
2009,Northeastern University,NeuLMWebBase,27,1000,961,39,1.02040816326531,2.05263157894737,0.0168397383852317
2009,Northeastern University,NeuLMWebBase,28,1000,870,130,1.0752688172043,2.16666666666667,2.56590726770929e-05
2009,Northeastern University,NeuLMWebBase,29,1000,958,42,1.02145045965271,2,6.81776456631974e-07
2009,Northeastern University,NeuLMWebBase,30,1000,965,35,1.0183299389002,2.05882352941176,0.000423171580570222
2009,Northeastern University,NeuLMWebBase,31,1000,923,77,1.04275286757039,2.13888888888889,0.0729859203457547
2009,Northeastern University,NeuLMWebBase,32,1000,974,26,1.01317122593718,2,0.0256661826363464
2009,Northeastern University,NeuLMWebBase,33,1000,959,41,1.02249488752556,2.15789473684211,2.32996684569175e-11
2009,Northeastern University,NeuLMWebBase,34,1000,827,173,1.11482720178372,2.47142857142857,2.48168072313323e-13
2009,Northeastern University,NeuLMWebBase,35,1000,910,90,1.04931794333683,2.09302325581395,2.06663064360672e-05
2009,Northeastern University,NeuLMWebBase,36,1000,972,28,1.01419878296146,2,5.42670731978415e-15
2009,Northeastern University,NeuLMWebBase,37,1000,940,60,1.03199174406605,2.06896551724138,2.26591332706837e-17
2009,Northeastern University,NeuLMWebBase,38,1000,964,36,1.0183299389002,2,7.84021529304426e-05
2009,Northeastern University,NeuLMWebBase,39,1000,951,49,1.02564102564103,2.04166666666667,4.02726613221576e-07
2009,Northeastern University,NeuLMWebBase,40,141,133,8,1.02919708029197,2,0.0312286039742071
2009,Northeastern University,NeuLMWebBase,41,1000,891,109,1.07066381156317,2.53488372093023,7.60785603209313e-06
2009,Northeastern University,NeuLMWebBase,42,1000,913,87,1.04602510460251,2.02325581395349,0.00149270099140525
2009,Northeastern University,NeuLMWebBase,43,1000,969,31,1.01626016260163,2.06666666666667,0.0663491705363645
2009,Northeastern University,NeuLMWebBase,44,1000,926,74,1.03950103950104,2.05555555555556,0.0165917021303749
2009,Northeastern University,NeuLMWebBase,45,1000,937,63,1.03412616339193,2.1,9.50182784242573e-06
2009,Northeastern University,NeuLMWebBase,46,1000,943,57,1.02986611740474,2.03571428571429,0.0122760599271624
2009,Northeastern University,NeuLMWebBase,47,1000,979,21,1.01112234580384,2.1,0.000276559885163798
2009,Northeastern University,NeuLMWebBase,48,1000,937,63,1.03842159916926,2.42307692307692,0.00134323384556362
2009,Northeastern University,NeuLMWebBase,49,1000,953,47,1.02564102564103,2.13636363636364,1.15356797877351e-07
2009,Northeastern University,NeuLMWebBase,50,1000,929,71,1.04384133611691,2.44827586206897,9.62417709496282e-12
2009,RMIT University,RmitLm,1,1000,732,268,1.20481927710843,2.73469387755102,0.376555755310055
2009,RMIT University,RmitLm,2,1000,906,94,1.05042016806723,2.04347826086957,0.0180523091264598
2009,RMIT University,RmitLm,3,1000,927,73,1.04384133611691,2.35483870967742,0.01718319139271
2009,RMIT University,RmitLm,4,1000,819,181,1.12485939257593,2.58571428571429,0.000948146783719447
2009,RMIT University,RmitLm,5,1000,867,133,1.08342361863489,2.375,0.0434862040334726
2009,RMIT University,RmitLm,6,1000,901,99,1.05596620908131,2.15217391304348,0.00536507073282412
2009,RMIT University,RmitLm,7,1000,610,390,1.53374233128834,9.28571428571429,0.188816313857161
2009,RMIT University,RmitLm,8,1000,821,179,1.11731843575419,2.41891891891892,0.0466660303110287
2009,RMIT University,RmitLm,9,1000,921,79,1.05042016806723,2.54838709677419,5.43792672082977e-08
2009,RMIT University,RmitLm,10,1000,858,142,1.085776330076,2.25396825396825,0.153620838443757
2009,RMIT University,RmitLm,11,1000,874,126,1.0752688172043,2.25,0.142292917541565
2009,RMIT University,RmitLm,12,1000,877,123,1.07411385606874,2.27777777777778,0.0042832249295573
2009,RMIT University,RmitLm,13,1000,786,214,1.16550116550117,2.97222222222222,0.00713553431054939
2009,RMIT University,RmitLm,14,1000,837,163,1.0989010989011,2.23287671232877,0.0494163507283107
2009,RMIT University,RmitLm,15,1000,616,384,1.39082058414465,3.72815533980583,0.25340975350483
2009,RMIT University,RmitLm,16,1000,833,167,1.09529025191676,2.0875,0.06957083439535
2009,RMIT University,RmitLm,17,1000,966,34,1.0183299389002,2.125,0.00256306146477163
2009,RMIT University,RmitLm,18,1000,932,68,1.03842159916926,2.19354838709677,0.097099803084132
2009,RMIT University,RmitLm,19,1000,793,207,1.15606936416185,2.875,0.0789158832947913
2009,RMIT University,RmitLm,20,1000,837,163,1.10497237569061,2.39705882352941,0.0202825205882566
2009,RMIT University,RmitLm,21,1000,889,111,1.08342361863489,3.26470588235294,0.000276560382427438
2009,RMIT University,RmitLm,22,1000,953,47,1.02459016393443,2.04347826086957,1.99775433629602e-10
2009,RMIT University,RmitLm,23,1000,383,617,2.05761316872428,5.99029126213592,0.053665557512001
2009,RMIT University,RmitLm,24,1000,836,164,1.0989010989011,2.21621621621622,0.00187014914424887
2009,RMIT University,RmitLm,25,1000,743,257,1.18063754427391,2.47115384615385,0.132643156825729
2009,RMIT University,RmitLm,26,1000,900,100,1.06044538706257,2.32558139534884,0.0139652061020803
2009,RMIT University,RmitLm,27,1000,909,91,1.0515247108307,2.16666666666667,0.0420860643219662
2009,RMIT University,RmitLm,28,1000,695,305,1.25944584382872,3.08080808080808,4.69412867447836e-05
2009,RMIT University,RmitLm,29,1000,936,64,1.03950103950104,2.46153846153846,0.0490378625516309
2009,RMIT University,RmitLm,30,1000,871,129,1.07181136120043,2.08064516129032,0.0863334888000994
2009,RMIT University,RmitLm,31,1000,777,223,1.1454753722795,2.32291666666667,0.261648293152165
2009,RMIT University,RmitLm,32,1000,856,144,1.08813928182807,2.28571428571429,0.333503066402843
2009,RMIT University,RmitLm,33,1000,919,81,1.04602510460251,2.18918918918919,0.000168808946556783
2009,RMIT University,RmitLm,34,1000,820,180,1.11856823266219,2.43243243243243,1.99565151414105e-12
2009,RMIT University,RmitLm,35,1000,756,244,1.16009280742459,2.30188679245283,0.385603737747959
2009,RMIT University,RmitLm,36,1000,952,48,1.02564102564103,2.08695652173913,4.89896332596513e-08
2009,RMIT University,RmitLm,37,1000,918,82,1.04712041884817,2.21621621621622,0.00834037624365769
2009,RMIT University,RmitLm,38,1000,917,83,1.04602510460251,2.12820512820513,0.000544818245243373
2009,RMIT University,RmitLm,39,1000,907,93,1.06157112526539,2.65714285714286,0.000754179525960428
2009,RMIT University,RmitLm,40,15,11,4,1.15384615384615,2,0.315703690177001
2009,RMIT University,RmitLm,41,1000,774,226,1.15740740740741,2.51111111111111,0.0306927718051549
2009,RMIT University,RmitLm,42,1000,862,138,1.09649122807018,2.76,0.00404416707454567
2009,RMIT University,RmitLm,43,1000,921,79,1.04493207941484,2.19444444444444,0.25808450206776
2009,RMIT University,RmitLm,44,1000,776,224,1.17924528301887,3.11111111111111,0.00935391001267776
2009,RMIT University,RmitLm,45,1000,861,139,1.09289617486339,2.57407407407407,7.94413020084258e-11
2009,RMIT University,RmitLm,46,1000,890,110,1.06837606837607,2.39130434782609,0.00656362900820475
2009,RMIT University,RmitLm,47,1000,894,106,1.06044538706257,2.16326530612245,0.113751725461278
2009,RMIT University,RmitLm,48,1000,894,106,1.07296137339056,2.78947368421053,0.00225538223043124
2009,RMIT University,RmitLm,49,1000,758,242,1.17647058823529,2.6304347826087,0.266475303243551
2009,RMIT University,RmitLm,50,1000,882,118,1.09051254089422,3.37142857142857,0.000119207108500534
2009,RMIT University,RmitOkapi,1,1000,874,126,1.07991360691145,2.42307692307692,0.0944470514189561
2009,RMIT University,RmitOkapi,2,1000,904,96,1.05263157894737,2.08695652173913,0.00120690014381358
2009,RMIT University,RmitOkapi,3,1000,883,117,1.06496272630458,2.08928571428571,0.133280045953094
2009,RMIT University,RmitOkapi,4,1000,805,195,1.13250283125708,2.5,0.00547941894114414
2009,RMIT University,RmitOkapi,5,1000,813,187,1.11607142857143,2.25301204819277,0.0525724750113117
2009,RMIT University,RmitOkapi,6,1000,826,174,1.10619469026549,2.23076923076923,0.0095029821608458
2009,RMIT University,RmitOkapi,7,1000,887,113,1.07066381156317,2.40425531914894,0.0503635242351883
2009,RMIT University,RmitOkapi,8,1000,692,308,1.22100122100122,2.4251968503937,0.034556253268933
2009,RMIT University,RmitOkapi,9,1000,904,96,1.06044538706257,2.46153846153846,0.0150625626877601
2009,RMIT University,RmitOkapi,10,1000,834,166,1.1037527593819,2.30555555555556,0.0137587643288582
2009,RMIT University,RmitOkapi,11,1000,843,157,1.10253583241455,2.453125,0.126847059745029
2009,RMIT University,RmitOkapi,12,1000,782,218,1.17647058823529,3.20588235294118,0.141325892012766
2009,RMIT University,RmitOkapi,13,1000,768,232,1.17924528301887,2.9,0.132670013765231
2009,RMIT University,RmitOkapi,14,1000,843,157,1.09529025191676,2.24285714285714,0.185795103301144
2009,RMIT University,RmitOkapi,15,1000,809,191,1.12485939257593,2.3875,0.0916898930503098
2009,RMIT University,RmitOkapi,16,1000,728,272,1.16414435389988,2.0763358778626,0.20055601456083
2009,RMIT University,RmitOkapi,17,1000,883,117,1.08225108225108,2.85365853658537,8.4009002806481e-06
2009,RMIT University,RmitOkapi,18,1000,897,103,1.06157112526539,2.28888888888889,0.0960040920776305
2009,RMIT University,RmitOkapi,19,1000,752,248,1.17096018735363,2.43137254901961,0.0929309580090587
2009,RMIT University,RmitOkapi,20,1000,806,194,1.11982082866741,2.22988505747126,0.00480189664616916
2009,RMIT University,RmitOkapi,21,1000,866,134,1.09769484083425,2.97777777777778,0.00127218808938495
2009,RMIT University,RmitOkapi,22,1000,930,70,1.03950103950104,2.1875,1.16426820212084e-06
2009,RMIT University,RmitOkapi,23,1000,401,599,1.98019801980198,5.75961538461539,0.198751086895519
2009,RMIT University,RmitOkapi,24,1000,768,232,1.14810562571757,2.25242718446602,0.0189125769738499
2009,RMIT University,RmitOkapi,25,1000,691,309,1.21359223300971,2.32330827067669,0.0849376848487321
2009,RMIT University,RmitOkapi,26,1000,910,90,1.0515247108307,2.19512195121951,0.162946333531364
2009,RMIT University,RmitOkapi,27,1000,745,255,1.19904076738609,2.86516853932584,0.00145603061692963
2009,RMIT University,RmitOkapi,28,1000,705,295,1.25,3.10526315789474,3.01978850471854e-05
2009,RMIT University,RmitOkapi,29,1000,900,100,1.07066381156317,2.94117647058824,0.0115214407637949
2009,RMIT University,RmitOkapi,30,1000,803,197,1.11731843575419,2.14130434782609,0.215549841301272
2009,RMIT University,RmitOkapi,31,1000,755,245,1.16414435389988,2.35576923076923,0.188114605658447
2009,RMIT University,RmitOkapi,32,1000,777,223,1.14942528735632,2.39784946236559,0.42748598393868
2009,RMIT University,RmitOkapi,33,1000,904,96,1.05708245243129,2.28571428571429,0.030530891298651
2009,RMIT University,RmitOkapi,34,1000,800,200,1.13378684807256,2.4390243902439,0.000249117421230858
2009,RMIT University,RmitOkapi,35,1000,744,256,1.16686114352392,2.26548672566372,0.294142157946954
2009,RMIT University,RmitOkapi,36,1000,941,59,1.03092783505155,2.03448275862069,0.00113134093824024
2009,RMIT University,RmitOkapi,37,1000,631,369,1.33868808567604,3.18103448275862,0.0345487341322927
2009,RMIT University,RmitOkapi,38,1000,892,108,1.06044538706257,2.11764705882353,0.0100708917146059
2009,RMIT University,RmitOkapi,39,1000,881,119,1.07642626480086,2.47916666666667,0.0483228415500388
2009,RMIT University,RmitOkapi,40,15,11,4,1.15384615384615,2,0.315703690177001
2009,RMIT University,RmitOkapi,41,1000,876,124,1.07066381156317,2.13793103448276,0.145485949764149
2009,RMIT University,RmitOkapi,42,1000,920,80,1.04602510460251,2.22222222222222,8.25406704293142e-08
2009,RMIT University,RmitOkapi,43,1000,880,120,1.07066381156317,2.22222222222222,0.0615937912945803
2009,RMIT University,RmitOkapi,44,1000,854,146,1.09289617486339,2.39344262295082,0.479939469881182
2009,RMIT University,RmitOkapi,45,1000,848,152,1.1001100110011,2.49180327868852,3.31053261052337e-10
2009,RMIT University,RmitOkapi,46,1000,878,122,1.07642626480086,2.3921568627451,0.026674015989585
2009,RMIT University,RmitOkapi,47,1000,876,124,1.06951871657754,2.10169491525424,0.0296469128336149
2009,RMIT University,RmitOkapi,48,1000,882,118,1.08108108108108,2.74418604651163,0.000468972900260709
2009,RMIT University,RmitOkapi,49,1000,750,250,1.17785630153121,2.52525252525253,0.509232344036453
2009,RMIT University,RmitOkapi,50,1000,931,69,1.03950103950104,2.2258064516129,0.000793167063483018
2009,"IIIT, Hyderabad",SIEL09,1,1000,629,371,1.37741046831956,3.82474226804124,0.251416916560477
2009,"IIIT, Hyderabad",SIEL09,2,1000,933,67,1.03950103950104,2.31034482758621,0.0838822045725649
2009,"IIIT, Hyderabad",SIEL09,3,1000,850,150,1.1001100110011,2.54237288135593,0.00504684569158924
2009,"IIIT, Hyderabad",SIEL09,4,1000,816,184,1.14678899082569,3.28571428571429,0.189605086062356
2009,"IIIT, Hyderabad",SIEL09,5,1000,789,211,1.13378684807256,2.26881720430108,0.0229628004201933
2009,"IIIT, Hyderabad",SIEL09,6,1000,342,658,2.23214285714286,6.20754716981132,0.00804671579750906
2009,"IIIT, Hyderabad",SIEL09,7,1000,905,95,1.06496272630458,2.79411764705882,0.000361336883969714
2009,"IIIT, Hyderabad",SIEL09,8,1000,756,244,1.18764845605701,2.83720930232558,0.0916553496850632
2009,"IIIT, Hyderabad",SIEL09,9,1000,791,209,1.16279069767442,3.02898550724638,0.00127661666547336
2009,"IIIT, Hyderabad",SIEL09,10,1000,820,180,1.15874855156431,4.18604651162791,0.0111948444455152
2009,"IIIT, Hyderabad",SIEL09,11,1000,884,116,1.06837606837607,2.23076923076923,0.0337282869624279
2009,"IIIT, Hyderabad",SIEL09,12,1000,667,333,1.27226463104326,2.79831932773109,0.00666229179269637
2009,"IIIT, Hyderabad",SIEL09,13,1000,590,410,1.45985401459854,4.31578947368421,0.565709509435399
2009,"IIIT, Hyderabad",SIEL09,14,1000,793,207,1.14285714285714,2.52439024390244,0.112244783392238
2009,"IIIT, Hyderabad",SIEL09,15,1000,787,213,1.14678899082569,2.50588235294118,0.00101742566843877
2009,"IIIT, Hyderabad",SIEL09,16,1000,784,216,1.15074798619102,2.54117647058824,0.186608098701038
2009,"IIIT, Hyderabad",SIEL09,17,1000,962,38,1.02040816326531,2.11111111111111,0.00199370287112236
2009,"IIIT, Hyderabad",SIEL09,18,1000,879,121,1.08108108108108,2.6304347826087,6.03076848528649e-05
2009,"IIIT, Hyderabad",SIEL09,19,1000,733,267,1.21951219512195,3.06896551724138,0.0576908949089258
2009,"IIIT, Hyderabad",SIEL09,20,1000,834,166,1.12359550561798,2.96428571428571,0.19603720813065
2009,"IIIT, Hyderabad",SIEL09,21,1000,854,146,1.10619469026549,2.92,0.00926363183470224
2009,"IIIT, Hyderabad",SIEL09,22,1000,889,111,1.07642626480086,2.775,0.00596490697314471
2009,"IIIT, Hyderabad",SIEL09,23,1000,815,185,1.14025085518814,2.98387096774194,0.0931466645756311
2009,"IIIT, Hyderabad",SIEL09,24,1000,812,188,1.13122171945701,2.61111111111111,0.054286572739457
2009,"IIIT, Hyderabad",SIEL09,25,1000,625,375,1.3262599469496,2.90697674418605,0.0103700599775301
2009,"IIIT, Hyderabad",SIEL09,26,1000,887,113,1.07296137339056,2.51111111111111,0.0136641312823013
2009,"IIIT, Hyderabad",SIEL09,27,1000,681,319,1.35869565217391,5.8,0.0339708638212669
2009,"IIIT, Hyderabad",SIEL09,28,1000,593,407,1.45985401459854,4.42391304347826,0.0672160553009604
2009,"IIIT, Hyderabad",SIEL09,29,1000,800,200,1.14155251141553,2.63157894736842,0.0139095662638599
2009,"IIIT, Hyderabad",SIEL09,30,1000,880,120,1.07066381156317,2.22222222222222,0.132888376509274
2009,"IIIT, Hyderabad",SIEL09,31,1000,719,281,1.23609394313968,3.12222222222222,0.227096077684643
2009,"IIIT, Hyderabad",SIEL09,32,1000,859,141,1.07991360691145,2.1044776119403,0.0953699489962752
2009,"IIIT, Hyderabad",SIEL09,33,1000,948,52,1.02986611740474,2.26086956521739,4.61224015712864e-05
2009,"IIIT, Hyderabad",SIEL09,34,1000,850,150,1.10741971207087,2.83018867924528,0.286732181309235
2009,"IIIT, Hyderabad",SIEL09,35,1000,719,281,1.20772946859903,2.57798165137615,0.0013725821216654
2009,"IIIT, Hyderabad",SIEL09,36,1000,902,98,1.07411385606874,3.37931034482759,0.15567897750879
2009,"IIIT, Hyderabad",SIEL09,37,1000,806,194,1.13895216400911,2.69444444444444,0.0974745406346931
2009,"IIIT, Hyderabad",SIEL09,38,1000,837,163,1.11234705228031,2.62903225806452,0.154993670270072
2009,"IIIT, Hyderabad",SIEL09,39,1000,892,108,1.07066381156317,2.57142857142857,0.0736109348924215
2009,"IIIT, Hyderabad",SIEL09,40,17,11,6,1.30769230769231,3,0.389224704019286
2009,"IIIT, Hyderabad",SIEL09,41,1000,833,167,1.09769484083425,2.14102564102564,0.0623159240670474
2009,"IIIT, Hyderabad",SIEL09,42,1000,900,100,1.06382978723404,2.5,0.280067316741296
2009,"IIIT, Hyderabad",SIEL09,43,1000,851,149,1.10987791342952,2.98,0.0303301112471139
2009,"IIIT, Hyderabad",SIEL09,44,1000,588,412,1.53139356814701,6.33846153846154,0.00834122687303665
2009,"IIIT, Hyderabad",SIEL09,45,1000,831,169,1.12233445566779,2.81666666666667,0.0424955548597818
2009,"IIIT, Hyderabad",SIEL09,46,1000,711,289,1.26582278481013,3.65822784810127,0.0108803821495269
2009,"IIIT, Hyderabad",SIEL09,47,1000,705,295,1.2987012987013,4.53846153846154,0.0385282725729246
2009,"IIIT, Hyderabad",SIEL09,48,1000,875,125,1.07991360691145,2.45098039215686,0.0012414136214991
2009,"IIIT, Hyderabad",SIEL09,49,1000,839,161,1.10132158590308,2.33333333333333,0.0198353770554813
2009,"IIIT, Hyderabad",SIEL09,50,1000,912,88,1.05708245243129,2.58823529411765,0.0734813960479339
2009,Sabir Research,Sab9wtBase,1,1000,826,174,1.11982082866741,2.59701492537313,0.126156870681182
2009,Sabir Research,Sab9wtBase,2,1000,875,125,1.08108108108108,2.5,0.121162677987406
2009,Sabir Research,Sab9wtBase,3,1000,661,339,1.28369704749679,2.8728813559322,0.229126754942358
2009,Sabir Research,Sab9wtBase,4,1000,755,245,1.17785630153121,2.6063829787234,0.440899635833542
2009,Sabir Research,Sab9wtBase,5,1000,842,158,1.1001100110011,2.35820895522388,0.12349897852866
2009,Sabir Research,Sab9wtBase,6,1000,740,260,1.16009280742459,2.13114754098361,0.172879635898901
2009,Sabir Research,Sab9wtBase,7,1000,768,232,1.22399020807834,4.73469387755102,0.00057904403597623
2009,Sabir Research,Sab9wtBase,8,1000,669,331,1.22699386503067,2.26712328767123,0.398167743635458
2009,Sabir Research,Sab9wtBase,9,1000,809,191,1.15340253748558,3.29310344827586,0.169688506581151
2009,Sabir Research,Sab9wtBase,10,1000,956,44,1.02669404517454,2.44444444444444,2.03275913178069e-05
2009,Sabir Research,Sab9wtBase,11,1000,743,257,1.21359223300971,3.17283950617284,0.167909618218833
2009,Sabir Research,Sab9wtBase,12,1000,631,369,1.31061598951507,2.79545454545455,0.319058651476984
2009,Sabir Research,Sab9wtBase,13,1000,511,489,1.53139356814701,3.44366197183099,0.696435393073794
2009,Sabir Research,Sab9wtBase,14,1000,150,850,2.32558139534884,3.03571428571429,0.644806801118208
2009,Sabir Research,Sab9wtBase,15,1000,802,198,1.12866817155756,2.35714285714286,0.372530150508187
2009,Sabir Research,Sab9wtBase,16,1000,652,348,1.26742712294043,2.54014598540146,0.176524834609262
2009,Sabir Research,Sab9wtBase,17,1000,744,256,1.17508813160987,2.39252336448598,0.0164706464549031
2009,Sabir Research,Sab9wtBase,18,1000,834,166,1.10132158590308,2.24324324324324,0.198808313444443
2009,Sabir Research,Sab9wtBase,19,1000,716,284,1.22100122100122,2.75728155339806,0.202841472012781
2009,Sabir Research,Sab9wtBase,20,1000,726,274,1.20192307692308,2.58490566037736,0.0689154756873583
2009,Sabir Research,Sab9wtBase,21,1000,795,205,1.12866817155756,2.25274725274725,0.0182698039784704
2009,Sabir Research,Sab9wtBase,22,1000,861,139,1.08459869848156,2.27868852459016,0.0405857022042865
2009,Sabir Research,Sab9wtBase,23,1000,649,351,1.30039011703511,2.925,0.0852186619226101
2009,Sabir Research,Sab9wtBase,24,1000,600,400,1.3262599469496,2.5974025974026,0.16510434114191
2009,Sabir Research,Sab9wtBase,25,1000,702,298,1.20918984280532,2.384,0.0385469536928467
2009,Sabir Research,Sab9wtBase,26,1000,788,212,1.14155251141553,2.40909090909091,0.0271229246165499
2009,Sabir Research,Sab9wtBase,27,1000,922,78,1.04493207941484,2.22857142857143,0.211925556354338
2009,Sabir Research,Sab9wtBase,28,1000,727,273,1.29032258064516,5.6875,0.037942305630064
2009,Sabir Research,Sab9wtBase,29,1000,831,169,1.12107623318386,2.77049180327869,0.0108672833188002
2009,Sabir Research,Sab9wtBase,30,1000,625,375,1.25786163522013,2.20588235294118,0.616151535815556
2009,Sabir Research,Sab9wtBase,31,1000,591,409,1.50829562594268,5.68055555555556,0.27137458006641
2009,Sabir Research,Sab9wtBase,32,1000,717,283,1.18203309692671,2.1937984496124,0.120020091614222
2009,Sabir Research,Sab9wtBase,33,1000,922,78,1.04712041884817,2.36363636363636,0.203635114818248
2009,Sabir Research,Sab9wtBase,34,1000,366,634,2.13219616204691,6.15533980582524,0.711421623801629
2009,Sabir Research,Sab9wtBase,35,1000,696,304,1.21065375302663,2.33846153846154,0.0268747470483583
2009,Sabir Research,Sab9wtBase,36,1000,708,292,1.30718954248366,5.12280701754386,0.0039226682860277
2009,Sabir Research,Sab9wtBase,37,1000,897,103,1.05932203389831,2.19148936170213,0.0346805517418833
2009,Sabir Research,Sab9wtBase,38,1000,747,253,1.15606936416185,2.14406779661017,0.233383768352261
2009,Sabir Research,Sab9wtBase,39,1000,680,320,1.30548302872063,3.72093023255814,0.330444721278821
2009,Sabir Research,Sab9wtBase,40,451,418,33,1.04883720930233,2.75,0.0169034915955927
2009,Sabir Research,Sab9wtBase,41,1000,573,427,1.33689839572193,2.44,0.377878038450532
2009,Sabir Research,Sab9wtBase,42,1000,888,112,1.06609808102345,2.24,0.104888391430509
2009,Sabir Research,Sab9wtBase,43,1000,781,219,1.1441647597254,2.35483870967742,0.274614729299755
2009,Sabir Research,Sab9wtBase,44,1000,764,236,1.15874855156431,2.38383838383838,0.0269427489478885
2009,Sabir Research,Sab9wtBase,45,1000,848,152,1.09409190371991,2.3030303030303,0.156624101082834
2009,Sabir Research,Sab9wtBase,46,1000,713,287,1.18343195266272,2.17424242424242,0.377951667660093
2009,Sabir Research,Sab9wtBase,47,1000,533,467,1.45985401459854,3.07236842105263,0.140863720395373
2009,Sabir Research,Sab9wtBase,48,1000,874,126,1.08108108108108,2.47058823529412,0.261683477007993
2009,Sabir Research,Sab9wtBase,49,1000,765,235,1.17370892018779,2.70114942528736,0.0275872278570109
2009,Sabir Research,Sab9wtBase,50,1000,877,123,1.07411385606874,2.27777777777778,0.184053382988791
2009,Sabir Research,Sab9wtBf1,1,1000,923,77,1.04493207941484,2.26470588235294,0.0565173715298441
2009,Sabir Research,Sab9wtBf1,2,1000,858,142,1.09170305676856,2.44827586206897,0.311540622766022
2009,Sabir Research,Sab9wtBf1,3,1000,709,291,1.23152709359606,2.8252427184466,0.0602392931534977
2009,Sabir Research,Sab9wtBf1,4,1000,852,148,1.10864745011086,2.96,0.171702018358978
2009,Sabir Research,Sab9wtBf1,5,1000,812,188,1.12485939257593,2.44155844155844,0.509641673834735
2009,Sabir Research,Sab9wtBf1,6,1000,725,275,1.17233294255569,2.1484375,0.255079663003618
2009,Sabir Research,Sab9wtBf1,7,1000,950,50,1.02564102564103,2,1.38854074480923e-07
2009,Sabir Research,Sab9wtBf1,8,1000,491,509,1.49925037481259,2.89204545454545,0.468371469351669
2009,Sabir Research,Sab9wtBf1,9,1000,762,238,1.22549019607843,4.40740740740741,0.253077708341748
2009,Sabir Research,Sab9wtBf1,10,1000,910,90,1.0482180293501,2.04545454545455,1.0528339969641e-07
2009,Sabir Research,Sab9wtBf1,11,1000,740,260,1.21212121212121,3.05882352941176,0.341107072729779
2009,Sabir Research,Sab9wtBf1,12,1000,843,157,1.11856823266219,3.07843137254902,0.448165032286895
2009,Sabir Research,Sab9wtBf1,13,1000,682,318,1.25156445556946,2.71794871794872,0.251946380485172
2009,Sabir Research,Sab9wtBf1,14,1000,56,944,2.51256281407035,2.76023391812866,0.999998162098593
2009,Sabir Research,Sab9wtBf1,15,1000,828,172,1.11358574610245,2.45714285714286,0.502323661845049
2009,Sabir Research,Sab9wtBf1,16,1000,631,369,1.29366106080207,2.59859154929577,0.46384263530681
2009,Sabir Research,Sab9wtBf1,17,1000,835,165,1.10253583241455,2.29166666666667,0.000346548702667789
2009,Sabir Research,Sab9wtBf1,18,1000,844,156,1.09769484083425,2.32835820895522,0.150306636225688
2009,Sabir Research,Sab9wtBf1,19,1000,819,181,1.12107623318386,2.47945205479452,0.404210741738963
2009,Sabir Research,Sab9wtBf1,20,1000,724,276,1.18203309692671,2.26229508196721,0.000330961552868067
2009,Sabir Research,Sab9wtBf1,21,1000,891,109,1.07181136120043,2.5952380952381,0.00292170123103575
2009,Sabir Research,Sab9wtBf1,22,1000,890,110,1.06496272630458,2.24489795918367,0.11699830985165
2009,Sabir Research,Sab9wtBf1,23,1000,759,241,1.17924528301887,2.70786516853933,0.0913878356532035
2009,Sabir Research,Sab9wtBf1,24,1000,651,349,1.24688279301746,2.3112582781457,0.283837353309366
2009,Sabir Research,Sab9wtBf1,25,1000,744,256,1.16822429906542,2.28571428571429,0.000443238786242841
2009,Sabir Research,Sab9wtBf1,26,1000,787,213,1.13895216400911,2.34065934065934,0.0889314335655846
2009,Sabir Research,Sab9wtBf1,27,1000,909,91,1.06269925611052,2.84375,0.102769643450563
2009,Sabir Research,Sab9wtBf1,28,1000,698,302,1.3351134846462,5.92156862745098,0.130705422868682
2009,Sabir Research,Sab9wtBf1,29,1000,682,318,1.20481927710843,2.14864864864865,0.0166164949793874
2009,Sabir Research,Sab9wtBf1,30,1000,573,427,1.31578947368421,2.28342245989305,0.707659649447487
2009,Sabir Research,Sab9wtBf1,31,1000,585,415,1.53609831029186,6.28787878787879,0.262347831917535
2009,Sabir Research,Sab9wtBf1,32,1000,706,294,1.19047619047619,2.19402985074627,0.0818417520984126
2009,Sabir Research,Sab9wtBf1,33,1000,941,59,1.0351966873706,2.36,0.343911448831081
2009,Sabir Research,Sab9wtBf1,34,1000,486,514,1.71526586620926,5.29896907216495,0.955302682724595
2009,Sabir Research,Sab9wtBf1,35,1000,657,343,1.25156445556946,2.41549295774648,0.20603597017011
2009,Sabir Research,Sab9wtBf1,36,1000,809,191,1.20192307692308,8.30434782608696,1.17819733696498e-08
2009,Sabir Research,Sab9wtBf1,37,1000,897,103,1.05932203389831,2.19148936170213,0.19733151807471
2009,Sabir Research,Sab9wtBf1,38,1000,791,209,1.14155251141553,2.45882352941177,0.26373715348265
2009,Sabir Research,Sab9wtBf1,39,1000,743,257,1.20772946859903,3.02352941176471,0.408063904217508
2009,Sabir Research,Sab9wtBf1,40,1000,396,604,1.85185185185185,4.19444444444444,0.0364682998559469
2009,Sabir Research,Sab9wtBf1,41,1000,615,385,1.29198966408269,2.42138364779874,0.721765536170013
2009,Sabir Research,Sab9wtBf1,42,1000,871,129,1.08932461873638,2.74468085106383,0.000951594095597039
2009,Sabir Research,Sab9wtBf1,43,1000,805,195,1.12739571589628,2.37804878048781,0.347274204779002
2009,Sabir Research,Sab9wtBf1,44,1000,704,296,1.23304562268804,2.76635514018692,0.201158321021502
2009,Sabir Research,Sab9wtBf1,45,1000,871,129,1.07874865156419,2.30357142857143,0.147534337308433
2009,Sabir Research,Sab9wtBf1,46,1000,713,287,1.18343195266272,2.17424242424242,0.546771524685867
2009,Sabir Research,Sab9wtBf1,47,1000,889,111,1.06837606837607,2.36170212765957,0.206026952638277
2009,Sabir Research,Sab9wtBf1,48,1000,905,95,1.05820105820106,2.375,7.81096838532397e-05
2009,Sabir Research,Sab9wtBf1,49,1000,783,217,1.15874855156431,2.7125,0.123548049167177
2009,Sabir Research,Sab9wtBf1,50,1000,867,133,1.07874865156419,2.21666666666667,0.105165214658676
2009,Sabir Research,Sab9wtBf2,1,1000,874,126,1.08225108225108,2.52,0.149716711591803
2009,Sabir Research,Sab9wtBf2,2,1000,867,133,1.08695652173913,2.50943396226415,0.183642566214362
2009,Sabir Research,Sab9wtBf2,3,1000,700,300,1.24843945068664,2.97029702970297,0.210256105482617
2009,Sabir Research,Sab9wtBf2,4,1000,786,214,1.16144018583043,2.85333333333333,0.118930760259005
2009,Sabir Research,Sab9wtBf2,5,1000,858,142,1.08459869848156,2.21875,0.277859981913884
2009,Sabir Research,Sab9wtBf2,6,1000,735,265,1.16279069767442,2.12,0.169962695214256
2009,Sabir Research,Sab9wtBf2,7,1000,815,185,1.17647058823529,5.28571428571429,1.79504685105512e-07
2009,Sabir Research,Sab9wtBf2,8,1000,647,353,1.24843945068664,2.29220779220779,0.416173303476017
2009,Sabir Research,Sab9wtBf2,9,1000,815,185,1.15074798619102,3.42592592592593,0.340433259803857
2009,Sabir Research,Sab9wtBf2,10,1000,960,40,1.02145045965271,2.10526315789474,0.000474587061829897
2009,Sabir Research,Sab9wtBf2,11,1000,758,242,1.19760479041916,3.14285714285714,0.155969943931784
2009,Sabir Research,Sab9wtBf2,12,1000,636,364,1.30718954248366,2.82170542635659,0.403780138419628
2009,Sabir Research,Sab9wtBf2,13,1000,624,376,1.34408602150538,3.13333333333333,0.394821419898408
2009,Sabir Research,Sab9wtBf2,14,1000,64,936,2.41545893719807,2.67428571428571,0.979705987636696
2009,Sabir Research,Sab9wtBf2,15,1000,847,153,1.09769484083425,2.390625,0.424887585347909
2009,Sabir Research,Sab9wtBf2,16,1000,630,370,1.29533678756477,2.6056338028169,0.345668327545147
2009,Sabir Research,Sab9wtBf2,17,1000,831,169,1.10619469026549,2.31506849315069,0.00540889932372846
2009,Sabir Research,Sab9wtBf2,18,1000,874,126,1.0752688172043,2.25,0.157240703154884
2009,Sabir Research,Sab9wtBf2,19,1000,820,180,1.12359550561798,2.57142857142857,0.242762163679635
2009,Sabir Research,Sab9wtBf2,20,1000,742,258,1.17096018735363,2.30357142857143,0.00175855070517206
2009,Sabir Research,Sab9wtBf2,21,1000,875,125,1.07296137339056,2.19298245614035,0.0317197079267673
2009,Sabir Research,Sab9wtBf2,22,1000,852,148,1.09529025191676,2.42622950819672,0.0423124901150321
2009,Sabir Research,Sab9wtBf2,23,1000,693,307,1.24069478908189,2.71681415929204,0.154137464181388
2009,Sabir Research,Sab9wtBf2,24,1000,663,337,1.23152709359606,2.26174496644295,0.202793266130856
2009,Sabir Research,Sab9wtBf2,25,1000,724,276,1.18343195266272,2.28099173553719,0.0376284550103121
2009,Sabir Research,Sab9wtBf2,26,1000,803,197,1.12866817155756,2.37349397590361,0.032095282383608
2009,Sabir Research,Sab9wtBf2,27,1000,935,65,1.03734439834025,2.24137931034483,0.187485529890367
2009,Sabir Research,Sab9wtBf2,28,1000,767,233,1.22699386503067,4.85416666666667,0.0516015075196703
2009,Sabir Research,Sab9wtBf2,29,1000,856,144,1.09051254089422,2.36065573770492,0.0186047904630879
2009,Sabir Research,Sab9wtBf2,30,1000,605,395,1.28205128205128,2.25714285714286,0.663748266380747
2009,Sabir Research,Sab9wtBf2,31,1000,636,364,1.41242937853107,5.05555555555556,0.275863186772721
2009,Sabir Research,Sab9wtBf2,32,1000,727,273,1.17647058823529,2.21951219512195,0.164062783472651
2009,Sabir Research,Sab9wtBf2,33,1000,934,66,1.03950103950104,2.35714285714286,0.209030225043206
2009,Sabir Research,Sab9wtBf2,34,1000,488,512,1.70357751277683,5.17171717171717,0.92406270027938
2009,Sabir Research,Sab9wtBf2,35,1000,700,300,1.20918984280532,2.36220472440945,0.0369815848673344
2009,Sabir Research,Sab9wtBf2,36,1000,779,221,1.23456790123457,7.12903225806452,2.89700721593638e-05
2009,Sabir Research,Sab9wtBf2,37,1000,899,101,1.05820105820106,2.19565217391304,0.0772759534718319
2009,Sabir Research,Sab9wtBf2,38,1000,771,229,1.1441647597254,2.22330097087379,0.072438859146394
2009,Sabir Research,Sab9wtBf2,39,1000,698,302,1.28040973111396,3.63855421686747,0.337272823247252
2009,Sabir Research,Sab9wtBf2,40,1000,800,200,1.15740740740741,3.125,0.0231064370984012
2009,Sabir Research,Sab9wtBf2,41,1000,573,427,1.34048257372654,2.46820809248555,0.641345141793966
2009,Sabir Research,Sab9wtBf2,42,1000,866,134,1.1001100110011,3.11627906976744,0.00409982966375277
2009,Sabir Research,Sab9wtBf2,43,1000,804,196,1.12485939257593,2.30588235294118,0.271357895768722
2009,Sabir Research,Sab9wtBf2,44,1000,755,245,1.17508813160987,2.55208333333333,0.0593122782148189
2009,Sabir Research,Sab9wtBf2,45,1000,878,122,1.07411385606874,2.30188679245283,0.161463577025197
2009,Sabir Research,Sab9wtBf2,46,1000,721,279,1.17785630153121,2.1796875,0.418619320827455
2009,Sabir Research,Sab9wtBf2,47,1000,766,234,1.16279069767442,2.48936170212766,0.239729936691604
2009,Sabir Research,Sab9wtBf2,48,1000,899,101,1.06609808102345,2.58974358974359,0.031232470947592
2009,Sabir Research,Sab9wtBf2,49,1000,786,214,1.15473441108545,2.675,0.0713129887791292
2009,Sabir Research,Sab9wtBf2,50,1000,877,123,1.0752688172043,2.32075471698113,0.16328742360839
2009,Tsinghua University (Min Zhang),THUIR09An,1,235,235,0,1,,0
2009,Tsinghua University (Min Zhang),THUIR09An,2,136,130,6,1.02255639097744,2,0.13955959861203
2009,Tsinghua University (Min Zhang),THUIR09An,3,1000,980,20,1.01010101010101,2,4.61757889063161e-09
2009,Tsinghua University (Min Zhang),THUIR09An,4,1000,719,281,1.18623962040332,2.26612903225806,2.5214764362214e-07
2009,Tsinghua University (Min Zhang),THUIR09An,5,1000,972,28,1.01936799184506,3.11111111111111,8.23846998147073e-10
2009,Tsinghua University (Min Zhang),THUIR09An,6,851,769,82,1.06508135168961,2.73333333333333,0.124805982607753
2009,Tsinghua University (Min Zhang),THUIR09An,7,1000,984,16,1.00806451612903,2,1.17236938642589e-05
2009,Tsinghua University (Min Zhang),THUIR09An,8,1000,827,173,1.10497237569061,2.21794871794872,0.0599854416699795
2009,Tsinghua University (Min Zhang),THUIR09An,9,1000,953,47,1.02564102564103,2.13636363636364,3.09426371856901e-05
2009,Tsinghua University (Min Zhang),THUIR09An,10,1000,975,25,1.01419878296146,2.27272727272727,0.0151556264898275
2009,Tsinghua University (Min Zhang),THUIR09An,11,37,37,0,1,,0
2009,Tsinghua University (Min Zhang),THUIR09An,12,1000,761,239,1.17233294255569,2.59782608695652,6.61712538526032e-05
2009,Tsinghua University (Min Zhang),THUIR09An,13,1000,569,431,1.33689839572193,2.40782122905028,0.0038589054241967
2009,Tsinghua University (Min Zhang),THUIR09An,14,1000,833,167,1.09529025191676,2.0875,3.30363127143065e-06
2009,Tsinghua University (Min Zhang),THUIR09An,15,1000,968,32,1.02145045965271,2.90909090909091,1.63372043785656e-14
2009,Tsinghua University (Min Zhang),THUIR09An,16,747,745,2,1.00134048257373,2,3.36232256313196e-05
2009,Tsinghua University (Min Zhang),THUIR09An,17,1000,953,47,1.02459016393443,2.04347826086957,4.61247229963947e-05
2009,Tsinghua University (Min Zhang),THUIR09An,18,151,151,0,1,,0
2009,Tsinghua University (Min Zhang),THUIR09An,19,1000,614,386,1.27551020408163,2.27058823529412,0.000663390208695028
2009,Tsinghua University (Min Zhang),THUIR09An,20,1000,800,200,1.11856823266219,2.12765957446809,0.000419499869653961
2009,Tsinghua University (Min Zhang),THUIR09An,21,1000,767,233,1.14285714285714,2.15740740740741,0.254306761727534
2009,Tsinghua University (Min Zhang),THUIR09An,22,1000,968,32,1.01626016260163,2,0.00128701891493758
2009,Tsinghua University (Min Zhang),THUIR09An,23,1000,688,312,1.20048019207683,2.15172413793103,1.35298426083567e-05
2009,Tsinghua University (Min Zhang),THUIR09An,24,1000,693,307,1.19331742243437,2.11724137931034,0.000217914358090976
2009,Tsinghua University (Min Zhang),THUIR09An,25,1000,913,87,1.04602510460251,2.02325581395349,0.00281134811119083
2009,Tsinghua University (Min Zhang),THUIR09An,26,543,541,2,1.00184501845018,2,7.345817425956e-09
2009,Tsinghua University (Min Zhang),THUIR09An,27,1000,830,170,1.10497237569061,2.26666666666667,0.137909969491962
2009,Tsinghua University (Min Zhang),THUIR09An,28,1000,794,206,1.13765642775882,2.42352941176471,2.35698953548389e-06
2009,Tsinghua University (Min Zhang),THUIR09An,29,426,416,10,1.01187648456057,2,0.154787304656194
2009,Tsinghua University (Min Zhang),THUIR09An,30,1000,962,38,1.01936799184506,2,0.00653575928226032
2009,Tsinghua University (Min Zhang),THUIR09An,31,1000,740,260,1.18764845605701,2.54901960784314,0.153374297437168
2009,Tsinghua University (Min Zhang),THUIR09An,32,1000,988,12,1.00603621730382,2,2.84592017938535e-09
2009,Tsinghua University (Min Zhang),THUIR09An,33,1000,930,70,1.03842159916926,2.12121212121212,0.00229341661452751
2009,Tsinghua University (Min Zhang),THUIR09An,34,1000,901,99,1.05485232067511,2.1063829787234,4.32276679899588e-08
2009,Tsinghua University (Min Zhang),THUIR09An,35,1000,879,121,1.06837606837607,2.12280701754386,0.00296399384468669
2009,Tsinghua University (Min Zhang),THUIR09An,36,1000,635,365,1.26422250316056,2.33974358974359,0.0259542430031044
2009,Tsinghua University (Min Zhang),THUIR09An,37,1000,906,94,1.05932203389831,2.47368421052632,1.28366983948506e-06
2009,Tsinghua University (Min Zhang),THUIR09An,38,1000,963,37,1.01936799184506,2.05555555555556,0.000307299957481964
2009,Tsinghua University (Min Zhang),THUIR09An,39,1000,935,65,1.0351966873706,2.09677419354839,3.53234753812201e-05
2009,Tsinghua University (Min Zhang),THUIR09An,40,21,21,0,1,,0
2009,Tsinghua University (Min Zhang),THUIR09An,41,402,402,0,1,,0
2009,Tsinghua University (Min Zhang),THUIR09An,42,1000,944,56,1.03412616339193,2.43478260869565,2.49092030750254e-06
2009,Tsinghua University (Min Zhang),THUIR09An,43,1000,956,44,1.02459016393443,2.2,9.84994824594716e-15
2009,Tsinghua University (Min Zhang),THUIR09An,44,1000,952,48,1.02880658436214,2.4,0.00020305436565509
2009,Tsinghua University (Min Zhang),THUIR09An,45,1000,883,117,1.08108108108108,2.78571428571429,0.00529298675141023
2009,Tsinghua University (Min Zhang),THUIR09An,46,71,71,0,1,,0
2009,Tsinghua University (Min Zhang),THUIR09An,47,178,178,0,1,,0
2009,Tsinghua University (Min Zhang),THUIR09An,48,601,546,55,1.05438596491228,2.29166666666667,0.00727148848174924
2009,Tsinghua University (Min Zhang),THUIR09An,49,290,288,2,1.00346020761246,2,0.000379368841093068
2009,Tsinghua University (Min Zhang),THUIR09An,50,1000,975,25,1.01522842639594,2.5,0.085043285889163
2009,Tsinghua University (Min Zhang),THUIR09LuTA,1,1000,964,36,1.02669404517454,3.6,4.6123003817659e-05
2009,Tsinghua University (Min Zhang),THUIR09LuTA,2,1000,937,63,1.04166666666667,2.73913043478261,0.0931015627263525
2009,Tsinghua University (Min Zhang),THUIR09LuTA,3,1000,990,10,1.00704934541793,3.33333333333333,2.50323902284404e-08
2009,Tsinghua University (Min Zhang),THUIR09LuTA,4,1000,979,21,1.01214574898785,2.33333333333333,8.52999781428093e-13
2009,Tsinghua University (Min Zhang),THUIR09LuTA,5,1000,976,24,1.01317122593718,2.18181818181818,1.05521080212636e-05
2009,Tsinghua University (Min Zhang),THUIR09LuTA,6,1000,905,95,1.06044538706257,2.5,0.0736098929100001
2009,Tsinghua University (Min Zhang),THUIR09LuTA,7,1000,953,47,1.0351966873706,3.61538461538462,9.70190696240963e-30
2009,Tsinghua University (Min Zhang),THUIR09LuTA,8,1000,978,22,1.01522842639594,3.14285714285714,0.00020161215628793
2009,Tsinghua University (Min Zhang),THUIR09LuTA,9,1000,1000,0,1,,0
2009,Tsinghua University (Min Zhang),THUIR09LuTA,10,1000,975,25,1.01626016260163,2.77777777777778,0.00329259188752753
2009,Tsinghua University (Min Zhang),THUIR09LuTA,11,1000,561,439,1.63132137030995,8.44230769230769,0.11485694209301
2009,Tsinghua University (Min Zhang),THUIR09LuTA,12,1000,996,4,1.00200400801603,2,7.31633188957971e-23
2009,Tsinghua University (Min Zhang),THUIR09LuTA,13,1000,814,186,1.16822429906542,4.42857142857143,0.000114523238358867
2009,Tsinghua University (Min Zhang),THUIR09LuTA,14,1000,993,7,1.00401606425703,2.33333333333333,0.0110484501512245
2009,Tsinghua University (Min Zhang),THUIR09LuTA,15,1000,993,7,1.00401606425703,2.33333333333333,6.71347586398093e-08
2009,Tsinghua University (Min Zhang),THUIR09LuTA,16,1000,975,25,1.01419878296146,2.27272727272727,1.91747766892024e-21
2009,Tsinghua University (Min Zhang),THUIR09LuTA,17,1000,996,4,1.00200400801603,2,1.01902604128094e-21
2009,Tsinghua University (Min Zhang),THUIR09LuTA,18,1000,981,19,1.01112234580384,2.375,1.26115054327217e-12
2009,Tsinghua University (Min Zhang),THUIR09LuTA,19,1000,900,100,1.07181136120043,3.03030303030303,0.00192118887253127
2009,Tsinghua University (Min Zhang),THUIR09LuTA,20,1000,992,8,1.00401606425703,2,1.22255082983871e-16
2009,Tsinghua University (Min Zhang),THUIR09LuTA,21,1000,989,11,1.00704934541793,2.75,6.33037091042731e-05
2009,Tsinghua University (Min Zhang),THUIR09LuTA,22,1000,996,4,1.00200400801603,2,4.80103839488285e-23
2009,Tsinghua University (Min Zhang),THUIR09LuTA,23,1000,967,33,1.01936799184506,2.35714285714286,3.67143646854003e-13
2009,Tsinghua University (Min Zhang),THUIR09LuTA,24,1000,992,8,1.00401606425703,2,2.41381239681225e-06
2009,Tsinghua University (Min Zhang),THUIR09LuTA,25,1000,996,4,1.00200400801603,2,6.95764288090802e-40
2009,Tsinghua University (Min Zhang),THUIR09LuTA,26,1000,979,21,1.01522842639594,3.5,1.78687606532151e-05
2009,Tsinghua University (Min Zhang),THUIR09LuTA,27,1000,963,37,1.02986611740474,4.625,0.0983614959694195
2009,Tsinghua University (Min Zhang),THUIR09LuTA,28,1000,973,27,1.01626016260163,2.45454545454545,0.000364918007988925
2009,Tsinghua University (Min Zhang),THUIR09LuTA,29,1000,951,49,1.02774922918808,2.22727272727273,1.95518172765704e-06
2009,Tsinghua University (Min Zhang),THUIR09LuTA,30,1000,974,26,1.01729399796541,2.88888888888889,3.62299121421915e-07
2009,Tsinghua University (Min Zhang),THUIR09LuTA,31,1000,945,55,1.03305785123967,2.39130434782609,0.0231007246099045
2009,Tsinghua University (Min Zhang),THUIR09LuTA,32,1000,996,4,1.00200400801603,2,0.0038523563221846
2009,Tsinghua University (Min Zhang),THUIR09LuTA,33,1000,988,12,1.00704934541793,2.4,3.16629179633217e-05
2009,Tsinghua University (Min Zhang),THUIR09LuTA,34,1000,998,2,1.001001001001,2,5.01552474629375e-27
2009,Tsinghua University (Min Zhang),THUIR09LuTA,35,1000,993,7,1.00401606425703,2.33333333333333,0.0814626794334368
2009,Tsinghua University (Min Zhang),THUIR09LuTA,36,1000,976,24,1.0183299389002,4,0.0124603423678689
2009,Tsinghua University (Min Zhang),THUIR09LuTA,37,1000,996,4,1.00200400801603,2,3.14911190754002e-23
2009,Tsinghua University (Min Zhang),THUIR09LuTA,38,1000,990,10,1.00502512562814,2,0.1121931
2009,Tsinghua University (Min Zhang),THUIR09LuTA,39,1000,985,15,1.00806451612903,2.14285714285714,1.38224514592514e-08
2009,Tsinghua University (Min Zhang),THUIR09LuTA,40,1000,899,101,1.06723585912487,2.65789473684211,1.91122929636039e-08
2009,Tsinghua University (Min Zhang),THUIR09LuTA,41,1000,923,77,1.06723585912487,5.5,0.000979610499673386
2009,Tsinghua University (Min Zhang),THUIR09LuTA,42,1000,979,21,1.01317122593718,2.625,0.000450346268933032
2009,Tsinghua University (Min Zhang),THUIR09LuTA,43,1000,987,13,1.00704934541793,2.16666666666667,1.39495982228187e-28
2009,Tsinghua University (Min Zhang),THUIR09LuTA,44,1000,943,57,1.04166666666667,3.35294117647059,0.0405406583406986
2009,Tsinghua University (Min Zhang),THUIR09LuTA,45,1000,960,40,1.02354145342886,2.35294117647059,4.34513969207505e-18
2009,Tsinghua University (Min Zhang),THUIR09LuTA,46,1000,936,64,1.04166666666667,2.66666666666667,2.05345100180848e-17
2009,Tsinghua University (Min Zhang),THUIR09LuTA,47,1000,918,82,1.05596620908131,2.82758620689655,0.0316891385996949
2009,Tsinghua University (Min Zhang),THUIR09LuTA,48,1000,941,59,1.03734439834025,2.56521739130435,0.00901522985272167
2009,Tsinghua University (Min Zhang),THUIR09LuTA,49,1000,941,59,1.0351966873706,2.36,1.91555862830018e-05
2009,Tsinghua University (Min Zhang),THUIR09LuTA,50,1000,954,46,1.02880658436214,2.55555555555556,0.177663645736524
2009,Tsinghua University (Min Zhang),THUIR09TxAn,1,1000,962,38,1.02145045965271,2.23529411764706,1.42259035426327e-06
2009,Tsinghua University (Min Zhang),THUIR09TxAn,2,1000,980,20,1.01214574898785,2.5,0.0113826131894036
2009,Tsinghua University (Min Zhang),THUIR09TxAn,3,1000,986,14,1.00704934541793,2,2.34100503883891e-08
2009,Tsinghua University (Min Zhang),THUIR09TxAn,4,1000,909,91,1.05042016806723,2.11627906976744,1.22507881110872e-09
2009,Tsinghua University (Min Zhang),THUIR09TxAn,5,1000,982,18,1.00908173562059,2,2.980005681535e-06
2009,Tsinghua University (Min Zhang),THUIR09TxAn,6,1000,978,22,1.01112234580384,2,0.0316867288987672
2009,Tsinghua University (Min Zhang),THUIR09TxAn,7,1000,964,36,1.01936799184506,2.11764705882353,3.30429282570827e-13
2009,Tsinghua University (Min Zhang),THUIR09TxAn,8,1000,938,62,1.03412616339193,2.13793103448276,6.81913618059475e-07
2009,Tsinghua University (Min Zhang),THUIR09TxAn,9,1000,982,18,1.00908173562059,2,1.03549686909786e-09
2009,Tsinghua University (Min Zhang),THUIR09TxAn,10,1000,492,508,1.83150183150183,9.40740740740741,1.57092247091538e-05
2009,Tsinghua University (Min Zhang),THUIR09TxAn,11,1000,862,138,1.1001100110011,2.93617021276596,0.00816939492978258
2009,Tsinghua University (Min Zhang),THUIR09TxAn,12,1000,885,115,1.09170305676856,3.70967741935484,4.72815406918182e-05
2009,Tsinghua University (Min Zhang),THUIR09TxAn,13,1000,848,152,1.09051254089422,2.20289855072464,8.3133076690194e-08
2009,Tsinghua University (Min Zhang),THUIR09TxAn,14,1000,964,36,1.0183299389002,2,4.9700892830076e-07
2009,Tsinghua University (Min Zhang),THUIR09TxAn,15,1000,976,24,1.01317122593718,2.18181818181818,4.02549744012925e-10
2009,Tsinghua University (Min Zhang),THUIR09TxAn,16,1000,990,10,1.00502512562814,2,2.26541037865734e-17
2009,Tsinghua University (Min Zhang),THUIR09TxAn,17,1000,975,25,1.01317122593718,2.08333333333333,2.93651627256907e-21
2009,Tsinghua University (Min Zhang),THUIR09TxAn,18,1000,976,24,1.01214574898785,2,6.04216138739895e-08
2009,Tsinghua University (Min Zhang),THUIR09TxAn,19,1000,866,134,1.0752688172043,2.09375,3.4040681981516e-08
2009,Tsinghua University (Min Zhang),THUIR09TxAn,20,1000,953,47,1.02459016393443,2.04347826086957,3.30586317730054e-05
2009,Tsinghua University (Min Zhang),THUIR09TxAn,21,1000,931,69,1.03626943005181,2.02941176470588,0.0419276828947548
2009,Tsinghua University (Min Zhang),THUIR09TxAn,22,1000,994,6,1.00300902708124,2,1.09576429814969e-30
2009,Tsinghua University (Min Zhang),THUIR09TxAn,23,1000,933,67,1.0351966873706,2.03030303030303,6.62590291798378e-09
2009,Tsinghua University (Min Zhang),THUIR09TxAn,24,1000,915,85,1.04493207941484,2.02380952380952,4.61226425667785e-05
2009,Tsinghua University (Min Zhang),THUIR09TxAn,25,1000,962,38,1.01936799184506,2,1.38251697180118e-08
2009,Tsinghua University (Min Zhang),THUIR09TxAn,26,1000,984,16,1.00806451612903,2,1.75601375261433e-16
2009,Tsinghua University (Min Zhang),THUIR09TxAn,27,1000,928,72,1.03734439834025,2,0.032891016172105
2009,Tsinghua University (Min Zhang),THUIR09TxAn,28,1000,873,127,1.07991360691145,2.39622641509434,0.00292199459782032
2009,Tsinghua University (Min Zhang),THUIR09TxAn,29,1000,958,42,1.02249488752556,2.1,1.04304732500641e-25
2009,Tsinghua University (Min Zhang),THUIR09TxAn,30,1000,976,24,1.01214574898785,2,7.29464511107405e-08
2009,Tsinghua University (Min Zhang),THUIR09TxAn,31,1000,911,89,1.04931794333683,2.11904761904762,0.125504476987393
2009,Tsinghua University (Min Zhang),THUIR09TxAn,32,1000,971,29,1.01522842639594,2.07142857142857,4.7485725504715e-10
2009,Tsinghua University (Min Zhang),THUIR09TxAn,33,1000,980,20,1.01010101010101,2,5.05025368540376e-23
2009,Tsinghua University (Min Zhang),THUIR09TxAn,34,1000,938,62,1.03199174406605,2,0.00994769154033796
2009,Tsinghua University (Min Zhang),THUIR09TxAn,35,1000,936,64,1.03626943005181,2.20689655172414,0.0030100490323936
2009,Tsinghua University (Min Zhang),THUIR09TxAn,36,1000,881,119,1.06382978723404,2.01694915254237,0.0055610281967648
2009,Tsinghua University (Min Zhang),THUIR09TxAn,37,1000,981,19,1.01010101010101,2.11111111111111,2.41380460204335e-06
2009,Tsinghua University (Min Zhang),THUIR09TxAn,38,1000,955,45,1.03199174406605,3.21428571428571,5.01552487557957e-27
2009,Tsinghua University (Min Zhang),THUIR09TxAn,39,1000,976,24,1.01419878296146,2.4,1.17308688307069e-07
2009,Tsinghua University (Min Zhang),THUIR09TxAn,40,1000,940,60,1.03412616339193,2.22222222222222,6.55503905817913e-07
2009,Tsinghua University (Min Zhang),THUIR09TxAn,41,1000,922,78,1.05374077976818,2.88888888888889,0.000248903896716896
2009,Tsinghua University (Min Zhang),THUIR09TxAn,42,1000,965,35,1.01936799184506,2.1875,9.49619203071372e-06
2009,Tsinghua University (Min Zhang),THUIR09TxAn,43,1000,974,26,1.01522842639594,2.36363636363636,1.58369730519527e-06
2009,Tsinghua University (Min Zhang),THUIR09TxAn,44,1000,909,91,1.06157112526539,2.75757575757576,5.72360428791649e-16
2009,Tsinghua University (Min Zhang),THUIR09TxAn,45,1000,941,59,1.03412616339193,2.26923076923077,1.22521769280122e-09
2009,Tsinghua University (Min Zhang),THUIR09TxAn,46,1000,988,12,1.00603621730382,2,2.75421015111915e-18
2009,Tsinghua University (Min Zhang),THUIR09TxAn,47,1000,740,260,1.30378096479791,9.62962962962963,0.0106480672264749
2009,Tsinghua University (Min Zhang),THUIR09TxAn,48,1000,962,38,1.02040816326531,2.11111111111111,0.00252794772095453
2009,Tsinghua University (Min Zhang),THUIR09TxAn,49,1000,970,30,1.01522842639594,2,1.13110214134336e-14
2009,Tsinghua University (Min Zhang),THUIR09TxAn,50,1000,960,40,1.02354145342886,2.35294117647059,0.0145783045045634
2009,"SCSI, University College Dublin",UCDSIFTinter,1,1000,170,830,3.37837837837838,6.58730158730159,0.0347325841638358
2009,"SCSI, University College Dublin",UCDSIFTinter,2,1000,161,839,3.66300366300366,7.49107142857143,0.0371048553140808
2009,"SCSI, University College Dublin",UCDSIFTinter,3,1000,104,896,5.71428571428571,12.6197183098592,0.0585920392448811
2009,"SCSI, University College Dublin",UCDSIFTinter,4,1000,87,913,6.49350649350649,13.6268656716418,0.00937618513181416
2009,"SCSI, University College Dublin",UCDSIFTinter,5,1000,181,819,3.003003003003,5.38815789473684,0.0843149314985702
2009,"SCSI, University College Dublin",UCDSIFTinter,6,1000,122,878,4.60829493087558,9.24210526315789,0.142288991877085
2009,"SCSI, University College Dublin",UCDSIFTinter,7,1000,141,859,3.87596899224806,7.34188034188034,0.0281782280866052
2009,"SCSI, University College Dublin",UCDSIFTinter,8,1000,57,943,8.92857142857143,17.1454545454545,0.366958643528303
2009,"SCSI, University College Dublin",UCDSIFTinter,9,1000,155,845,3.53356890459364,6.6015625,0.0955531008792606
2009,"SCSI, University College Dublin",UCDSIFTinter,10,1000,120,880,4.80769230769231,10,0.24268898396812
2009,"SCSI, University College Dublin",UCDSIFTinter,11,1000,166,834,3.80228136882129,8.5979381443299,0.00208757136043374
2009,"SCSI, University College Dublin",UCDSIFTinter,12,1000,59,941,8.84955752212389,17.4259259259259,0.242299643528303
2009,"SCSI, University College Dublin",UCDSIFTinter,13,1000,99,901,6.45161290322581,16.0892857142857,0.251564660777948
2009,"SCSI, University College Dublin",UCDSIFTinter,14,1000,92,908,6.41025641025641,14.1875,0.0992503657579381
2009,"SCSI, University College Dublin",UCDSIFTinter,15,1000,89,911,6.36942675159236,13.3970588235294,0.0101925769972499
2009,"SCSI, University College Dublin",UCDSIFTinter,16,1000,217,783,2.67379679144385,4.98726114649682,0.0219630544728642
2009,"SCSI, University College Dublin",UCDSIFTinter,17,1000,78,922,6.89655172413793,13.7611940298507,0.2790410657171
2009,"SCSI, University College Dublin",UCDSIFTinter,18,1000,181,819,3.15457413249211,6.02205882352941,0.0146514940294096
2009,"SCSI, University College Dublin",UCDSIFTinter,19,1000,105,895,4.97512437810945,9.32291666666667,0.186351599513203
2009,"SCSI, University College Dublin",UCDSIFTinter,20,1000,104,896,4.97512437810945,9.23711340206185,0.329156589401472
2009,"SCSI, University College Dublin",UCDSIFTinter,21,1000,81,919,6.84931506849315,14.1384615384615,0.12689634524688
2009,"SCSI, University College Dublin",UCDSIFTinter,22,1000,143,857,4.03225806451613,8.16190476190476,0.0139051659187564
2009,"SCSI, University College Dublin",UCDSIFTinter,23,1000,78,922,7.93650793650794,19.2083333333333,0.251564660777948
2009,"SCSI, University College Dublin",UCDSIFTinter,24,1000,138,862,4.16666666666667,8.45098039215686,0.0864517521382272
2009,"SCSI, University College Dublin",UCDSIFTinter,25,1000,127,873,4.80769230769231,10.7777777777778,0.134593574126299
2009,"SCSI, University College Dublin",UCDSIFTinter,26,1000,238,762,2.42130750605327,4.35428571428571,0.0178069427010168
2009,"SCSI, University College Dublin",UCDSIFTinter,27,1000,96,904,5.3475935828877,9.93406593406593,0.371529835914057
2009,"SCSI, University College Dublin",UCDSIFTinter,28,1000,100,900,5.37634408602151,10.4651162790698,0.305980761332161
2009,"SCSI, University College Dublin",UCDSIFTinter,29,1000,195,805,2.98507462686567,5.75,0.0248566036274405
2009,"SCSI, University College Dublin",UCDSIFTinter,30,1000,142,858,3.86100386100386,7.33333333333333,0.0313464920921892
2009,"SCSI, University College Dublin",UCDSIFTinter,31,1000,59,941,8.7719298245614,17.1090909090909,0.366447376713739
2009,"SCSI, University College Dublin",UCDSIFTinter,32,1000,208,792,2.93255131964809,5.95488721804511,0.017505974190489
2009,"SCSI, University College Dublin",UCDSIFTinter,33,1000,130,870,4.60829493087558,10,0.104186428123871
2009,"SCSI, University College Dublin",UCDSIFTinter,34,1000,121,879,4.80769230769231,10.1034482758621,0.110854168194667
2009,"SCSI, University College Dublin",UCDSIFTinter,35,1000,103,897,5.26315789473684,10.3103448275862,0.294140063752497
2009,"SCSI, University College Dublin",UCDSIFTinter,36,1000,76,924,6.25,11,0.364891292515748
2009,"SCSI, University College Dublin",UCDSIFTinter,37,1000,115,885,4.60829493087558,8.67647058823529,0.0417104084961424
2009,"SCSI, University College Dublin",UCDSIFTinter,38,1000,109,891,5.58659217877095,12.7285714285714,0.234189106165704
2009,"SCSI, University College Dublin",UCDSIFTinter,39,1000,153,847,3.64963503649635,7,0.0250783735324056
2009,"SCSI, University College Dublin",UCDSIFTinter,40,163,69,94,1.75268817204301,3.91666666666667,0.0613441173402951
2009,"SCSI, University College Dublin",UCDSIFTinter,41,1000,188,812,2.89017341040462,5.13924050632911,0.0763526477237642
2009,"SCSI, University College Dublin",UCDSIFTinter,42,1000,187,813,3.25732899022801,6.775,0.0302664085458963
2009,"SCSI, University College Dublin",UCDSIFTinter,43,1000,174,826,3.40136054421769,6.88333333333333,0.0142492995205599
2009,"SCSI, University College Dublin",UCDSIFTinter,44,1000,144,856,3.42465753424658,5.78378378378378,0.030539238782712
2009,"SCSI, University College Dublin",UCDSIFTinter,45,1000,158,842,3.84615384615385,8.25490196078432,0.156296017122174
2009,"SCSI, University College Dublin",UCDSIFTinter,46,1000,136,864,4.29184549356223,8.90721649484536,0.144789135203929
2009,"SCSI, University College Dublin",UCDSIFTinter,47,1000,176,824,3.3112582781457,6.53968253968254,0.042648478333154
2009,"SCSI, University College Dublin",UCDSIFTinter,48,1000,141,859,4.52488687782805,10.7375,0.117338060515547
2009,"SCSI, University College Dublin",UCDSIFTinter,49,1000,240,760,2.42130750605327,4.39306358381503,0.128438677614699
2009,"SCSI, University College Dublin",UCDSIFTinter,50,1000,198,802,3.15457413249211,6.73949579831933,0.0034409837167557
2009,"SCSI, University College Dublin",UCDSIFTprob,1,1000,305,695,2.17391304347826,4.48387096774194,0.994605630450821
2009,"SCSI, University College Dublin",UCDSIFTprob,2,1000,250,750,2.73972602739726,6.52173913043478,0.998470950633597
2009,"SCSI, University College Dublin",UCDSIFTprob,3,1000,19,981,10.6382978723404,13.08,0.99997003093271
2009,"SCSI, University College Dublin",UCDSIFTprob,4,1000,23,977,9.25925925925926,11.4941176470588,0.99943988111467
2009,"SCSI, University College Dublin",UCDSIFTprob,5,1000,459,541,1.53374233128834,2.80310880829016,0.994095696166755
2009,"SCSI, University College Dublin",UCDSIFTprob,6,1000,74,926,4.80769230769231,6.91044776119403,0.99900058023665
2009,"SCSI, University College Dublin",UCDSIFTprob,7,1000,184,816,2.71739130434783,4.43478260869565,0.995652117253595
2009,"SCSI, University College Dublin",UCDSIFTprob,8,1000,0,1000,58.8235294117647,58.8235294117647,1
2009,"SCSI, University College Dublin",UCDSIFTprob,9,1000,208,792,2.4330900243309,3.90147783251232,0.990570977926692
2009,"SCSI, University College Dublin",UCDSIFTprob,10,1000,140,860,3.54609929078014,6.05633802816901,0.999688848916746
2009,"SCSI, University College Dublin",UCDSIFTprob,11,1000,237,763,2.52525252525253,4.79874213836478,0.997324394367288
2009,"SCSI, University College Dublin",UCDSIFTprob,12,1000,7,993,22.2222222222222,26.1315789473684,0.899021212004195
2009,"SCSI, University College Dublin",UCDSIFTprob,13,1000,0,1000,58.8235294117647,58.8235294117647,1
2009,"SCSI, University College Dublin",UCDSIFTprob,14,1000,17,983,11.4942528735632,14.0428571428571,0.918892942494933
2009,"SCSI, University College Dublin",UCDSIFTprob,15,1000,17,983,14.7058823529412,19.2745098039216,0.999999999351136
2009,"SCSI, University College Dublin",UCDSIFTprob,16,1000,485,515,1.58227848101266,3.50340136054422,0.870573994361051
2009,"SCSI, University College Dublin",UCDSIFTprob,17,1000,40,960,11.1111111111111,19.2,0.718985736756003
2009,"SCSI, University College Dublin",UCDSIFTprob,18,1000,311,689,2.01207243460765,3.70430107526882,0.998651677835351
2009,"SCSI, University College Dublin",UCDSIFTprob,19,1000,45,955,5.58659217877095,7.12686567164179,0.996638418058653
2009,"SCSI, University College Dublin",UCDSIFTprob,20,1000,111,889,3.96825396825397,6.30496453900709,0.899557594767316
2009,"SCSI, University College Dublin",UCDSIFTprob,21,1000,31,969,9.43396226415094,12.92,0.999999852865176
2009,"SCSI, University College Dublin",UCDSIFTprob,22,1000,125,875,3.7037037037037,6.03448275862069,0.999180666937286
2009,"SCSI, University College Dublin",UCDSIFTprob,23,1000,4,996,25.6410256410256,28.4571428571429,1
2009,"SCSI, University College Dublin",UCDSIFTprob,24,1000,154,846,2.80898876404494,4.18811881188119,0.999082008626217
2009,"SCSI, University College Dublin",UCDSIFTprob,25,1000,75,925,4.52488687782805,6.33561643835617,0.995581842269311
2009,"SCSI, University College Dublin",UCDSIFTprob,26,1000,632,368,1.32275132275132,2.96774193548387,0.974526660806213
2009,"SCSI, University College Dublin",UCDSIFTprob,27,1000,50,950,6.17283950617284,8.48214285714286,0.999924312999476
2009,"SCSI, University College Dublin",UCDSIFTprob,28,1000,25,975,8.92857142857143,11.2068965517241,0.999419371538533
2009,"SCSI, University College Dublin",UCDSIFTprob,29,1000,262,738,2.32558139534884,4.39285714285714,0.777544134104859
2009,"SCSI, University College Dublin",UCDSIFTprob,30,1000,119,881,4.08163265306122,6.99206349206349,0.613329127035021
2009,"SCSI, University College Dublin",UCDSIFTprob,31,1000,14,986,26.3157894736842,41.0833333333333,0.999173003710696
2009,"SCSI, University College Dublin",UCDSIFTprob,32,1000,389,611,1.66666666666667,2.8957345971564,0.820321696873086
2009,"SCSI, University College Dublin",UCDSIFTprob,33,1000,80,920,4.76190476190476,7.07692307692308,0.950098861752438
2009,"SCSI, University College Dublin",UCDSIFTprob,34,1000,56,944,5.43478260869565,7.375,0.999796677358963
2009,"SCSI, University College Dublin",UCDSIFTprob,35,1000,50,950,5.84795321637427,7.85123966942149,0.997398099359048
2009,"SCSI, University College Dublin",UCDSIFTprob,36,1000,15,985,12.8205128205128,15.6349206349206,1
2009,"SCSI, University College Dublin",UCDSIFTprob,37,1000,89,911,4.50450450450451,6.84962406015038,0.999892993745091
2009,"SCSI, University College Dublin",UCDSIFTprob,38,1000,75,925,5.4945054945055,8.64485981308411,0.969951581005697
2009,"SCSI, University College Dublin",UCDSIFTprob,39,1000,244,756,2.2883295194508,3.91709844559586,0.986595189151997
2009,"SCSI, University College Dublin",UCDSIFTprob,40,163,68,95,1.63,2.96875,0.730126860911353
2009,"SCSI, University College Dublin",UCDSIFTprob,41,1000,487,513,1.5527950310559,3.26751592356688,0.997943052173693
2009,"SCSI, University College Dublin",UCDSIFTprob,42,1000,310,690,2.04918032786885,3.87640449438202,0.998302013599532
2009,"SCSI, University College Dublin",UCDSIFTprob,43,1000,292,708,2.04081632653061,3.57575757575758,0.999118564687777
2009,"SCSI, University College Dublin",UCDSIFTprob,44,1000,362,638,1.84842883548983,3.56424581005587,0.99896827842472
2009,"SCSI, University College Dublin",UCDSIFTprob,45,1000,221,779,2.52525252525253,4.45142857142857,0.937239290382848
2009,"SCSI, University College Dublin",UCDSIFTprob,46,1000,150,850,3.33333333333333,5.66666666666667,0.999999887588433
2009,"SCSI, University College Dublin",UCDSIFTprob,47,1000,289,711,2.14132762312634,3.99438202247191,0.9669938325098
2009,"SCSI, University College Dublin",UCDSIFTprob,48,1000,118,882,4.03225806451613,6.78461538461538,0.994455648078784
2009,"SCSI, University College Dublin",UCDSIFTprob,49,1000,620,380,1.33155792276964,2.90076335877863,0.982306176394801
2009,"SCSI, University College Dublin",UCDSIFTprob,50,1000,317,683,1.90839694656489,3.29951690821256,0.997516499815269
2009,"SCSI, University College Dublin",UCDSIFTslide,1,1000,281,719,2.42130750605327,5.4469696969697,0.0268974606715194
2009,"SCSI, University College Dublin",UCDSIFTslide,2,1000,297,703,2.24215246636771,4.71812080536913,0.106575569255552
2009,"SCSI, University College Dublin",UCDSIFTslide,3,1000,258,742,2.5,5.22535211267606,0.0270410206185638
2009,"SCSI, University College Dublin",UCDSIFTslide,4,1000,226,774,2.89017341040462,6.45,0.0838736977758916
2009,"SCSI, University College Dublin",UCDSIFTslide,5,1000,376,624,1.8348623853211,3.69230769230769,0.116985429772551
2009,"SCSI, University College Dublin",UCDSIFTslide,6,1000,279,721,2.27272727272727,4.47826086956522,0.00329870752248333
2009,"SCSI, University College Dublin",UCDSIFTslide,7,1000,292,708,2.3094688221709,5.02127659574468,0.00198705933834475
2009,"SCSI, University College Dublin",UCDSIFTslide,8,1000,93,907,4.40528634361233,6.76865671641791,0.0292113669719526
2009,"SCSI, University College Dublin",UCDSIFTslide,9,1000,302,698,2.2271714922049,4.74829931972789,0.0158192518819431
2009,"SCSI, University College Dublin",UCDSIFTslide,10,1000,279,721,2.25733634311512,4.39634146341463,0.0181623097762756
2009,"SCSI, University College Dublin",UCDSIFTslide,11,1000,236,764,2.67379679144385,5.53623188405797,0.00531055674831295
2009,"SCSI, University College Dublin",UCDSIFTslide,12,1000,93,907,4.40528634361233,6.76865671641791,0.0292113669719526
2009,"SCSI, University College Dublin",UCDSIFTslide,13,1000,156,844,2.9940119760479,4.74157303370787,0.0825336936945862
2009,"SCSI, University College Dublin",UCDSIFTslide,14,1000,148,852,3.50877192982456,6.21897810218978,0.0879066539146283
2009,"SCSI, University College Dublin",UCDSIFTslide,15,1000,111,889,4.20168067226891,7,0.0107681887573834
2009,"SCSI, University College Dublin",UCDSIFTslide,16,1000,391,609,1.85528756957328,4.11486486486487,0.0388394197272103
2009,"SCSI, University College Dublin",UCDSIFTslide,17,1000,168,832,3.43642611683849,6.76422764227642,0.119473939156223
2009,"SCSI, University College Dublin",UCDSIFTslide,18,1000,338,662,2.02429149797571,4.24358974358974,0.00574198658016934
2009,"SCSI, University College Dublin",UCDSIFTslide,19,1000,215,785,2.91545189504373,6.1328125,0.00299618415543441
2009,"SCSI, University College Dublin",UCDSIFTslide,20,1000,240,760,2.67379679144385,5.67164179104478,0.0172599977422811
2009,"SCSI, University College Dublin",UCDSIFTslide,21,1000,209,791,2.9940119760479,6.328,0.00129686249267854
2009,"SCSI, University College Dublin",UCDSIFTslide,22,1000,286,714,2.17864923747277,4.1271676300578,0.128897878083671
2009,"SCSI, University College Dublin",UCDSIFTslide,23,1000,146,854,3.20512820512821,5.14457831325301,0.0825336934531653
2009,"SCSI, University College Dublin",UCDSIFTslide,24,1000,290,710,2.2271714922049,4.46540880503145,0.0157722972983505
2009,"SCSI, University College Dublin",UCDSIFTslide,25,1000,203,797,2.89017341040462,5.57342657342657,0.00919497445028878
2009,"SCSI, University College Dublin",UCDSIFTslide,26,1000,394,606,1.7921146953405,3.69512195121951,0.0281791182079306
2009,"SCSI, University College Dublin",UCDSIFTslide,27,1000,203,797,2.84900284900285,5.38513513513514,0.0414075411837329
2009,"SCSI, University College Dublin",UCDSIFTslide,28,1000,285,715,2.23713646532438,4.41358024691358,0.0117589899510852
2009,"SCSI, University College Dublin",UCDSIFTslide,29,1000,304,696,2.2271714922049,4.8,0.0254769692108041
2009,"SCSI, University College Dublin",UCDSIFTslide,30,1000,302,698,2.16919739696312,4.38993710691824,0.123180684583513
2009,"SCSI, University College Dublin",UCDSIFTslide,31,1000,93,907,4.3859649122807,6.71851851851852,0.0290589909695505
2009,"SCSI, University College Dublin",UCDSIFTslide,32,1000,344,656,2.03252032520325,4.43243243243243,0.0211185497556925
2009,"SCSI, University College Dublin",UCDSIFTslide,33,1000,296,704,2.34192037470726,5.37404580152672,0.00189356096361752
2009,"SCSI, University College Dublin",UCDSIFTslide,34,1000,352,648,2,4.37837837837838,0.0749585769747407
2009,"SCSI, University College Dublin",UCDSIFTslide,35,1000,233,767,2.55754475703325,4.85443037974684,0.102350326352326
2009,"SCSI, University College Dublin",UCDSIFTslide,36,1000,248,752,2.38095238095238,4.37209302325581,0.0173528365060756
2009,"SCSI, University College Dublin",UCDSIFTslide,37,1000,327,673,2.02429149797571,4.02994011976048,0.0970452020433091
2009,"SCSI, University College Dublin",UCDSIFTslide,38,1000,172,828,3.52112676056338,7.39285714285714,0.0167932718292697
2009,"SCSI, University College Dublin",UCDSIFTslide,39,1000,302,698,2.24215246636771,4.84722222222222,0.0207928126593517
2009,"SCSI, University College Dublin",UCDSIFTslide,40,163,87,76,1.38135593220339,2.45161290322581,0.0559725362623229
2009,"SCSI, University College Dublin",UCDSIFTslide,41,1000,390,610,1.86567164179104,4.17808219178082,0.0110261106420986
2009,"SCSI, University College Dublin",UCDSIFTslide,42,1000,327,673,2.22222222222222,5.47154471544716,0.0561079794228663
2009,"SCSI, University College Dublin",UCDSIFTslide,43,1000,325,675,2.05761316872428,4.19254658385093,0.00146130292547036
2009,"SCSI, University College Dublin",UCDSIFTslide,44,1000,335,665,2.05338809034908,4.375,0.0539009967116103
2009,"SCSI, University College Dublin",UCDSIFTslide,45,1000,260,740,2.48756218905473,5.2112676056338,0.0143157013412545
2009,"SCSI, University College Dublin",UCDSIFTslide,46,1000,282,718,2.2883295194508,4.63225806451613,0.00617170399985692
2009,"SCSI, University College Dublin",UCDSIFTslide,47,1000,353,647,1.97628458498024,4.22875816993464,0.0334476539412417
2009,"SCSI, University College Dublin",UCDSIFTslide,48,1000,192,808,2.86532951289398,5.14649681528662,0.0305190715382605
2009,"SCSI, University College Dublin",UCDSIFTslide,49,1000,369,631,1.93798449612403,4.29251700680272,0.0109832798283757
2009,"SCSI, University College Dublin",UCDSIFTslide,50,1000,320,680,2.06611570247934,4.14634146341463,0.0300289064595902
2009,University of Delaware (Fang),UDWAxBL,1,1000,912,88,1.04931794333683,2.14634146341463,0.142599829198816
2009,University of Delaware (Fang),UDWAxBL,2,1000,913,87,1.04931794333683,2.175,0.000520670840143534
2009,University of Delaware (Fang),UDWAxBL,3,1000,783,217,1.12994350282486,2.12745098039216,0.00653000964694896
2009,University of Delaware (Fang),UDWAxBL,4,1000,882,118,1.06496272630458,2.07017543859649,2.82780927697181e-06
2009,University of Delaware (Fang),UDWAxBL,5,1000,903,97,1.05263157894737,2.06382978723404,0.0270581237228474
2009,University of Delaware (Fang),UDWAxBL,6,1000,897,103,1.05485232067511,2.01960784313725,0.000265022567995974
2009,University of Delaware (Fang),UDWAxBL,7,1000,781,219,1.13507377979569,2.19,4.4437285910135e-05
2009,University of Delaware (Fang),UDWAxBL,8,1000,793,207,1.11856823266219,2.04950495049505,1.87256942843109e-05
2009,University of Delaware (Fang),UDWAxBL,9,1000,653,347,1.24688279301746,2.32885906040268,0.0296568349439301
2009,University of Delaware (Fang),UDWAxBL,10,1000,804,196,1.11856823266219,2.17777777777778,0.0645440943456399
2009,University of Delaware (Fang),UDWAxBL,11,1000,970,30,1.01522842639594,2,0.129913291640998
2009,University of Delaware (Fang),UDWAxBL,12,1000,516,484,1.39275766016713,2.3960396039604,0.119177271102665
2009,University of Delaware (Fang),UDWAxBL,13,1000,133,867,2.97619047619048,4.27093596059113,0.168331323447217
2009,University of Delaware (Fang),UDWAxBL,14,1000,828,172,1.09529025191676,2.02352941176471,0.000722290660363283
2009,University of Delaware (Fang),UDWAxBL,15,1000,798,202,1.11856823266219,2.10416666666667,0.0259784425754239
2009,University of Delaware (Fang),UDWAxBL,16,1000,946,54,1.02880658436214,2.07692307692308,8.79500444179977e-05
2009,University of Delaware (Fang),UDWAxBL,17,1000,847,153,1.085776330076,2.06756756756757,0.000273558536256513
2009,University of Delaware (Fang),UDWAxBL,18,1000,958,42,1.02249488752556,2.1,1.26675004012667e-15
2009,University of Delaware (Fang),UDWAxBL,19,1000,506,494,1.3986013986014,2.36363636363636,0.0744824975123103
2009,University of Delaware (Fang),UDWAxBL,20,1000,851,149,1.08225108225108,2.04109589041096,0.0041018694002898
2009,University of Delaware (Fang),UDWAxBL,21,1000,826,174,1.10253583241455,2.14814814814815,0.0274436252073564
2009,University of Delaware (Fang),UDWAxBL,22,1000,978,22,1.01112234580384,2,0.0989307310737355
2009,University of Delaware (Fang),UDWAxBL,23,1000,399,601,1.63398692810458,2.82159624413146,0.00140136691121201
2009,University of Delaware (Fang),UDWAxBL,24,1000,745,255,1.16009280742459,2.17948717948718,0.00556365072760058
2009,University of Delaware (Fang),UDWAxBL,25,1000,879,121,1.06496272630458,2.01666666666667,0.0208052336526904
2009,University of Delaware (Fang),UDWAxBL,26,1000,917,83,1.04384133611691,2.02439024390244,0.000757211524852823
2009,University of Delaware (Fang),UDWAxBL,27,1000,912,88,1.04712041884817,2.04651162790698,0.00108802118978838
2009,University of Delaware (Fang),UDWAxBL,28,1000,881,119,1.06837606837607,2.16363636363636,7.21415430378631e-06
2009,University of Delaware (Fang),UDWAxBL,29,1000,922,78,1.04058272632674,2,9.68913243450689e-05
2009,University of Delaware (Fang),UDWAxBL,30,1000,880,120,1.06496272630458,2.03389830508475,0.0626060549809962
2009,University of Delaware (Fang),UDWAxBL,31,1000,884,116,1.06496272630458,2.10909090909091,0.00887347053418628
2009,University of Delaware (Fang),UDWAxBL,32,1000,729,271,1.17096018735363,2.168,0.039394661325734
2009,University of Delaware (Fang),UDWAxBL,33,1000,918,82,1.04384133611691,2.05,0.000140824474698471
2009,University of Delaware (Fang),UDWAxBL,34,1000,473,527,1.46198830409357,2.49763033175355,0.00531025993284472
2009,University of Delaware (Fang),UDWAxBL,35,1000,890,110,1.06269925611052,2.15686274509804,0.114467879618021
2009,University of Delaware (Fang),UDWAxBL,36,1000,686,314,1.20627261761158,2.1958041958042,0.00654608228030492
2009,University of Delaware (Fang),UDWAxBL,37,1000,778,222,1.17647058823529,3.08333333333333,1.18373883821448e-05
2009,University of Delaware (Fang),UDWAxBL,38,1000,854,146,1.08108108108108,2.05633802816901,1.52290571302396e-05
2009,University of Delaware (Fang),UDWAxBL,39,1000,935,65,1.03412616339193,2.03125,0.00108801979706334
2009,University of Delaware (Fang),UDWAxBL,40,141,129,12,1.04444444444444,2,0.0471121366215224
2009,University of Delaware (Fang),UDWAxBL,41,1000,948,52,1.02669404517454,2,1.44155843545245e-07
2009,University of Delaware (Fang),UDWAxBL,42,1000,824,176,1.1001100110011,2.07058823529412,0.00532964398985006
2009,University of Delaware (Fang),UDWAxBL,43,1000,926,74,1.04058272632674,2.11428571428571,0.0330805326788487
2009,University of Delaware (Fang),UDWAxBL,44,1000,768,232,1.14025085518814,2.12844036697248,0.0645123997857107
2009,University of Delaware (Fang),UDWAxBL,45,1000,843,157,1.09170305676856,2.15068493150685,2.80608823406719e-05
2009,University of Delaware (Fang),UDWAxBL,46,1000,938,62,1.03305785123967,2.06666666666667,0.00280838177793238
2009,University of Delaware (Fang),UDWAxBL,47,1000,967,33,1.01729399796541,2.0625,9.90515689638003e-17
2009,University of Delaware (Fang),UDWAxBL,48,1000,938,62,1.0351966873706,2.21428571428571,2.62348137148136e-08
2009,University of Delaware (Fang),UDWAxBL,49,1000,865,135,1.08342361863489,2.32758620689655,4.54204595272725e-06
2009,University of Delaware (Fang),UDWAxBL,50,1000,949,51,1.02669404517454,2.04,1.22752142108978e-09
2009,University of Delaware (Fang),UDWAxQE,1,1000,901,99,1.05374077976818,2.0625,0.302478972089133
2009,University of Delaware (Fang),UDWAxQE,2,1000,970,30,1.01626016260163,2.14285714285714,0.0105626527376214
2009,University of Delaware (Fang),UDWAxQE,3,1000,785,215,1.12485939257593,2.06730769230769,2.6662182970794e-05
2009,University of Delaware (Fang),UDWAxQE,4,1000,974,26,1.01317122593718,2,2.30519534562095e-09
2009,University of Delaware (Fang),UDWAxQE,5,1000,938,62,1.03199174406605,2,5.02899293706027e-05
2009,University of Delaware (Fang),UDWAxQE,6,1000,932,68,1.03734439834025,2.125,2.75461452647955e-05
2009,University of Delaware (Fang),UDWAxQE,7,1000,901,99,1.05263157894737,2.02040816326531,0.000881991903385774
2009,University of Delaware (Fang),UDWAxQE,8,1000,884,116,1.06951871657754,2.27450980392157,8.49342605090386e-06
2009,University of Delaware (Fang),UDWAxQE,9,1000,932,68,1.03626943005181,2.06060606060606,3.69798765642963e-06
2009,University of Delaware (Fang),UDWAxQE,10,1000,952,48,1.02774922918808,2.28571428571429,6.86771923769878e-08
2009,University of Delaware (Fang),UDWAxQE,11,1000,925,75,1.04166666666667,2.14285714285714,0.0392383821335312
2009,University of Delaware (Fang),UDWAxQE,12,1000,940,60,1.03305785123967,2.14285714285714,0.00840484802039971
2009,University of Delaware (Fang),UDWAxQE,13,1000,912,88,1.04712041884817,2.04651162790698,0.0065838781072527
2009,University of Delaware (Fang),UDWAxQE,14,1000,933,67,1.03734439834025,2.16129032258065,4.43288278868405e-08
2009,University of Delaware (Fang),UDWAxQE,15,1000,917,83,1.04384133611691,2.02439024390244,0.0692123596484767
2009,University of Delaware (Fang),UDWAxQE,16,1000,989,11,1.00603621730382,2.2,5.92797691783799e-23
2009,University of Delaware (Fang),UDWAxQE,17,1000,968,32,1.01626016260163,2,6.04375741700808e-08
2009,University of Delaware (Fang),UDWAxQE,18,1000,924,76,1.04058272632674,2.05405405405405,5.07307207450114e-08
2009,University of Delaware (Fang),UDWAxQE,19,1000,346,654,1.73010380622837,2.81896551724138,0.00804186695930168
2009,University of Delaware (Fang),UDWAxQE,20,1000,640,360,1.30548302872063,2.85714285714286,0.0832184888416721
2009,University of Delaware (Fang),UDWAxQE,21,1000,866,134,1.07991360691145,2.23333333333333,0.00244763785197628
2009,University of Delaware (Fang),UDWAxQE,22,1000,923,77,1.05263157894737,2.85185185185185,3.16213353558107e-09
2009,University of Delaware (Fang),UDWAxQE,23,1000,952,48,1.02459016393443,2,1.62053741225827e-12
2009,University of Delaware (Fang),UDWAxQE,24,1000,890,110,1.05932203389831,2.03703703703704,7.82965677947146e-09
2009,University of Delaware (Fang),UDWAxQE,25,1000,923,77,1.04058272632674,2.02631578947368,0.00859296712937674
2009,University of Delaware (Fang),UDWAxQE,26,1000,900,100,1.05485232067511,2.08333333333333,3.44069845035716e-10
2009,University of Delaware (Fang),UDWAxQE,27,1000,949,51,1.02669404517454,2.04,0.00989436819946874
2009,University of Delaware (Fang),UDWAxQE,28,1000,910,90,1.05042016806723,2.14285714285714,0.0068089164866149
2009,University of Delaware (Fang),UDWAxQE,29,1000,951,49,1.02564102564103,2.04166666666667,2.07742005250226e-09
2009,University of Delaware (Fang),UDWAxQE,30,1000,953,47,1.02459016393443,2.04347826086957,5.43791996445122e-08
2009,University of Delaware (Fang),UDWAxQE,31,1000,741,259,1.19760479041916,2.75531914893617,0.0683234568165514
2009,University of Delaware (Fang),UDWAxQE,32,1000,865,135,1.07642626480086,2.109375,0.000183540921881192
2009,University of Delaware (Fang),UDWAxQE,33,1000,983,17,1.00908173562059,2.125,6.41140268715679e-11
2009,University of Delaware (Fang),UDWAxQE,34,1000,849,151,1.12107623318386,3.51162790697674,4.54759658740095e-15
2009,University of Delaware (Fang),UDWAxQE,35,1000,965,35,1.01936799184506,2.1875,6.13556743419793e-07
2009,University of Delaware (Fang),UDWAxQE,36,1000,972,28,1.01419878296146,2,0.0034671232512943
2009,University of Delaware (Fang),UDWAxQE,37,1000,950,50,1.02669404517454,2.08333333333333,8.79546114355577e-11
2009,University of Delaware (Fang),UDWAxQE,38,1000,958,42,1.02145045965271,2,0.000881295575118974
2009,University of Delaware (Fang),UDWAxQE,39,1000,954,46,1.02459016393443,2.09090909090909,0.0047337704468643
2009,University of Delaware (Fang),UDWAxQE,40,1000,951,49,1.03199174406605,2.72222222222222,0.000116077436672071
2009,University of Delaware (Fang),UDWAxQE,41,1000,898,102,1.06157112526539,2.31818181818182,3.98302167826414e-09
2009,University of Delaware (Fang),UDWAxQE,42,1000,884,116,1.06269925611052,2.03508771929825,0.0487809296373355
2009,University of Delaware (Fang),UDWAxQE,43,1000,951,49,1.02564102564103,2.04166666666667,0.0208682736358214
2009,University of Delaware (Fang),UDWAxQE,44,1000,908,92,1.04931794333683,2.04444444444444,0.0549878630947198
2009,University of Delaware (Fang),UDWAxQE,45,1000,945,55,1.02880658436214,2.03703703703704,2.21315136250465e-12
2009,University of Delaware (Fang),UDWAxQE,46,1000,895,105,1.05820105820106,2.1,1.91166881843156e-07
2009,University of Delaware (Fang),UDWAxQE,47,1000,967,33,1.01729399796541,2.0625,0.000148258056660547
2009,University of Delaware (Fang),UDWAxQE,48,1000,946,54,1.02986611740474,2.16,1.3026326515847e-05
2009,University of Delaware (Fang),UDWAxQE,49,1000,895,105,1.06157112526539,2.23404255319149,0.0020902069928706
2009,University of Delaware (Fang),UDWAxQE,50,1000,970,30,1.01522842639594,2,7.88594028872188e-08
2009,University of Delaware (Fang),UDWAxQEWeb,1,1000,880,120,1.06496272630458,2.03389830508475,0.330419616257151
2009,University of Delaware (Fang),UDWAxQEWeb,2,1000,971,29,1.01626016260163,2.23076923076923,0.000137568571913226
2009,University of Delaware (Fang),UDWAxQEWeb,3,1000,926,74,1.03950103950104,2.05555555555556,0.0382730574344614
2009,University of Delaware (Fang),UDWAxQEWeb,4,1000,970,30,1.01522842639594,2,0.00587491052927725
2009,University of Delaware (Fang),UDWAxQEWeb,5,1000,866,134,1.07411385606874,2.06153846153846,0.00252753908857985
2009,University of Delaware (Fang),UDWAxQEWeb,6,1000,912,88,1.04602510460251,2,0.124659002700008
2009,University of Delaware (Fang),UDWAxQEWeb,7,1000,870,130,1.07411385606874,2.13114754098361,0.00010552782641704
2009,University of Delaware (Fang),UDWAxQEWeb,8,1000,934,66,1.03412616339193,2,5.12471052793304e-05
2009,University of Delaware (Fang),UDWAxQEWeb,9,1000,938,62,1.0351966873706,2.21428571428571,3.30779934006902e-13
2009,University of Delaware (Fang),UDWAxQEWeb,10,1000,899,101,1.05485232067511,2.06122448979592,0.00243446134927521
2009,University of Delaware (Fang),UDWAxQEWeb,11,1000,938,62,1.03305785123967,2.06666666666667,0.00719215472206192
2009,University of Delaware (Fang),UDWAxQEWeb,12,1000,881,119,1.06382978723404,2.01694915254237,2.48437269316969e-07
2009,University of Delaware (Fang),UDWAxQEWeb,13,1000,924,76,1.04166666666667,2.11111111111111,0.010715491545823
2009,University of Delaware (Fang),UDWAxQEWeb,14,1000,947,53,1.02774922918808,2.03846153846154,3.73592482807796e-05
2009,University of Delaware (Fang),UDWAxQEWeb,15,1000,906,94,1.04931794333683,2,0.0434659615187834
2009,University of Delaware (Fang),UDWAxQEWeb,16,1000,958,42,1.02145045965271,2,9.49699580807812e-06
2009,University of Delaware (Fang),UDWAxQEWeb,17,1000,938,62,1.03199174406605,2,3.67912458203357e-06
2009,University of Delaware (Fang),UDWAxQEWeb,18,1000,935,65,1.03626943005181,2.16666666666667,1.18808231938042e-11
2009,University of Delaware (Fang),UDWAxQEWeb,19,1000,920,80,1.04384133611691,2.10526315789474,0.0323052794096916
2009,University of Delaware (Fang),UDWAxQEWeb,20,1000,959,41,1.02145045965271,2.05,1.4473902798255e-05
2009,University of Delaware (Fang),UDWAxQEWeb,21,1000,928,72,1.03842159916926,2.05714285714286,0.0316866742493207
2009,University of Delaware (Fang),UDWAxQEWeb,22,1000,986,14,1.00704934541793,2,2.12198859439042e-05
2009,University of Delaware (Fang),UDWAxQEWeb,23,1000,317,683,1.82815356489945,2.9695652173913,0.0617243569567029
2009,University of Delaware (Fang),UDWAxQEWeb,24,1000,902,98,1.05263157894737,2.04166666666667,0.00312051099761192
2009,University of Delaware (Fang),UDWAxQEWeb,25,1000,890,110,1.06269925611052,2.15686274509804,0.0179754147442568
2009,University of Delaware (Fang),UDWAxQEWeb,26,1000,928,72,1.03734439834025,2,2.56875658316846e-06
2009,University of Delaware (Fang),UDWAxQEWeb,27,1000,962,38,1.02040816326531,2.11111111111111,5.77072760048516e-11
2009,University of Delaware (Fang),UDWAxQEWeb,28,1000,923,77,1.04275286757039,2.13888888888889,0.182488165844016
2009,University of Delaware (Fang),UDWAxQEWeb,29,1000,917,83,1.04384133611691,2.02439024390244,3.51349560050583e-09
2009,University of Delaware (Fang),UDWAxQEWeb,30,1000,922,78,1.04166666666667,2.05263157894737,0.000949516406454841
2009,University of Delaware (Fang),UDWAxQEWeb,31,1000,917,83,1.04602510460251,2.12820512820513,0.0602403369559996
2009,University of Delaware (Fang),UDWAxQEWeb,32,1000,868,132,1.07642626480086,2.16393442622951,0.00204247472288339
2009,University of Delaware (Fang),UDWAxQEWeb,33,1000,956,44,1.02249488752556,2,3.37745563726e-12
2009,University of Delaware (Fang),UDWAxQEWeb,34,1000,918,82,1.04602510460251,2.15789473684211,0.000645700868273826
2009,University of Delaware (Fang),UDWAxQEWeb,35,1000,961,39,1.02040816326531,2.05263157894737,5.59546889992132e-07
2009,University of Delaware (Fang),UDWAxQEWeb,36,1000,970,30,1.01522842639594,2,1.06697120089361e-12
2009,University of Delaware (Fang),UDWAxQEWeb,37,1000,968,32,1.01626016260163,2,5.10979161846608e-19
2009,University of Delaware (Fang),UDWAxQEWeb,38,1000,922,78,1.04166666666667,2.05263157894737,0.00135272980363574
2009,University of Delaware (Fang),UDWAxQEWeb,39,1000,960,40,1.02040816326531,2,1.28284752596472e-06
2009,University of Delaware (Fang),UDWAxQEWeb,40,1000,934,66,1.03412616339193,2,3.55704388474453e-06
2009,University of Delaware (Fang),UDWAxQEWeb,41,1000,948,52,1.02669404517454,2,1.38231422636325e-08
2009,University of Delaware (Fang),UDWAxQEWeb,42,1000,891,109,1.05932203389831,2.05660377358491,0.0265744529279243
2009,University of Delaware (Fang),UDWAxQEWeb,43,1000,931,69,1.03626943005181,2.02941176470588,0.0596240132703386
2009,University of Delaware (Fang),UDWAxQEWeb,44,1000,875,125,1.07642626480086,2.31481481481482,5.27728712728885e-05
2009,University of Delaware (Fang),UDWAxQEWeb,45,1000,937,63,1.03305785123967,2.03225806451613,0.0136406018315713
2009,University of Delaware (Fang),UDWAxQEWeb,46,1000,965,35,1.0183299389002,2.05882352941176,0.000132279810410679
2009,University of Delaware (Fang),UDWAxQEWeb,47,1000,959,41,1.02145045965271,2.05,5.11617024469454e-06
2009,University of Delaware (Fang),UDWAxQEWeb,48,1000,969,31,1.01626016260163,2.06666666666667,5.69412278469061e-05
2009,University of Delaware (Fang),UDWAxQEWeb,49,1000,937,63,1.03305785123967,2.03225806451613,0.00165832690956954
2009,University of Delaware (Fang),UDWAxQEWeb,50,1000,929,71,1.03842159916926,2.08823529411765,0.00930531415521205
2009,"University of Maryland, College Park",UMHOObm25B,1,1000,935,65,1.04058272632674,2.5,0.276101442209298
2009,"University of Maryland, College Park",UMHOObm25B,2,1000,823,177,1.10987791342952,2.26923076923077,0.0683662270088692
2009,"University of Maryland, College Park",UMHOObm25B,3,1000,871,129,1.07991360691145,2.34545454545455,0.215752221604514
2009,"University of Maryland, College Park",UMHOObm25B,4,1000,802,198,1.14025085518814,2.64,0.0320041299248592
2009,"University of Maryland, College Park",UMHOObm25B,5,1000,782,218,1.15740740740741,2.65853658536585,0.0404569725847484
2009,"University of Maryland, College Park",UMHOObm25B,6,1000,584,416,1.32275132275132,2.41860465116279,0.0832705151004534
2009,"University of Maryland, College Park",UMHOObm25B,7,1000,962,38,1.01936799184506,2,0.0318527354438454
2009,"University of Maryland, College Park",UMHOObm25B,8,1000,841,159,1.1037527593819,2.44615384615385,0.000556229171175505
2009,"University of Maryland, College Park",UMHOObm25B,9,1000,950,50,1.02774922918808,2.17391304347826,0.00167446436305681
2009,"University of Maryland, College Park",UMHOObm25B,10,1000,793,207,1.14285714285714,2.52439024390244,0.00262888063773318
2009,"University of Maryland, College Park",UMHOObm25B,11,1000,870,130,1.08225108225108,2.40740740740741,0.0597055571913723
2009,"University of Maryland, College Park",UMHOObm25B,12,1000,752,248,1.18203309692671,2.63829787234043,0.165731043804866
2009,"University of Maryland, College Park",UMHOObm25B,13,1000,422,578,1.70648464163823,3.52439024390244,0.0387785789780719
2009,"University of Maryland, College Park",UMHOObm25B,14,1000,782,218,1.13378684807256,2.18,0.115631880319757
2009,"University of Maryland, College Park",UMHOObm25B,15,1000,811,189,1.12994350282486,2.55405405405405,0.242430222616623
2009,"University of Maryland, College Park",UMHOObm25B,16,1000,755,245,1.1454753722795,2.07627118644068,0.0373965173237632
2009,"University of Maryland, College Park",UMHOObm25B,17,1000,963,37,1.02040816326531,2.17647058823529,0.0072489694499611
2009,"University of Maryland, College Park",UMHOObm25B,18,1000,939,61,1.03412616339193,2.17857142857143,0.0436834633881102
2009,"University of Maryland, College Park",UMHOObm25B,19,1000,770,230,1.17508813160987,2.83950617283951,0.0341505489297592
2009,"University of Maryland, College Park",UMHOObm25B,20,1000,858,142,1.08813928182807,2.32786885245902,0.0158302093843247
2009,"University of Maryland, College Park",UMHOObm25B,21,1000,875,125,1.09289617486339,3.125,0.0736109129609825
2009,"University of Maryland, College Park",UMHOObm25B,22,1000,953,47,1.02564102564103,2.13636363636364,8.93900394069725e-10
2009,"University of Maryland, College Park",UMHOObm25B,23,1000,428,572,1.89753320683112,5.77777777777778,0.0929011330228762
2009,"University of Maryland, College Park",UMHOObm25B,24,1000,847,153,1.09409190371991,2.28358208955224,0.00546658467407587
2009,"University of Maryland, College Park",UMHOObm25B,25,1000,693,307,1.23152709359606,2.57983193277311,0.204561826236811
2009,"University of Maryland, College Park",UMHOObm25B,26,1000,890,110,1.06609808102345,2.29166666666667,0.0191700867138189
2009,"University of Maryland, College Park",UMHOObm25B,27,1000,901,99,1.05708245243129,2.2,0.0979722148941264
2009,"University of Maryland, College Park",UMHOObm25B,28,1000,637,363,1.33868808567604,3.3,0.00676796460854847
2009,"University of Maryland, College Park",UMHOObm25B,29,1000,894,106,1.07066381156317,2.65,0.00121426315999419
2009,"University of Maryland, College Park",UMHOObm25B,30,1000,861,139,1.07642626480086,2.04411764705882,0.08856319476224
2009,"University of Maryland, College Park",UMHOObm25B,31,1000,770,230,1.16279069767442,2.55555555555556,0.31214517439906
2009,"University of Maryland, College Park",UMHOObm25B,32,1000,866,134,1.08108108108108,2.27118644067797,0.27517879434714
2009,"University of Maryland, College Park",UMHOObm25B,33,1000,928,72,1.03950103950104,2.11764705882353,0.000520400725692146
2009,"University of Maryland, College Park",UMHOObm25B,34,1000,782,218,1.16009280742459,2.725,3.51765605569804e-08
2009,"University of Maryland, College Park",UMHOObm25B,35,1000,743,257,1.17370892018779,2.35779816513761,0.364172674555559
2009,"University of Maryland, College Park",UMHOObm25B,36,1000,926,74,1.04275286757039,2.24242424242424,4.61775071112395e-05
2009,"University of Maryland, College Park",UMHOObm25B,37,1000,866,134,1.07874865156419,2.19672131147541,0.0151589592870826
2009,"University of Maryland, College Park",UMHOObm25B,38,1000,861,139,1.0752688172043,2.01449275362319,3.07617900764217e-05
2009,"University of Maryland, College Park",UMHOObm25B,39,1000,861,139,1.09170305676856,2.52727272727273,0.000803979161588608
2009,"University of Maryland, College Park",UMHOObm25B,40,132,120,12,1.04761904761905,2,0.12369210651147
2009,"University of Maryland, College Park",UMHOObm25B,41,1000,859,141,1.08225108225108,2.16923076923077,0.15390992578156
2009,"University of Maryland, College Park",UMHOObm25B,42,1000,848,152,1.10741971207087,2.76363636363636,0.0770688592669477
2009,"University of Maryland, College Park",UMHOObm25B,43,1000,904,96,1.05708245243129,2.28571428571429,0.382204399852857
2009,"University of Maryland, College Park",UMHOObm25B,44,1000,869,131,1.08459869848156,2.47169811320755,0.151571103274952
2009,"University of Maryland, College Park",UMHOObm25B,45,1000,855,145,1.09289617486339,2.41666666666667,0.0352073836261523
2009,"University of Maryland, College Park",UMHOObm25B,46,1000,875,125,1.08459869848156,2.65957446808511,0.0300855643431523
2009,"University of Maryland, College Park",UMHOObm25B,47,1000,883,117,1.06609808102345,2.12727272727273,0.207327945778552
2009,"University of Maryland, College Park",UMHOObm25B,48,1000,856,144,1.09649122807018,2.57142857142857,0.000798102347124274
2009,"University of Maryland, College Park",UMHOObm25B,49,1000,766,234,1.17647058823529,2.78571428571429,0.328271382250014
2009,"University of Maryland, College Park",UMHOObm25B,50,1000,937,63,1.03412616339193,2.1,9.64370856944383e-05
2009,"University of Maryland, College Park",UMHOObm25GS,1,1000,930,70,1.04384133611691,2.5,0.0511702274219983
2009,"University of Maryland, College Park",UMHOObm25GS,2,1000,848,152,1.0989010989011,2.45161290322581,0.0020238014151181
2009,"University of Maryland, College Park",UMHOObm25GS,3,1000,854,146,1.11111111111111,3.17391304347826,0.000520405876801963
2009,"University of Maryland, College Park",UMHOObm25GS,4,1000,807,193,1.15606936416185,3.32758620689655,0.014772385500806
2009,"University of Maryland, College Park",UMHOObm25GS,5,1000,810,190,1.12866817155756,2.5,0.000124864860424109
2009,"University of Maryland, College Park",UMHOObm25GS,6,1000,657,343,1.25156445556946,2.41549295774648,0.157233180169849
2009,"University of Maryland, College Park",UMHOObm25GS,7,1000,578,422,1.44092219020173,3.63793103448276,0.177712636754608
2009,"University of Maryland, College Park",UMHOObm25GS,8,1000,805,195,1.14025085518814,2.70833333333333,0.153912196290682
2009,"University of Maryland, College Park",UMHOObm25GS,9,1000,950,50,1.03305785123967,2.77777777777778,0.461537044669741
2009,"University of Maryland, College Park",UMHOObm25GS,10,1000,897,103,1.05820105820106,2.14583333333333,0.0357668689670803
2009,"University of Maryland, College Park",UMHOObm25GS,11,1000,782,218,1.15606936416185,2.62650602409639,0.216530968587958
2009,"University of Maryland, College Park",UMHOObm25GS,12,1000,681,319,1.24223602484472,2.57258064516129,0.00702623101844499
2009,"University of Maryland, College Park",UMHOObm25GS,13,1000,614,386,1.43061516452074,4.54117647058824,9.7535675351365e-07
2009,"University of Maryland, College Park",UMHOObm25GS,14,1000,793,207,1.14678899082569,2.62025316455696,0.00156573605797847
2009,"University of Maryland, College Park",UMHOObm25GS,15,1000,877,123,1.0752688172043,2.32075471698113,0.329106762862285
2009,"University of Maryland, College Park",UMHOObm25GS,16,1000,773,227,1.15740740740741,2.49450549450549,0.10149694705541
2009,"University of Maryland, College Park",UMHOObm25GS,17,1000,952,48,1.03092783505155,2.66666666666667,0.100973790023936
2009,"University of Maryland, College Park",UMHOObm25GS,18,1000,821,179,1.11982082866741,2.48611111111111,0.00135140471717202
2009,"University of Maryland, College Park",UMHOObm25GS,19,1000,864,136,1.08813928182807,2.47272727272727,4.61348507238389e-05
2009,"University of Maryland, College Park",UMHOObm25GS,20,1000,864,136,1.08108108108108,2.22950819672131,0.00426836228895301
2009,"University of Maryland, College Park",UMHOObm25GS,21,1000,817,183,1.12485939257593,2.54166666666667,9.41148790961669e-06
2009,"University of Maryland, College Park",UMHOObm25GS,22,1000,934,66,1.0351966873706,2.0625,0.0231418103870091
2009,"University of Maryland, College Park",UMHOObm25GS,23,1000,872,128,1.09529025191676,3.1219512195122,3.32036831647088e-05
2009,"University of Maryland, College Park",UMHOObm25GS,24,1000,772,228,1.16822429906542,2.71428571428571,0.00312298927716671
2009,"University of Maryland, College Park",UMHOObm25GS,25,1000,704,296,1.22549019607843,2.64285714285714,0.355693184267572
2009,"University of Maryland, College Park",UMHOObm25GS,26,1000,823,177,1.11111111111111,2.2987012987013,0.0248694333691778
2009,"University of Maryland, College Park",UMHOObm25GS,27,1000,900,100,1.05708245243129,2.17391304347826,0.0026545301686236
2009,"University of Maryland, College Park",UMHOObm25GS,28,1000,822,178,1.12612612612613,2.6969696969697,0.0115768727113888
2009,"University of Maryland, College Park",UMHOObm25GS,29,1000,946,54,1.02880658436214,2.07692307692308,0.000151517261198638
2009,"University of Maryland, College Park",UMHOObm25GS,30,1000,731,269,1.17647058823529,2.26050420168067,0.119779748181384
2009,"University of Maryland, College Park",UMHOObm25GS,31,1000,723,277,1.19189511323004,2.38793103448276,0.0195728157905814
2009,"University of Maryland, College Park",UMHOObm25GS,32,1000,774,226,1.17647058823529,2.97368421052632,0.681355311988941
2009,"University of Maryland, College Park",UMHOObm25GS,33,1000,922,78,1.04602510460251,2.29411764705882,1.53123158780932e-05
2009,"University of Maryland, College Park",UMHOObm25GS,34,1000,942,58,1.03842159916926,2.76190476190476,0.0908924932345501
2009,"University of Maryland, College Park",UMHOObm25GS,35,1000,667,333,1.25786163522013,2.6015625,0.0480571207973282
2009,"University of Maryland, College Park",UMHOObm25GS,36,1000,850,150,1.1001100110011,2.54237288135593,0.0651003621298492
2009,"University of Maryland, College Park",UMHOObm25GS,37,1000,855,145,1.09289617486339,2.41666666666667,0.0424116464418695
2009,"University of Maryland, College Park",UMHOObm25GS,38,1000,850,150,1.09409190371991,2.34375,0.000173746438934808
2009,"University of Maryland, College Park",UMHOObm25GS,39,1000,913,87,1.05374077976818,2.41666666666667,0.000194521847858402
2009,"University of Maryland, College Park",UMHOObm25GS,40,1000,445,555,1.58982511923688,3.01630434782609,0.0020493989574337
2009,"University of Maryland, College Park",UMHOObm25GS,41,1000,734,266,1.20192307692308,2.71428571428571,0.0101522422990723
2009,"University of Maryland, College Park",UMHOObm25GS,42,1000,923,77,1.05374077976818,2.96153846153846,0.000149659211987263
2009,"University of Maryland, College Park",UMHOObm25GS,43,1000,891,109,1.07066381156317,2.53488372093023,0.180336136439608
2009,"University of Maryland, College Park",UMHOObm25GS,44,1000,703,297,1.26582278481013,3.41379310344828,0.0352257618571363
2009,"University of Maryland, College Park",UMHOObm25GS,45,1000,888,112,1.06951871657754,2.38297872340426,0.00172407537542434
2009,"University of Maryland, College Park",UMHOObm25GS,46,1000,659,341,1.23915737298637,2.30405405405405,0.19108596861634
2009,"University of Maryland, College Park",UMHOObm25GS,47,1000,877,123,1.08225108225108,2.61702127659575,0.0698303234336138
2009,"University of Maryland, College Park",UMHOObm25GS,48,1000,867,133,1.08695652173913,2.50943396226415,0.000148749985784772
2009,"University of Maryland, College Park",UMHOObm25GS,49,1000,820,180,1.12866817155756,2.72727272727273,0.00500404217864648
2009,"University of Maryland, College Park",UMHOObm25GS,50,1000,854,146,1.09529025191676,2.47457627118644,0.0787845196833737
2009,"University of Maryland, College Park",UMHOObm25IF,1,1000,951,49,1.02986611740474,2.45,0.00120221698027084
2009,"University of Maryland, College Park",UMHOObm25IF,2,1000,947,53,1.03092783505155,2.30434782608696,0.00233805081443987
2009,"University of Maryland, College Park",UMHOObm25IF,3,1000,897,103,1.07181136120043,2.86111111111111,0.000134450212111326
2009,"University of Maryland, College Park",UMHOObm25IF,4,1000,881,119,1.10132158590308,4.40740740740741,0.00170252114592917
2009,"University of Maryland, College Park",UMHOObm25IF,5,1000,942,58,1.03199174406605,2.14814814814815,3.36978449712523e-05
2009,"University of Maryland, College Park",UMHOObm25IF,6,1000,919,81,1.04493207941484,2.13157894736842,9.68062133527471e-07
2009,"University of Maryland, College Park",UMHOObm25IF,7,1000,842,158,1.11856823266219,3.03846153846154,0.012313240158354
2009,"University of Maryland, College Park",UMHOObm25IF,8,1000,884,116,1.08459869848156,3.05263157894737,0.000290538834590952
2009,"University of Maryland, College Park",UMHOObm25IF,9,1000,966,34,1.02354145342886,3.09090909090909,0.0446262711881137
2009,"University of Maryland, College Park",UMHOObm25IF,10,1000,981,19,1.01112234580384,2.375,1.42266963250448e-13
2009,"University of Maryland, College Park",UMHOObm25IF,11,1000,924,76,1.04931794333683,2.62068965517241,0.00183785315136725
2009,"University of Maryland, College Park",UMHOObm25IF,12,1000,884,116,1.09769484083425,4.2962962962963,0.00209569890751735
2009,"University of Maryland, College Park",UMHOObm25IF,13,1000,740,260,1.26422250316056,5.09803921568627,0.000307302626423271
2009,"University of Maryland, College Park",UMHOObm25IF,14,1000,933,67,1.0351966873706,2.03030303030303,0.000310402075493631
2009,"University of Maryland, College Park",UMHOObm25IF,15,1000,924,76,1.05708245243129,3.45454545454545,1.75604426273765e-13
2009,"University of Maryland, College Park",UMHOObm25IF,16,1000,954,46,1.02564102564103,2.19047619047619,0.0187618942713899
2009,"University of Maryland, College Park",UMHOObm25IF,17,1000,976,24,1.01317122593718,2.18181818181818,4.67270301824198e-15
2009,"University of Maryland, College Park",UMHOObm25IF,18,1000,917,83,1.05708245243129,2.86206896551724,1.38044376139326e-06
2009,"University of Maryland, College Park",UMHOObm25IF,19,1000,935,65,1.04275286757039,2.70833333333333,0.000254390601385465
2009,"University of Maryland, College Park",UMHOObm25IF,20,1000,969,31,1.01626016260163,2.06666666666667,6.01975134510116e-09
2009,"University of Maryland, College Park",UMHOObm25IF,21,1000,902,98,1.06044538706257,2.39024390243902,0.00347879511793819
2009,"University of Maryland, College Park",UMHOObm25IF,22,1000,978,22,1.01214574898785,2.2,0.00833141112427197
2009,"University of Maryland, College Park",UMHOObm25IF,23,1000,950,50,1.02880658436214,2.27272727272727,4.18049644933143e-09
2009,"University of Maryland, College Park",UMHOObm25IF,24,1000,886,114,1.08342361863489,3.08108108108108,0.00700794552413782
2009,"University of Maryland, College Park",UMHOObm25IF,25,1000,935,65,1.03734439834025,2.24137931034483,0.117053776452918
2009,"University of Maryland, College Park",UMHOObm25IF,26,1000,959,41,1.02145045965271,2.05,5.12440549586557e-05
2009,"University of Maryland, College Park",UMHOObm25IF,27,1000,957,43,1.02564102564103,2.38888888888889,3.62140740649065e-05
2009,"University of Maryland, College Park",UMHOObm25IF,28,1000,868,132,1.08813928182807,2.58823529411765,0.357687070838627
2009,"University of Maryland, College Park",UMHOObm25IF,29,1000,982,18,1.00908173562059,2,1.29994777414361e-12
2009,"University of Maryland, College Park",UMHOObm25IF,30,1000,973,27,1.01419878296146,2.07692307692308,0.0438456375281137
2009,"University of Maryland, College Park",UMHOObm25IF,31,1000,901,99,1.05596620908131,2.15217391304348,0.0498910533991962
2009,"University of Maryland, College Park",UMHOObm25IF,32,1000,891,109,1.07642626480086,2.86842105263158,0.224409213946268
2009,"University of Maryland, College Park",UMHOObm25IF,33,1000,966,34,1.01936799184506,2.26666666666667,0.0212971932370288
2009,"University of Maryland, College Park",UMHOObm25IF,34,1000,976,24,1.01317122593718,2.18181818181818,0.000307288761285427
2009,"University of Maryland, College Park",UMHOObm25IF,35,1000,964,36,1.01936799184506,2.11764705882353,0.00477211360818829
2009,"University of Maryland, College Park",UMHOObm25IF,36,1000,954,46,1.02880658436214,2.55555555555556,0.00652672359638475
2009,"University of Maryland, College Park",UMHOObm25IF,37,1000,959,41,1.02145045965271,2.05,9.20917958773629e-08
2009,"University of Maryland, College Park",UMHOObm25IF,38,1000,958,42,1.02459016393443,2.33333333333333,9.56471120038724e-06
2009,"University of Maryland, College Park",UMHOObm25IF,39,1000,966,34,1.01936799184506,2.26666666666667,0.000468356608609266
2009,"University of Maryland, College Park",UMHOObm25IF,40,1000,778,222,1.15874855156431,2.61176470588235,0.000434866842409292
2009,"University of Maryland, College Park",UMHOObm25IF,41,1000,925,75,1.04931794333683,2.67857142857143,0.100973792876586
2009,"University of Maryland, College Park",UMHOObm25IF,42,1000,954,46,1.02986611740474,2.70588235294118,8.09114896975246e-05
2009,"University of Maryland, College Park",UMHOObm25IF,43,1000,955,45,1.02880658436214,2.64705882352941,0.00994360521423396
2009,"University of Maryland, College Park",UMHOObm25IF,44,1000,860,140,1.0989010989011,2.8,0.000190732200460414
2009,"University of Maryland, College Park",UMHOObm25IF,45,1000,965,35,1.0183299389002,2.05882352941176,4.67567133876865e-05
2009,"University of Maryland, College Park",UMHOObm25IF,46,1000,950,50,1.02986611740474,2.38095238095238,0.0021340878724419
2009,"University of Maryland, College Park",UMHOObm25IF,47,1000,918,82,1.05708245243129,2.92857142857143,0.00120891027284869
2009,"University of Maryland, College Park",UMHOObm25IF,48,1000,909,91,1.0515247108307,2.16666666666667,0.101490826962253
2009,"University of Maryland, College Park",UMHOObm25IF,49,1000,912,88,1.05485232067511,2.44444444444444,0.00611307289061554
2009,"University of Maryland, College Park",UMHOObm25IF,50,1000,941,59,1.03412616339193,2.26923076923077,0.259539245466111
2009,"University of Maryland, College Park",UMHOOqlB,1,1000,758,242,1.18063754427391,2.71910112359551,0.46118777368847
2009,"University of Maryland, College Park",UMHOOqlB,2,1000,835,165,1.10253583241455,2.29166666666667,0.0605593972984593
2009,"University of Maryland, College Park",UMHOOqlB,3,1000,876,124,1.0752688172043,2.2962962962963,0.219336994071548
2009,"University of Maryland, College Park",UMHOOqlB,4,1000,806,194,1.13765642775882,2.65753424657534,0.00931899412902205
2009,"University of Maryland, College Park",UMHOOqlB,5,1000,833,167,1.10741971207087,2.38571428571429,0.00476909516245849
2009,"University of Maryland, College Park",UMHOOqlB,6,1000,583,417,1.32450331125828,2.42441860465116,0.0601917513502701
2009,"University of Maryland, College Park",UMHOOqlB,7,1000,917,83,1.05932203389831,3.07407407407407,0.0231572916332913
2009,"University of Maryland, College Park",UMHOOqlB,8,1000,831,169,1.11358574610245,2.52238805970149,0.000277902438109928
2009,"University of Maryland, College Park",UMHOOqlB,9,1000,952,48,1.02669404517454,2.18181818181818,0.000269826064516367
2009,"University of Maryland, College Park",UMHOOqlB,10,1000,850,150,1.09051254089422,2.23880597014925,0.00142717241116669
2009,"University of Maryland, College Park",UMHOOqlB,11,1000,845,155,1.09170305676856,2.1830985915493,0.0693233275969606
2009,"University of Maryland, College Park",UMHOOqlB,12,1000,752,248,1.18203309692671,2.63829787234043,0.183393133118837
2009,"University of Maryland, College Park",UMHOOqlB,13,1000,378,622,1.79856115107914,3.49438202247191,0.0286541838274229
2009,"University of Maryland, College Park",UMHOOqlB,14,1000,782,218,1.13378684807256,2.18,0.118806872252767
2009,"University of Maryland, College Park",UMHOOqlB,15,1000,772,228,1.16279069767442,2.59090909090909,0.202835494886672
2009,"University of Maryland, College Park",UMHOOqlB,16,1000,818,182,1.10619469026549,2.11627906976744,0.081343234202254
2009,"University of Maryland, College Park",UMHOOqlB,17,1000,959,41,1.02249488752556,2.15789473684211,0.0136400617837397
2009,"University of Maryland, College Park",UMHOOqlB,18,1000,919,81,1.04602510460251,2.18918918918919,0.0330589100981041
2009,"University of Maryland, College Park",UMHOOqlB,19,1000,760,240,1.18343195266272,2.82352941176471,0.0625789256944864
2009,"University of Maryland, College Park",UMHOOqlB,20,1000,860,140,1.08695652173913,2.33333333333333,0.0222518462582084
2009,"University of Maryland, College Park",UMHOOqlB,21,1000,877,123,1.09170305676856,3.15384615384615,0.0817893362238618
2009,"University of Maryland, College Park",UMHOOqlB,22,1000,951,49,1.02669404517454,2.1304347826087,4.40478265452296e-08
2009,"University of Maryland, College Park",UMHOOqlB,23,1000,402,598,1.99203187250996,5.98,0.0981336883203205
2009,"University of Maryland, College Park",UMHOOqlB,24,1000,840,160,1.09769484083425,2.25352112676056,0.00624434083478414
2009,"University of Maryland, College Park",UMHOOqlB,25,1000,698,302,1.21951219512195,2.47540983606557,0.191292041541814
2009,"University of Maryland, College Park",UMHOOqlB,26,1000,891,109,1.06496272630458,2.27083333333333,0.00453644280646129
2009,"University of Maryland, College Park",UMHOOqlB,27,1000,903,97,1.05596620908131,2.20454545454545,0.0643519210678832
2009,"University of Maryland, College Park",UMHOOqlB,28,1000,668,332,1.29366106080207,3.16190476190476,0.00853418195145307
2009,"University of Maryland, College Park",UMHOOqlB,29,1000,936,64,1.03626943005181,2.20689655172414,0.00895011556477396
2009,"University of Maryland, College Park",UMHOOqlB,30,1000,866,134,1.07411385606874,2.06153846153846,0.0136948305028996
2009,"University of Maryland, College Park",UMHOOqlB,31,1000,774,226,1.15740740740741,2.51111111111111,0.29584633184157
2009,"University of Maryland, College Park",UMHOOqlB,32,1000,870,130,1.08225108225108,2.40740740740741,0.295919277259687
2009,"University of Maryland, College Park",UMHOOqlB,33,1000,926,74,1.04058272632674,2.11428571428571,0.00071384954344904
2009,"University of Maryland, College Park",UMHOOqlB,34,1000,776,224,1.16414435389988,2.69879518072289,5.99441868392954e-09
2009,"University of Maryland, College Park",UMHOOqlB,35,1000,729,271,1.18623962040332,2.37719298245614,0.274965207927824
2009,"University of Maryland, College Park",UMHOOqlB,36,1000,922,78,1.04493207941484,2.22857142857143,0.000132299845815229
2009,"University of Maryland, College Park",UMHOOqlB,37,1000,883,117,1.07066381156317,2.29411764705882,0.00822813549919407
2009,"University of Maryland, College Park",UMHOOqlB,38,1000,866,134,1.07296137339056,2.03030303030303,1.62208229211964e-05
2009,"University of Maryland, College Park",UMHOOqlB,39,1000,889,111,1.07181136120043,2.52272727272727,0.00149951451480681
2009,"University of Maryland, College Park",UMHOOqlB,40,132,120,12,1.04761904761905,2,0.129138298337238
2009,"University of Maryland, College Park",UMHOOqlB,41,1000,784,216,1.1441647597254,2.4,0.0986776389727896
2009,"University of Maryland, College Park",UMHOOqlB,42,1000,857,143,1.10497237569061,2.97916666666667,0.0101195399017198
2009,"University of Maryland, College Park",UMHOOqlB,43,1000,897,103,1.06044538706257,2.23913043478261,0.2319264366388
2009,"University of Maryland, College Park",UMHOOqlB,44,1000,870,130,1.08108108108108,2.36363636363636,0.0936493475087788
2009,"University of Maryland, College Park",UMHOOqlB,45,1000,846,154,1.0989010989011,2.40625,0.0207896081475666
2009,"University of Maryland, College Park",UMHOOqlB,46,1000,864,136,1.09170305676856,2.61538461538462,0.0132946901984981
2009,"University of Maryland, College Park",UMHOOqlB,47,1000,898,102,1.05820105820106,2.17021276595745,0.182537546892531
2009,"University of Maryland, College Park",UMHOOqlB,48,1000,874,126,1.08225108225108,2.52,0.00750476569143442
2009,"University of Maryland, College Park",UMHOOqlB,49,1000,740,260,1.19760479041916,2.73684210526316,0.232012517543648
2009,"University of Maryland, College Park",UMHOOqlB,50,1000,916,84,1.06496272630458,3.65217391304348,0.000215620966987972
2009,"University of Maryland, College Park",UMHOOqlGS,1,1000,489,511,1.5015015015015,2.88700564971751,0.110595037450529
2009,"University of Maryland, College Park",UMHOOqlGS,2,1000,874,126,1.07874865156419,2.37735849056604,4.29497232382728e-05
2009,"University of Maryland, College Park",UMHOOqlGS,3,1000,856,144,1.10987791342952,3.2,0.00052040698658846
2009,"University of Maryland, College Park",UMHOOqlGS,4,1000,809,191,1.15473441108545,3.35087719298246,0.0147723047812995
2009,"University of Maryland, College Park",UMHOOqlGS,5,1000,830,170,1.11234705228031,2.46376811594203,0.00384758310361422
2009,"University of Maryland, College Park",UMHOOqlGS,6,1000,649,351,1.25944584382872,2.42068965517241,0.156875223255309
2009,"University of Maryland, College Park",UMHOOqlGS,7,1000,773,227,1.18623962040332,3.24285714285714,0.159290148965891
2009,"University of Maryland, College Park",UMHOOqlGS,8,1000,801,199,1.14285714285714,2.68918918918919,0.171020651877233
2009,"University of Maryland, College Park",UMHOOqlGS,9,1000,914,86,1.05820105820106,2.7741935483871,0.461347431439068
2009,"University of Maryland, College Park",UMHOOqlGS,10,1000,913,87,1.04712041884817,2.07142857142857,0.0169878424547701
2009,"University of Maryland, College Park",UMHOOqlGS,11,1000,804,196,1.13895216400911,2.64864864864865,0.218879701457236
2009,"University of Maryland, College Park",UMHOOqlGS,12,1000,681,319,1.24223602484472,2.57258064516129,0.0203984592951549
2009,"University of Maryland, College Park",UMHOOqlGS,13,1000,612,388,1.43061516452074,4.45977011494253,4.26328105141752e-06
2009,"University of Maryland, College Park",UMHOOqlGS,14,1000,801,199,1.14155251141553,2.65333333333333,0.00185932282833344
2009,"University of Maryland, College Park",UMHOOqlGS,15,1000,878,122,1.07758620689655,2.44,0.286431491446897
2009,"University of Maryland, College Park",UMHOOqlGS,16,1000,799,201,1.13895216400911,2.54430379746835,0.101440750841348
2009,"University of Maryland, College Park",UMHOOqlGS,17,1000,931,69,1.04384133611691,2.55555555555556,0.112193126010543
2009,"University of Maryland, College Park",UMHOOqlGS,18,1000,862,138,1.08225108225108,2.2258064516129,0.000651961650802547
2009,"University of Maryland, College Park",UMHOOqlGS,19,1000,866,134,1.08695652173913,2.48148148148148,4.61336074199712e-05
2009,"University of Maryland, College Park",UMHOOqlGS,20,1000,868,132,1.07874865156419,2.23728813559322,0.00384336740546268
2009,"University of Maryland, College Park",UMHOOqlGS,21,1000,814,186,1.12739571589628,2.54794520547945,9.86230855541035e-06
2009,"University of Maryland, College Park",UMHOOqlGS,22,1000,930,70,1.03734439834025,2.05882352941176,0.0207903907030563
2009,"University of Maryland, College Park",UMHOOqlGS,23,1000,870,130,1.09649122807018,3.0952380952381,3.81843085455894e-05
2009,"University of Maryland, College Park",UMHOOqlGS,24,1000,772,228,1.16822429906542,2.71428571428571,0.00312529463956508
2009,"University of Maryland, College Park",UMHOOqlGS,25,1000,698,302,1.23456790123457,2.69642857142857,0.355114717201121
2009,"University of Maryland, College Park",UMHOOqlGS,26,1000,829,171,1.10132158590308,2.16455696202532,0.0848827888682472
2009,"University of Maryland, College Park",UMHOOqlGS,27,1000,904,96,1.05485232067511,2.18181818181818,0.00266864126113965
2009,"University of Maryland, College Park",UMHOOqlGS,28,1000,822,178,1.12612612612613,2.6969696969697,0.0120283155432362
2009,"University of Maryland, College Park",UMHOOqlGS,29,1000,942,58,1.0351966873706,2.41666666666667,3.67901937127634e-06
2009,"University of Maryland, College Park",UMHOOqlGS,30,1000,687,313,1.20481927710843,2.18881118881119,0.0697235890042722
2009,"University of Maryland, College Park",UMHOOqlGS,31,1000,723,277,1.19189511323004,2.38793103448276,0.0192318028185654
2009,"University of Maryland, College Park",UMHOOqlGS,32,1000,821,179,1.13250283125708,2.88709677419355,0.590784684943466
2009,"University of Maryland, College Park",UMHOOqlGS,33,1000,924,76,1.04493207941484,2.3030303030303,3.48501228563742e-06
2009,"University of Maryland, College Park",UMHOOqlGS,34,1000,934,66,1.04384133611691,2.75,0.0909036458863255
2009,"University of Maryland, College Park",UMHOOqlGS,35,1000,664,336,1.26103404791929,2.6046511627907,0.0496170523901382
2009,"University of Maryland, College Park",UMHOOqlGS,36,1000,848,152,1.10132158590308,2.53333333333333,0.0701725895992203
2009,"University of Maryland, College Park",UMHOOqlGS,37,1000,853,147,1.09409190371991,2.40983606557377,0.0296314358454151
2009,"University of Maryland, College Park",UMHOOqlGS,38,1000,863,137,1.08342361863489,2.28333333333333,4.00706834127451e-05
2009,"University of Maryland, College Park",UMHOOqlGS,39,1000,915,85,1.05263157894737,2.42857142857143,0.00146226426300744
2009,"University of Maryland, College Park",UMHOOqlGS,40,1000,443,557,1.59235668789809,3.01081081081081,0.00204970101387431
2009,"University of Maryland, College Park",UMHOOqlGS,41,1000,747,253,1.19189511323004,2.75,0.00118773573798729
2009,"University of Maryland, College Park",UMHOOqlGS,42,1000,731,269,1.19047619047619,2.46788990825688,0.000384651238301016
2009,"University of Maryland, College Park",UMHOOqlGS,43,1000,877,123,1.07874865156419,2.46,0.105704841869565
2009,"University of Maryland, College Park",UMHOOqlGS,44,1000,742,258,1.230012300123,3.63380281690141,0.0482958538166782
2009,"University of Maryland, College Park",UMHOOqlGS,45,1000,893,107,1.06609808102345,2.37777777777778,1.57644293946184e-05
2009,"University of Maryland, College Park",UMHOOqlGS,46,1000,674,326,1.22699386503067,2.31205673758865,0.159330389763169
2009,"University of Maryland, College Park",UMHOOqlGS,47,1000,880,120,1.07991360691145,2.60869565217391,0.013237229564469
2009,"University of Maryland, College Park",UMHOOqlGS,48,1000,852,148,1.10864745011086,2.96,0.000179330451949985
2009,"University of Maryland, College Park",UMHOOqlGS,49,1000,814,186,1.1454753722795,3.15254237288136,0.0145232308734265
2009,"University of Maryland, College Park",UMHOOqlGS,50,1000,854,146,1.09289617486339,2.39344262295082,0.0516925972434882
2009,"University of Maryland, College Park",UMHOOqlIF,1,1000,767,233,1.15207373271889,2.30693069306931,0.0357725535950323
2009,"University of Maryland, College Park",UMHOOqlIF,2,1000,962,38,1.01936799184506,2,9.58103262725742e-06
2009,"University of Maryland, College Park",UMHOOqlIF,3,1000,905,95,1.06382978723404,2.71428571428571,0.00184257383828047
2009,"University of Maryland, College Park",UMHOOqlIF,4,1000,877,123,1.1037527593819,4.24137931034483,0.0104169301714136
2009,"University of Maryland, College Park",UMHOOqlIF,5,1000,932,68,1.03950103950104,2.26666666666667,0.000710495799687128
2009,"University of Maryland, College Park",UMHOOqlIF,6,1000,894,106,1.06044538706257,2.16326530612245,0.000120090983350873
2009,"University of Maryland, College Park",UMHOOqlIF,7,1000,864,136,1.09529025191676,2.77551020408163,0.172353512918911
2009,"University of Maryland, College Park",UMHOOqlIF,8,1000,888,112,1.07758620689655,2.8,0.0483386209634348
2009,"University of Maryland, College Park",UMHOOqlIF,9,1000,958,42,1.02774922918808,2.8,0.269318414619176
2009,"University of Maryland, College Park",UMHOOqlIF,10,1000,981,19,1.01112234580384,2.375,2.20601983580581e-05
2009,"University of Maryland, College Park",UMHOOqlIF,11,1000,916,84,1.05485232067511,2.625,0.00625100736782236
2009,"University of Maryland, College Park",UMHOOqlIF,12,1000,927,73,1.05596620908131,3.65,4.09137448344496e-06
2009,"University of Maryland, College Park",UMHOOqlIF,13,1000,696,304,1.33689839572193,5.84615384615385,2.45116095562772e-05
2009,"University of Maryland, College Park",UMHOOqlIF,14,1000,927,73,1.04058272632674,2.14705882352941,5.04689292579666e-06
2009,"University of Maryland, College Park",UMHOOqlIF,15,1000,946,54,1.03092783505155,2.25,0.120636102020589
2009,"University of Maryland, College Park",UMHOOqlIF,16,1000,938,62,1.03412616339193,2.13793103448276,1.43597809071729e-08
2009,"University of Maryland, College Park",UMHOOqlIF,17,1000,975,25,1.01419878296146,2.27272727272727,1.60637746670385e-14
2009,"University of Maryland, College Park",UMHOOqlIF,18,1000,934,66,1.03734439834025,2.2,0.000224014112244582
2009,"University of Maryland, College Park",UMHOOqlIF,19,1000,933,67,1.04384133611691,2.68,2.01197746199075e-11
2009,"University of Maryland, College Park",UMHOOqlIF,20,1000,973,27,1.01419878296146,2.07692307692308,1.68288970799345e-10
2009,"University of Maryland, College Park",UMHOOqlIF,21,1000,935,65,1.03842159916926,2.32142857142857,3.06804023406566e-05
2009,"University of Maryland, College Park",UMHOOqlIF,22,1000,979,21,1.01214574898785,2.33333333333333,3.56977740528337e-08
2009,"University of Maryland, College Park",UMHOOqlIF,23,1000,940,60,1.0351966873706,2.30769230769231,1.36616714169003e-09
2009,"University of Maryland, College Park",UMHOOqlIF,24,1000,887,113,1.07642626480086,2.69047619047619,4.20597919638799e-10
2009,"University of Maryland, College Park",UMHOOqlIF,25,1000,912,88,1.04712041884817,2.04651162790698,0.144677544592228
2009,"University of Maryland, College Park",UMHOOqlIF,26,1000,946,54,1.02880658436214,2.07692307692308,0.00994421858586816
2009,"University of Maryland, College Park",UMHOOqlIF,27,1000,958,42,1.02459016393443,2.33333333333333,1.06747452401844e-09
2009,"University of Maryland, College Park",UMHOOqlIF,28,1000,889,111,1.07642626480086,2.775,0.0549942423773634
2009,"University of Maryland, College Park",UMHOOqlIF,29,1000,981,19,1.01317122593718,3.16666666666667,3.10755881861745e-17
2009,"University of Maryland, College Park",UMHOOqlIF,30,1000,960,40,1.02040816326531,2,0.0316866452634393
2009,"University of Maryland, College Park",UMHOOqlIF,31,1000,885,115,1.06837606837607,2.25490196078431,0.0041429699801324
2009,"University of Maryland, College Park",UMHOOqlIF,32,1000,915,85,1.06269925611052,3.26923076923077,0.415653001519676
2009,"University of Maryland, College Park",UMHOOqlIF,33,1000,972,28,1.01522842639594,2.15384615384615,4.4648773716899e-07
2009,"University of Maryland, College Park",UMHOOqlIF,34,1000,970,30,1.01729399796541,2.30769230769231,1.84072455190198e-10
2009,"University of Maryland, College Park",UMHOOqlIF,35,1000,889,111,1.06951871657754,2.41304347826087,5.37429029058566e-06
2009,"University of Maryland, College Park",UMHOOqlIF,36,1000,952,48,1.02986611740474,2.52631578947368,0.0136412059999112
2009,"University of Maryland, College Park",UMHOOqlIF,37,1000,943,57,1.03199174406605,2.19230769230769,0.0034671209702699
2009,"University of Maryland, College Park",UMHOOqlIF,38,1000,954,46,1.02459016393443,2.09090909090909,9.55502286164348e-06
2009,"University of Maryland, College Park",UMHOOqlIF,39,1000,964,36,1.01936799184506,2.11764705882353,7.8555963599707e-05
2009,"University of Maryland, College Park",UMHOOqlIF,40,1000,780,220,1.15740740740741,2.61904761904762,0.000922402412197632
2009,"University of Maryland, College Park",UMHOOqlIF,41,1000,896,104,1.06723585912487,2.53658536585366,0.001839808072011
2009,"University of Maryland, College Park",UMHOOqlIF,42,1000,906,94,1.05932203389831,2.47368421052632,0.000335576951627189
2009,"University of Maryland, College Park",UMHOOqlIF,43,1000,923,77,1.04712041884817,2.40625,0.0662489185516585
2009,"University of Maryland, College Park",UMHOOqlIF,44,1000,868,132,1.09409190371991,2.8695652173913,0.0352082254406454
2009,"University of Maryland, College Park",UMHOOqlIF,45,1000,963,37,1.01936799184506,2.05555555555556,1.1127086343466e-05
2009,"University of Maryland, College Park",UMHOOqlIF,46,1000,958,42,1.02459016393443,2.33333333333333,0.000551122223904967
2009,"University of Maryland, College Park",UMHOOqlIF,47,1000,955,45,1.02669404517454,2.36842105263158,0.00385266736612848
2009,"University of Maryland, College Park",UMHOOqlIF,48,1000,905,95,1.06157112526539,2.56756756756757,0.00587411546157267
2009,"University of Maryland, College Park",UMHOOqlIF,49,1000,902,98,1.06269925611052,2.51282051282051,0.0136471270828113
2009,"University of Maryland, College Park",UMHOOqlIF,50,1000,951,49,1.02774922918808,2.22727272727273,0.0795344667419449
2009,"University of Maryland, College Park",UMHOOsd,1,1000,854,146,1.11111111111111,3.17391304347826,0.343493668775758
2009,"University of Maryland, College Park",UMHOOsd,2,1000,818,182,1.11482720178372,2.30379746835443,0.0917483246018993
2009,"University of Maryland, College Park",UMHOOsd,3,1000,871,129,1.07991360691145,2.34545454545455,0.215752221604514
2009,"University of Maryland, College Park",UMHOOsd,4,1000,802,198,1.14025085518814,2.64,0.0320041299248592
2009,"University of Maryland, College Park",UMHOOsd,5,1000,840,160,1.1001100110011,2.31884057971015,0.00268209631113384
2009,"University of Maryland, College Park",UMHOOsd,6,1000,584,416,1.32275132275132,2.41860465116279,0.0832705151004534
2009,"University of Maryland, College Park",UMHOOsd,7,1000,950,50,1.02669404517454,2.08333333333333,0.0393661251764411
2009,"University of Maryland, College Park",UMHOOsd,8,1000,841,159,1.1037527593819,2.44615384615385,0.000556229171175505
2009,"University of Maryland, College Park",UMHOOsd,9,1000,932,68,1.03950103950104,2.26666666666667,0.000214471266638085
2009,"University of Maryland, College Park",UMHOOsd,10,1000,828,172,1.10864745011086,2.32432432432432,0.00101649451012333
2009,"University of Maryland, College Park",UMHOOsd,11,1000,857,143,1.08225108225108,2.13432835820896,0.0603048256423658
2009,"University of Maryland, College Park",UMHOOsd,12,1000,752,248,1.18203309692671,2.63829787234043,0.165731043804866
2009,"University of Maryland, College Park",UMHOOsd,13,1000,422,578,1.70648464163823,3.52439024390244,0.0387785789780719
2009,"University of Maryland, College Park",UMHOOsd,14,1000,782,218,1.13378684807256,2.18,0.115631880319757
2009,"University of Maryland, College Park",UMHOOsd,15,1000,909,91,1.05263157894737,2.21951219512195,0.278279426507987
2009,"University of Maryland, College Park",UMHOOsd,16,1000,745,255,1.15340253748558,2.09016393442623,0.0217482013183181
2009,"University of Maryland, College Park",UMHOOsd,17,1000,967,33,1.0183299389002,2.2,0.00805450142454852
2009,"University of Maryland, College Park",UMHOOsd,18,1000,913,87,1.0515247108307,2.28947368421053,0.0930442814686156
2009,"University of Maryland, College Park",UMHOOsd,19,1000,770,230,1.17508813160987,2.83950617283951,0.0341505489297592
2009,"University of Maryland, College Park",UMHOOsd,20,1000,858,142,1.08813928182807,2.32786885245902,0.0158302093843247
2009,"University of Maryland, College Park",UMHOOsd,21,1000,875,125,1.09289617486339,3.125,0.0736109129609825
2009,"University of Maryland, College Park",UMHOOsd,22,1000,961,39,1.02145045965271,2.16666666666667,2.52700334701251e-10
2009,"University of Maryland, College Park",UMHOOsd,23,1000,428,572,1.89753320683112,5.77777777777778,0.0929011330228762
2009,"University of Maryland, College Park",UMHOOsd,24,1000,847,153,1.09409190371991,2.28358208955224,0.00546658467407587
2009,"University of Maryland, College Park",UMHOOsd,25,1000,693,307,1.23152709359606,2.57983193277311,0.204561826236811
2009,"University of Maryland, College Park",UMHOOsd,26,1000,854,146,1.09649122807018,2.51724137931035,0.000745239795864084
2009,"University of Maryland, College Park",UMHOOsd,27,1000,901,99,1.05708245243129,2.2,0.0979722148941264
2009,"University of Maryland, College Park",UMHOOsd,28,1000,637,363,1.33868808567604,3.3,0.00676796460854847
2009,"University of Maryland, College Park",UMHOOsd,29,1000,941,59,1.0351966873706,2.36,0.0168452855899055
2009,"University of Maryland, College Park",UMHOOsd,30,1000,863,137,1.0752688172043,2.04477611940299,0.101966816824863
2009,"University of Maryland, College Park",UMHOOsd,31,1000,770,230,1.16279069767442,2.55555555555556,0.31214517439906
2009,"University of Maryland, College Park",UMHOOsd,32,1000,855,145,1.08695652173913,2.23076923076923,0.189948804265971
2009,"University of Maryland, College Park",UMHOOsd,33,1000,925,75,1.04384133611691,2.27272727272727,0.000793170514607555
2009,"University of Maryland, College Park",UMHOOsd,34,1000,930,70,1.03734439834025,2.05882352941176,1.93236151131112e-08
2009,"University of Maryland, College Park",UMHOOsd,35,1000,743,257,1.17370892018779,2.35779816513761,0.364172674555559
2009,"University of Maryland, College Park",UMHOOsd,36,1000,926,74,1.04275286757039,2.24242424242424,4.61775071112395e-05
2009,"University of Maryland, College Park",UMHOOsd,37,1000,839,161,1.11482720178372,2.77586206896552,0.0151566686034395
2009,"University of Maryland, College Park",UMHOOsd,38,1000,912,88,1.04712041884817,2.04651162790698,0.000224013575549636
2009,"University of Maryland, College Park",UMHOOsd,39,1000,840,160,1.10497237569061,2.46153846153846,0.00341739964380825
2009,"University of Maryland, College Park",UMHOOsd,40,132,120,12,1.04761904761905,2,0.12369210651147
2009,"University of Maryland, College Park",UMHOOsd,41,1000,793,207,1.13895216400911,2.43529411764706,0.00166929430985015
2009,"University of Maryland, College Park",UMHOOsd,42,1000,840,160,1.1001100110011,2.31884057971015,0.0976863514290947
2009,"University of Maryland, College Park",UMHOOsd,43,1000,898,102,1.06157112526539,2.31818181818182,0.395859783548669
2009,"University of Maryland, College Park",UMHOOsd,44,1000,797,203,1.16686114352392,3.38333333333333,0.112170261391321
2009,"University of Maryland, College Park",UMHOOsd,45,1000,878,122,1.0752688172043,2.34615384615385,0.0434659056997786
2009,"University of Maryland, College Park",UMHOOsd,46,1000,855,145,1.10497237569061,2.9,0.0150784268915125
2009,"University of Maryland, College Park",UMHOOsd,47,1000,898,102,1.05932203389831,2.21739130434783,0.230482589448351
2009,"University of Maryland, College Park",UMHOOsd,48,1000,889,111,1.07296137339056,2.58139534883721,0.0104878340544681
2009,"University of Maryland, College Park",UMHOOsd,49,1000,738,262,1.19760479041916,2.70103092783505,0.279916563330016
2009,"University of Maryland, College Park",UMHOOsd,50,1000,926,74,1.04166666666667,2.17647058823529,0.00955120684081971
2009,"University of Maryland, College Park",UMHOOsdp,1,1000,854,146,1.11111111111111,3.17391304347826,0.343493668775758
2009,"University of Maryland, College Park",UMHOOsdp,2,1000,818,182,1.11482720178372,2.30379746835443,0.0917483246018993
2009,"University of Maryland, College Park",UMHOOsdp,3,1000,871,129,1.07991360691145,2.34545454545455,0.215752221604514
2009,"University of Maryland, College Park",UMHOOsdp,4,1000,802,198,1.14025085518814,2.64,0.0320041299248592
2009,"University of Maryland, College Park",UMHOOsdp,5,1000,840,160,1.1001100110011,2.31884057971015,0.00268209631113384
2009,"University of Maryland, College Park",UMHOOsdp,6,1000,584,416,1.32275132275132,2.41860465116279,0.0832705151004534
2009,"University of Maryland, College Park",UMHOOsdp,7,1000,950,50,1.02669404517454,2.08333333333333,0.0393661251764411
2009,"University of Maryland, College Park",UMHOOsdp,8,1000,841,159,1.1037527593819,2.44615384615385,0.000556229171175505
2009,"University of Maryland, College Park",UMHOOsdp,9,1000,932,68,1.03950103950104,2.26666666666667,0.000214471266638085
2009,"University of Maryland, College Park",UMHOOsdp,10,1000,828,172,1.10864745011086,2.32432432432432,0.00101649451012333
2009,"University of Maryland, College Park",UMHOOsdp,11,1000,857,143,1.08225108225108,2.13432835820896,0.0603048256423658
2009,"University of Maryland, College Park",UMHOOsdp,12,1000,752,248,1.18203309692671,2.63829787234043,0.165731043804866
2009,"University of Maryland, College Park",UMHOOsdp,13,1000,422,578,1.70648464163823,3.52439024390244,0.0387785789780719
2009,"University of Maryland, College Park",UMHOOsdp,14,1000,782,218,1.13378684807256,2.18,0.115631880319757
2009,"University of Maryland, College Park",UMHOOsdp,15,1000,909,91,1.05263157894737,2.21951219512195,0.278279426507987
2009,"University of Maryland, College Park",UMHOOsdp,16,1000,745,255,1.15340253748558,2.09016393442623,0.0217482013183181
2009,"University of Maryland, College Park",UMHOOsdp,17,1000,967,33,1.0183299389002,2.2,0.00805450142454852
2009,"University of Maryland, College Park",UMHOOsdp,18,1000,913,87,1.0515247108307,2.28947368421053,0.0930442814686156
2009,"University of Maryland, College Park",UMHOOsdp,19,1000,770,230,1.17508813160987,2.83950617283951,0.0341505489297592
2009,"University of Maryland, College Park",UMHOOsdp,20,1000,858,142,1.08813928182807,2.32786885245902,0.0158302093843247
2009,"University of Maryland, College Park",UMHOOsdp,21,1000,875,125,1.09289617486339,3.125,0.0736109129609825
2009,"University of Maryland, College Park",UMHOOsdp,22,1000,961,39,1.02145045965271,2.16666666666667,2.52700334701251e-10
2009,"University of Maryland, College Park",UMHOOsdp,23,1000,428,572,1.89753320683112,5.77777777777778,0.0929011330228762
2009,"University of Maryland, College Park",UMHOOsdp,24,1000,847,153,1.09409190371991,2.28358208955224,0.00546658467407587
2009,"University of Maryland, College Park",UMHOOsdp,25,1000,693,307,1.23152709359606,2.57983193277311,0.204561826236811
2009,"University of Maryland, College Park",UMHOOsdp,26,1000,854,146,1.09649122807018,2.51724137931035,0.000745239795864084
2009,"University of Maryland, College Park",UMHOOsdp,27,1000,901,99,1.05708245243129,2.2,0.0979722148941264
2009,"University of Maryland, College Park",UMHOOsdp,28,1000,637,363,1.33868808567604,3.3,0.00676796460854847
2009,"University of Maryland, College Park",UMHOOsdp,29,1000,880,120,1.07874865156419,2.5531914893617,0.000193162829127877
2009,"University of Maryland, College Park",UMHOOsdp,30,1000,863,137,1.0752688172043,2.04477611940299,0.101966816824863
2009,"University of Maryland, College Park",UMHOOsdp,31,1000,770,230,1.16279069767442,2.55555555555556,0.31214517439906
2009,"University of Maryland, College Park",UMHOOsdp,32,1000,855,145,1.08695652173913,2.23076923076923,0.189948804265971
2009,"University of Maryland, College Park",UMHOOsdp,33,1000,925,75,1.04384133611691,2.27272727272727,0.000793170514607555
2009,"University of Maryland, College Park",UMHOOsdp,34,1000,930,70,1.03734439834025,2.05882352941176,1.93236151131112e-08
2009,"University of Maryland, College Park",UMHOOsdp,35,1000,743,257,1.17370892018779,2.35779816513761,0.364172674555559
2009,"University of Maryland, College Park",UMHOOsdp,36,1000,926,74,1.04275286757039,2.24242424242424,4.61775071112395e-05
2009,"University of Maryland, College Park",UMHOOsdp,37,1000,839,161,1.11482720178372,2.77586206896552,0.0151566686034395
2009,"University of Maryland, College Park",UMHOOsdp,38,1000,912,88,1.04712041884817,2.04651162790698,0.000224013575549636
2009,"University of Maryland, College Park",UMHOOsdp,39,1000,840,160,1.10497237569061,2.46153846153846,0.00341739964380825
2009,"University of Maryland, College Park",UMHOOsdp,40,132,120,12,1.04761904761905,2,0.12369210651147
2009,"University of Maryland, College Park",UMHOOsdp,41,1000,793,207,1.13895216400911,2.43529411764706,0.00166929430985015
2009,"University of Maryland, College Park",UMHOOsdp,42,1000,840,160,1.1001100110011,2.31884057971015,0.0976863514290947
2009,"University of Maryland, College Park",UMHOOsdp,43,1000,898,102,1.06157112526539,2.31818181818182,0.395859783548669
2009,"University of Maryland, College Park",UMHOOsdp,44,1000,797,203,1.16686114352392,3.38333333333333,0.112170261391321
2009,"University of Maryland, College Park",UMHOOsdp,45,1000,878,122,1.0752688172043,2.34615384615385,0.0434659056997786
2009,"University of Maryland, College Park",UMHOOsdp,46,1000,855,145,1.10497237569061,2.9,0.0150784268915125
2009,"University of Maryland, College Park",UMHOOsdp,47,1000,898,102,1.05932203389831,2.21739130434783,0.230482589448351
2009,"University of Maryland, College Park",UMHOOsdp,48,1000,889,111,1.07296137339056,2.58139534883721,0.0104878340544681
2009,"University of Maryland, College Park",UMHOOsdp,49,1000,738,262,1.19760479041916,2.70103092783505,0.279916563330016
2009,"University of Maryland, College Park",UMHOOsdp,50,1000,926,74,1.04166666666667,2.17647058823529,0.00955120684081971
2009,University of Amsterdam,UamsAw7an3,1,1000,745,255,1.18343195266272,2.55,5.6935855830319e-07
2009,University of Amsterdam,UamsAw7an3,2,1000,968,32,1.01729399796541,2.13333333333333,0.0122760555895323
2009,University of Amsterdam,UamsAw7an3,3,1000,952,48,1.02459016393443,2,1.78687633962241e-05
2009,University of Amsterdam,UamsAw7an3,4,1000,899,101,1.05374077976818,2.02,0.000379368890969978
2009,University of Amsterdam,UamsAw7an3,5,1000,940,60,1.03092783505155,2,0.0352074757218311
2009,University of Amsterdam,UamsAw7an3,6,1000,844,156,1.09170305676856,2.16666666666667,1.86564121210858e-05
2009,University of Amsterdam,UamsAw7an3,7,1000,951,49,1.02564102564103,2.04166666666667,4.29454189879121e-07
2009,University of Amsterdam,UamsAw7an3,8,1000,863,137,1.07874865156419,2.140625,2.11010448762476e-08
2009,University of Amsterdam,UamsAw7an3,9,1000,948,52,1.02669404517454,2,6.92273039702065e-06
2009,University of Amsterdam,UamsAw7an3,10,1000,962,38,1.01936799184506,2,0.0547862096015984
2009,University of Amsterdam,UamsAw7an3,11,1000,994,6,1.00300902708124,2,1.29726842721459e-19
2009,University of Amsterdam,UamsAw7an3,12,1000,899,101,1.05596620908131,2.10416666666667,1.08353876133979e-17
2009,University of Amsterdam,UamsAw7an3,13,1000,948,52,1.02880658436214,2.16666666666667,7.23863341477143e-12
2009,University of Amsterdam,UamsAw7an3,14,1000,821,179,1.10987791342952,2.2375,0.039119315850702
2009,University of Amsterdam,UamsAw7an3,15,1000,921,79,1.04275286757039,2.07894736842105,5.60743716435634e-06
2009,University of Amsterdam,UamsAw7an3,16,1000,976,24,1.01214574898785,2,0.00204730443470327
2009,University of Amsterdam,UamsAw7an3,17,1000,976,24,1.01214574898785,2,2.23075871189132e-12
2009,University of Amsterdam,UamsAw7an3,18,1000,783,217,1.13122171945701,2.14851485148515,4.22726493263646e-05
2009,University of Amsterdam,UamsAw7an3,19,1000,898,102,1.05485232067511,2.04,0.000174211299787875
2009,University of Amsterdam,UamsAw7an3,20,1000,827,173,1.10253583241455,2.1625,8.42324892716082e-07
2009,University of Amsterdam,UamsAw7an3,21,1000,912,88,1.04712041884817,2.04651162790698,7.44404328945611e-15
2009,University of Amsterdam,UamsAw7an3,22,1000,980,20,1.01010101010101,2,5.68238657766716e-12
2009,University of Amsterdam,UamsAw7an3,23,1000,962,38,1.02040816326531,2.11111111111111,5.34633689033441e-05
2009,University of Amsterdam,UamsAw7an3,24,1000,795,205,1.12233445566779,2.13541666666667,2.56692737550252e-05
2009,University of Amsterdam,UamsAw7an3,25,1000,801,199,1.12739571589628,2.31395348837209,4.16421848990839e-06
2009,University of Amsterdam,UamsAw7an3,26,1000,972,28,1.01419878296146,2,4.96140124176307e-14
2009,University of Amsterdam,UamsAw7an3,27,1000,901,99,1.05374077976818,2.0625,9.18885351446874e-25
2009,University of Amsterdam,UamsAw7an3,28,1000,908,92,1.05042016806723,2.09090909090909,7.25725022283417e-08
2009,University of Amsterdam,UamsAw7an3,29,1000,965,35,1.0183299389002,2.05882352941176,2.41380463458507e-06
2009,University of Amsterdam,UamsAw7an3,30,1000,962,38,1.01936799184506,2,2.39093998948959e-11
2009,University of Amsterdam,UamsAw7an3,31,1000,870,130,1.07758620689655,2.24137931034483,3.62150545092351e-05
2009,University of Amsterdam,UamsAw7an3,32,1000,947,53,1.02774922918808,2.03846153846154,0.000578218044351777
2009,University of Amsterdam,UamsAw7an3,33,1000,898,102,1.05820105820106,2.17021276595745,8.70421980342069e-18
2009,University of Amsterdam,UamsAw7an3,34,1000,961,39,1.02040816326531,2.05263157894737,9.85443348929862e-21
2009,University of Amsterdam,UamsAw7an3,35,1000,869,131,1.07874865156419,2.25862068965517,5.6941228473663e-05
2009,University of Amsterdam,UamsAw7an3,36,1000,870,130,1.0752688172043,2.16666666666667,5.34591584554689e-16
2009,University of Amsterdam,UamsAw7an3,37,1000,789,211,1.12359550561798,2.08910891089109,0.0316973907336611
2009,University of Amsterdam,UamsAw7an3,38,1000,972,28,1.01419878296146,2,9.92312018118383e-10
2009,University of Amsterdam,UamsAw7an3,39,1000,972,28,1.01419878296146,2,6.47263318904372e-21
2009,University of Amsterdam,UamsAw7an3,40,142,132,10,1.03649635036496,2,0.000137766652439617
2009,University of Amsterdam,UamsAw7an3,41,1000,968,32,1.01626016260163,2,1.51264183740391e-10
2009,University of Amsterdam,UamsAw7an3,42,1000,928,72,1.03734439834025,2,0.00197477743046797
2009,University of Amsterdam,UamsAw7an3,43,1000,948,52,1.02669404517454,2,6.1707046600553e-07
2009,University of Amsterdam,UamsAw7an3,44,1000,923,77,1.04058272632674,2.02631578947368,0.0150642094862605
2009,University of Amsterdam,UamsAw7an3,45,1000,976,24,1.01214574898785,2,1.33770280632384e-17
2009,University of Amsterdam,UamsAw7an3,46,1000,967,33,1.01729399796541,2.0625,0.000379389908691674
2009,University of Amsterdam,UamsAw7an3,47,1000,792,208,1.12739571589628,2.18947368421053,3.18169938614726e-06
2009,University of Amsterdam,UamsAw7an3,48,1000,979,21,1.01112234580384,2.1,1.17023700061639e-12
2009,University of Amsterdam,UamsAw7an3,49,1000,974,26,1.01317122593718,2,0.000185559807538896
2009,University of Amsterdam,UamsAw7an3,50,1000,966,34,1.01729399796541,2,1.10671235692572e-09
2009,University of Amsterdam,UamsAwebQE10,1,1000,914,86,1.04493207941484,2,8.39502677085137e-06
2009,University of Amsterdam,UamsAwebQE10,2,1000,953,47,1.02459016393443,2.04347826086957,0.0482954507613906
2009,University of Amsterdam,UamsAwebQE10,3,1000,973,27,1.01419878296146,2.07692307692308,9.6285982286859e-12
2009,University of Amsterdam,UamsAwebQE10,4,1000,950,50,1.02669404517454,2.08333333333333,0.000881301511302407
2009,University of Amsterdam,UamsAwebQE10,5,1000,952,48,1.02459016393443,2,0.020795108360603
2009,University of Amsterdam,UamsAwebQE10,6,1000,744,256,1.16009280742459,2.16949152542373,0.0342774524631567
2009,University of Amsterdam,UamsAwebQE10,7,1000,769,231,1.25,7.45161290322581,2.19141387610678e-06
2009,University of Amsterdam,UamsAwebQE10,8,1000,943,57,1.02986611740474,2.03571428571429,0.0043701011030637
2009,University of Amsterdam,UamsAwebQE10,9,1000,956,44,1.02354145342886,2.0952380952381,0.000132909825326117
2009,University of Amsterdam,UamsAwebQE10,10,1000,932,68,1.03734439834025,2.125,0.00327672435425953
2009,University of Amsterdam,UamsAwebQE10,11,1000,964,36,1.0183299389002,2,0.0443472012365587
2009,University of Amsterdam,UamsAwebQE10,12,1000,787,213,1.13765642775882,2.31521739130435,0.00895010461700821
2009,University of Amsterdam,UamsAwebQE10,13,1000,596,404,1.31061598951507,2.41916167664671,0.00022585650803292
2009,University of Amsterdam,UamsAwebQE10,14,1000,926,74,1.03842159916926,2,8.97861290150946e-07
2009,University of Amsterdam,UamsAwebQE10,15,1000,732,268,1.22549019607843,3.19047619047619,0.0408896856264667
2009,University of Amsterdam,UamsAwebQE10,16,1000,956,44,1.02249488752556,2,0.000421634791166801
2009,University of Amsterdam,UamsAwebQE10,17,1000,958,42,1.02145045965271,2,6.38504724099486e-14
2009,University of Amsterdam,UamsAwebQE10,18,1000,817,183,1.10497237569061,2.07954545454545,0.000163307787345131
2009,University of Amsterdam,UamsAwebQE10,19,1000,909,91,1.04931794333683,2.06818181818182,0.00253721768662558
2009,University of Amsterdam,UamsAwebQE10,20,1000,898,102,1.05485232067511,2.04,6.4804881227044e-11
2009,University of Amsterdam,UamsAwebQE10,21,1000,945,55,1.03199174406605,2.29166666666667,3.2335350059233e-05
2009,University of Amsterdam,UamsAwebQE10,22,1000,984,16,1.00806451612903,2,8.39906900930975e-14
2009,University of Amsterdam,UamsAwebQE10,23,1000,678,322,1.26422250316056,2.84955752212389,0.000216085870908985
2009,University of Amsterdam,UamsAwebQE10,24,1000,833,167,1.10132158590308,2.22666666666667,0.000148693822070209
2009,University of Amsterdam,UamsAwebQE10,25,1000,881,119,1.06496272630458,2.05172413793103,0.0353701893342366
2009,University of Amsterdam,UamsAwebQE10,26,1000,963,37,1.01936799184506,2.05555555555556,2.23282918321772e-18
2009,University of Amsterdam,UamsAwebQE10,27,1000,952,48,1.02564102564103,2.08695652173913,0.00652575892211069
2009,University of Amsterdam,UamsAwebQE10,28,1000,874,126,1.07181136120043,2.13559322033898,1.65743372341718e-06
2009,University of Amsterdam,UamsAwebQE10,29,1000,970,30,1.01522842639594,2,2.71228581266386e-08
2009,University of Amsterdam,UamsAwebQE10,30,1000,876,124,1.06951871657754,2.10169491525424,1.17394014030061e-05
2009,University of Amsterdam,UamsAwebQE10,31,1000,917,83,1.04493207941484,2.075,0.0559496685341173
2009,University of Amsterdam,UamsAwebQE10,32,1000,958,42,1.02249488752556,2.1,0.0187106471730086
2009,University of Amsterdam,UamsAwebQE10,33,1000,956,44,1.02354145342886,2.0952380952381,4.5326522522235e-13
2009,University of Amsterdam,UamsAwebQE10,34,1000,826,174,1.11482720178372,2.45070422535211,0.0596240132591507
2009,University of Amsterdam,UamsAwebQE10,35,1000,892,108,1.06044538706257,2.11764705882353,0.0232483536380871
2009,University of Amsterdam,UamsAwebQE10,36,1000,954,46,1.02354145342886,2,3.02609030682187e-05
2009,University of Amsterdam,UamsAwebQE10,37,1000,682,318,1.26103404791929,2.86486486486487,0.00528972985973807
2009,University of Amsterdam,UamsAwebQE10,38,1000,966,34,1.01729399796541,2,0.000979974766851835
2009,University of Amsterdam,UamsAwebQE10,39,1000,957,43,1.02249488752556,2.04761904761905,7.24603090041525e-14
2009,University of Amsterdam,UamsAwebQE10,40,141,133,8,1.02919708029197,2,0.0312286039742071
2009,University of Amsterdam,UamsAwebQE10,41,1000,889,111,1.07066381156317,2.46666666666667,7.42033430958826e-06
2009,University of Amsterdam,UamsAwebQE10,42,1000,945,55,1.02880658436214,2.03703703703704,0.00809085787065124
2009,University of Amsterdam,UamsAwebQE10,43,1000,975,25,1.01317122593718,2.08333333333333,0.101106072073367
2009,University of Amsterdam,UamsAwebQE10,44,1000,925,75,1.03950103950104,2.02702702702703,0.0812254572832023
2009,University of Amsterdam,UamsAwebQE10,45,1000,946,54,1.02986611740474,2.16,1.60828885879052e-05
2009,University of Amsterdam,UamsAwebQE10,46,1000,943,57,1.02986611740474,2.03571428571429,0.00346720357238459
2009,University of Amsterdam,UamsAwebQE10,47,1000,535,465,1.4903129657228,3.41911764705882,0.00326375159402245
2009,University of Amsterdam,UamsAwebQE10,48,1000,933,67,1.04058272632674,2.39285714285714,0.000713850549317104
2009,University of Amsterdam,UamsAwebQE10,49,1000,923,77,1.04602510460251,2.33333333333333,7.58154218490263e-05
2009,University of Amsterdam,UamsAwebQE10,50,1000,950,50,1.02986611740474,2.38095238095238,2.99198820595911e-09
2009,University of Waterloo (Smucker),WatSdmrm3,1,1000,920,80,1.04275286757039,2.05128205128205,0.263586293043938
2009,University of Waterloo (Smucker),WatSdmrm3,2,1000,974,26,1.01317122593718,2,1.33718766161103e-06
2009,University of Waterloo (Smucker),WatSdmrm3,3,1000,958,42,1.02145045965271,2,3.87145846119723e-12
2009,University of Waterloo (Smucker),WatSdmrm3,4,1000,922,78,1.05374077976818,2.88888888888889,1.51779481383505e-06
2009,University of Waterloo (Smucker),WatSdmrm3,5,1000,953,47,1.02459016393443,2.04347826086957,1.02324028246603e-07
2009,University of Waterloo (Smucker),WatSdmrm3,6,1000,945,55,1.02880658436214,2.03703703703704,2.72348376036745e-05
2009,University of Waterloo (Smucker),WatSdmrm3,7,1000,946,54,1.03305785123967,2.45454545454545,1.55957915705555e-07
2009,University of Waterloo (Smucker),WatSdmrm3,8,1000,977,23,1.01214574898785,2.09090909090909,0.19
2009,University of Waterloo (Smucker),WatSdmrm3,9,1000,965,35,1.0183299389002,2.05882352941176,9.59411277003992e-18
2009,University of Waterloo (Smucker),WatSdmrm3,10,1000,956,44,1.02249488752556,2,6.90845544121662e-13
2009,University of Waterloo (Smucker),WatSdmrm3,11,1000,947,53,1.02774922918808,2.03846153846154,0.00805692196386828
2009,University of Waterloo (Smucker),WatSdmrm3,12,1000,871,129,1.0989010989011,3.30769230769231,0.114978573365368
2009,University of Waterloo (Smucker),WatSdmrm3,13,1000,792,208,1.17508813160987,3.52542372881356,5.32994340760893e-09
2009,University of Waterloo (Smucker),WatSdmrm3,14,1000,964,36,1.0183299389002,2,5.18971123634174e-22
2009,University of Waterloo (Smucker),WatSdmrm3,15,1000,964,36,1.0183299389002,2,2.31292052051761e-16
2009,University of Waterloo (Smucker),WatSdmrm3,16,1000,940,60,1.03305785123967,2.14285714285714,0.000333889951238532
2009,University of Waterloo (Smucker),WatSdmrm3,17,1000,975,25,1.01317122593718,2.08333333333333,2.6080672977665e-09
2009,University of Waterloo (Smucker),WatSdmrm3,18,1000,972,28,1.01419878296146,2,2.26554756639529e-06
2009,University of Waterloo (Smucker),WatSdmrm3,19,1000,984,16,1.00806451612903,2,0.00284327377923541
2009,University of Waterloo (Smucker),WatSdmrm3,20,1000,949,51,1.02774922918808,2.125,3.96432073906438e-08
2009,University of Waterloo (Smucker),WatSdmrm3,21,1000,979,21,1.01112234580384,2.1,0.153900000000001
2009,University of Waterloo (Smucker),WatSdmrm3,22,1000,968,32,1.01626016260163,2,0.000202164373645333
2009,University of Waterloo (Smucker),WatSdmrm3,23,1000,955,45,1.02459016393443,2.14285714285714,7.9016772959313e-08
2009,University of Waterloo (Smucker),WatSdmrm3,24,1000,927,73,1.03950103950104,2.08571428571429,1.18216680974311e-07
2009,University of Waterloo (Smucker),WatSdmrm3,25,1000,935,65,1.03626943005181,2.16666666666667,0.153697928959584
2009,University of Waterloo (Smucker),WatSdmrm3,26,1000,962,38,1.01936799184506,2,0.136181173715658
2009,University of Waterloo (Smucker),WatSdmrm3,27,1000,976,24,1.01214574898785,2,1.74953989760276e-09
2009,University of Waterloo (Smucker),WatSdmrm3,28,1000,960,40,1.02354145342886,2.35294117647059,9.27340130085494e-06
2009,University of Waterloo (Smucker),WatSdmrm3,29,1000,958,42,1.02145045965271,2,4.61225031336615e-05
2009,University of Waterloo (Smucker),WatSdmrm3,30,1000,973,27,1.01419878296146,2.07692307692308,0.0908769079929039
2009,University of Waterloo (Smucker),WatSdmrm3,31,1000,953,47,1.02459016393443,2.04347826086957,4.49625047693113e-06
2009,University of Waterloo (Smucker),WatSdmrm3,32,1000,954,46,1.02459016393443,2.09090909090909,7.92944851624238e-06
2009,University of Waterloo (Smucker),WatSdmrm3,33,1000,988,12,1.00603621730382,2,3.96424036295558e-08
2009,University of Waterloo (Smucker),WatSdmrm3,34,1000,970,30,1.01522842639594,2,1.422855729458e-13
2009,University of Waterloo (Smucker),WatSdmrm3,35,1000,960,40,1.02459016393443,2.5,0.00046853006486971
2009,University of Waterloo (Smucker),WatSdmrm3,36,1000,971,29,1.01522842639594,2.07142857142857,2.93462289898849e-07
2009,University of Waterloo (Smucker),WatSdmrm3,37,1000,957,43,1.02249488752556,2.04761904761905,1.42631979052203e-06
2009,University of Waterloo (Smucker),WatSdmrm3,38,1000,910,90,1.0482180293501,2.04545454545455,0.0125865473747501
2009,University of Waterloo (Smucker),WatSdmrm3,39,1000,986,14,1.00704934541793,2,6.32680441415164e-05
2009,University of Waterloo (Smucker),WatSdmrm3,40,1000,954,46,1.02459016393443,2.09090909090909,1.40362102785884e-07
2009,University of Waterloo (Smucker),WatSdmrm3,41,1000,749,251,1.18623962040332,2.67021276595745,0.00120891026828997
2009,University of Waterloo (Smucker),WatSdmrm3,42,1000,968,32,1.0183299389002,2.28571428571429,0.00588258651210101
2009,University of Waterloo (Smucker),WatSdmrm3,43,1000,987,13,1.00704934541793,2.16666666666667,1.86720822963565e-09
2009,University of Waterloo (Smucker),WatSdmrm3,44,1000,948,52,1.02880658436214,2.16666666666667,2.23989165450844e-11
2009,University of Waterloo (Smucker),WatSdmrm3,45,1000,951,49,1.02564102564103,2.04166666666667,1.53724073279003e-16
2009,University of Waterloo (Smucker),WatSdmrm3,46,1000,943,57,1.03199174406605,2.19230769230769,1.05638440781843e-05
2009,University of Waterloo (Smucker),WatSdmrm3,47,1000,972,28,1.01419878296146,2,5.90939286814283e-12
2009,University of Waterloo (Smucker),WatSdmrm3,48,1000,968,32,1.01626016260163,2,4.24102890149909e-15
2009,University of Waterloo (Smucker),WatSdmrm3,49,1000,949,51,1.02880658436214,2.21739130434783,0.015156061078046
2009,University of Waterloo (Smucker),WatSdmrm3,50,1000,969,31,1.01626016260163,2.06666666666667,0.0297411522993016
2009,University of Waterloo (Smucker),WatSdmrm3we,1,1000,946,54,1.02880658436214,2.07692307692308,0.214286336808153
2009,University of Waterloo (Smucker),WatSdmrm3we,2,1000,968,32,1.01626016260163,2,0.00188232675040474
2009,University of Waterloo (Smucker),WatSdmrm3we,3,1000,962,38,1.01936799184506,2,8.61089471871292e-11
2009,University of Waterloo (Smucker),WatSdmrm3we,4,1000,923,77,1.04712041884817,2.40625,1.21920689932589e-05
2009,University of Waterloo (Smucker),WatSdmrm3we,5,1000,967,33,1.01729399796541,2.0625,4.27974228528541e-10
2009,University of Waterloo (Smucker),WatSdmrm3we,6,1000,955,45,1.02354145342886,2.04545454545455,0.000979358596507385
2009,University of Waterloo (Smucker),WatSdmrm3we,7,1000,894,106,1.07066381156317,2.65,0.00587159934136718
2009,University of Waterloo (Smucker),WatSdmrm3we,8,1000,955,45,1.02354145342886,2.04545454545455,0.0908764234402155
2009,University of Waterloo (Smucker),WatSdmrm3we,9,1000,966,34,1.01729399796541,2,6.69966217115273e-15
2009,University of Waterloo (Smucker),WatSdmrm3we,10,1000,978,22,1.01112234580384,2,3.11525732137632e-10
2009,University of Waterloo (Smucker),WatSdmrm3we,11,1000,978,22,1.01112234580384,2,4.15101551461505e-05
2009,University of Waterloo (Smucker),WatSdmrm3we,12,1000,921,79,1.04275286757039,2.07894736842105,0.0296435547753656
2009,University of Waterloo (Smucker),WatSdmrm3we,13,1000,845,155,1.10132158590308,2.46031746031746,0.0103145053500866
2009,University of Waterloo (Smucker),WatSdmrm3we,14,1000,937,63,1.03412616339193,2.1,0.00134323954419596
2009,University of Waterloo (Smucker),WatSdmrm3we,15,1000,988,12,1.00603621730382,2,8.2288901089241e-22
2009,University of Waterloo (Smucker),WatSdmrm3we,16,1000,952,48,1.02459016393443,2,0.000954461192123456
2009,University of Waterloo (Smucker),WatSdmrm3we,17,1000,970,30,1.01522842639594,2,6.73391944971483e-08
2009,University of Waterloo (Smucker),WatSdmrm3we,18,1000,973,27,1.01419878296146,2.07692307692308,2.43654565679943e-07
2009,University of Waterloo (Smucker),WatSdmrm3we,19,1000,950,50,1.02564102564103,2,9.39088299887808e-07
2009,University of Waterloo (Smucker),WatSdmrm3we,20,1000,963,37,1.02040816326531,2.17647058823529,3.32832342585978e-10
2009,University of Waterloo (Smucker),WatSdmrm3we,21,1000,982,18,1.00908173562059,2,2.59557730584855e-15
2009,University of Waterloo (Smucker),WatSdmrm3we,22,1000,982,18,1.00908173562059,2,3.40728225546529e-11
2009,University of Waterloo (Smucker),WatSdmrm3we,23,1000,901,99,1.05596620908131,2.15217391304348,0.00134332774059343
2009,University of Waterloo (Smucker),WatSdmrm3we,24,1000,912,88,1.05042016806723,2.2,2.46969178421513e-12
2009,University of Waterloo (Smucker),WatSdmrm3we,25,1000,934,66,1.0351966873706,2.0625,0.135400703820723
2009,University of Waterloo (Smucker),WatSdmrm3we,26,1000,971,29,1.01522842639594,2.07142857142857,0.0483115326228501
2009,University of Waterloo (Smucker),WatSdmrm3we,27,1000,980,20,1.01010101010101,2,1.4099869500354e-08
2009,University of Waterloo (Smucker),WatSdmrm3we,28,1000,805,195,1.18063754427391,4.64285714285714,1.24514942355045e-10
2009,University of Waterloo (Smucker),WatSdmrm3we,29,1000,972,28,1.01419878296146,2,2.14958062355136e-07
2009,University of Waterloo (Smucker),WatSdmrm3we,30,1000,972,28,1.01419878296146,2,0.0740499725757513
2009,University of Waterloo (Smucker),WatSdmrm3we,31,1000,933,67,1.03626943005181,2.09375,0.0507654118868416
2009,University of Waterloo (Smucker),WatSdmrm3we,32,1000,954,46,1.02564102564103,2.19047619047619,3.41336782050492e-06
2009,University of Waterloo (Smucker),WatSdmrm3we,33,1000,988,12,1.00603621730382,2,4.81959082968457e-09
2009,University of Waterloo (Smucker),WatSdmrm3we,34,1000,984,16,1.00806451612903,2,6.42720701728809e-11
2009,University of Waterloo (Smucker),WatSdmrm3we,35,1000,964,36,1.0183299389002,2,3.73592736369304e-05
2009,University of Waterloo (Smucker),WatSdmrm3we,36,1000,954,46,1.02354145342886,2,1.58370421679593e-06
2009,University of Waterloo (Smucker),WatSdmrm3we,37,1000,984,16,1.00806451612903,2,1.12552228203912e-13
2009,University of Waterloo (Smucker),WatSdmrm3we,38,1000,955,45,1.02354145342886,2.04545454545455,0.000988604061077639
2009,University of Waterloo (Smucker),WatSdmrm3we,39,1000,968,32,1.01626016260163,2,0.000107144965946777
2009,University of Waterloo (Smucker),WatSdmrm3we,40,1000,943,57,1.03092783505155,2.11111111111111,0.000714014945402674
2009,University of Waterloo (Smucker),WatSdmrm3we,41,1000,758,242,1.16822429906542,2.46938775510204,2.51411361894347e-12
2009,University of Waterloo (Smucker),WatSdmrm3we,42,1000,967,33,1.01936799184506,2.35714285714286,5.19294509448703e-06
2009,University of Waterloo (Smucker),WatSdmrm3we,43,1000,952,48,1.02669404517454,2.18181818181818,0.00010748524147173
2009,University of Waterloo (Smucker),WatSdmrm3we,44,1000,945,55,1.03092783505155,2.2,1.03816551895631e-09
2009,University of Waterloo (Smucker),WatSdmrm3we,45,1000,978,22,1.01112234580384,2,1.53582793991682e-08
2009,University of Waterloo (Smucker),WatSdmrm3we,46,1000,967,33,1.0183299389002,2.2,0.000471693720755948
2009,University of Waterloo (Smucker),WatSdmrm3we,47,1000,983,17,1.00908173562059,2.125,1.98544589777806e-05
2009,University of Waterloo (Smucker),WatSdmrm3we,48,1000,985,15,1.00806451612903,2.14285714285714,5.15687868752605e-14
2009,University of Waterloo (Smucker),WatSdmrm3we,49,1000,931,69,1.04058272632674,2.3,0.00807802241276411
2009,University of Waterloo (Smucker),WatSdmrm3we,50,1000,970,30,1.0183299389002,2.5,0.0197625305075726
2009,University of Waterloo (Smucker),WatSql,1,1000,738,262,1.17508813160987,2.31858407079646,0.0503382239139523
2009,University of Waterloo (Smucker),WatSql,2,1000,962,38,1.01936799184506,2,7.25502420403941e-06
2009,University of Waterloo (Smucker),WatSql,3,1000,961,39,1.02145045965271,2.16666666666667,1.92445622946944e-19
2009,University of Waterloo (Smucker),WatSql,4,1000,907,93,1.06269925611052,2.73529411764706,0.0361572004751034
2009,University of Waterloo (Smucker),WatSql,5,1000,952,48,1.02564102564103,2.08695652173913,7.49080200582741e-08
2009,University of Waterloo (Smucker),WatSql,6,1000,861,139,1.08108108108108,2.171875,0.000403034399285297
2009,University of Waterloo (Smucker),WatSql,7,1000,924,76,1.04493207941484,2.3030303030303,0.0434699934647753
2009,University of Waterloo (Smucker),WatSql,8,1000,948,52,1.02774922918808,2.08,0.19
2009,University of Waterloo (Smucker),WatSql,9,1000,957,43,1.02249488752556,2.04761904761905,0.138510000071249
2009,University of Waterloo (Smucker),WatSql,10,1000,965,35,1.0183299389002,2.05882352941176,1.66954437769624e-05
2009,University of Waterloo (Smucker),WatSql,11,1000,924,76,1.04275286757039,2.17142857142857,0.00588491693640169
2009,University of Waterloo (Smucker),WatSql,12,1000,754,246,1.16279069767442,2.32075471698113,0.0271459822965339
2009,University of Waterloo (Smucker),WatSql,13,1000,735,265,1.23152709359606,3.44155844155844,9.49302626455369e-11
2009,University of Waterloo (Smucker),WatSql,14,1000,942,58,1.03092783505155,2.07142857142857,0.00724888806506198
2009,University of Waterloo (Smucker),WatSql,15,1000,964,36,1.0183299389002,2,0.043465949713146
2009,University of Waterloo (Smucker),WatSql,16,1000,946,54,1.02774922918808,2,3.24134853827899e-09
2009,University of Waterloo (Smucker),WatSql,17,1000,970,30,1.01522842639594,2,6.51057553059534e-10
2009,University of Waterloo (Smucker),WatSql,18,1000,963,37,1.01936799184506,2.05555555555556,2.67801179079412e-13
2009,University of Waterloo (Smucker),WatSql,19,1000,948,52,1.02986611740474,2.26086956521739,1.76090396684109e-06
2009,University of Waterloo (Smucker),WatSql,20,1000,941,59,1.03412616339193,2.26923076923077,4.79978402062099e-12
2009,University of Waterloo (Smucker),WatSql,21,1000,873,127,1.07874865156419,2.35185185185185,0.00184883064702172
2009,University of Waterloo (Smucker),WatSql,22,1000,980,20,1.01010101010101,2,2.16495494413125e-07
2009,University of Waterloo (Smucker),WatSql,23,1000,848,152,1.08932461873638,2.17142857142857,2.59079168485935e-11
2009,University of Waterloo (Smucker),WatSql,24,1000,939,61,1.03199174406605,2.03333333333333,0.00057824692414736
2009,University of Waterloo (Smucker),WatSql,25,1000,937,63,1.03412616339193,2.1,0.0333749201837112
2009,University of Waterloo (Smucker),WatSql,26,1000,960,40,1.02040816326531,2,0.0256718589552214
2009,University of Waterloo (Smucker),WatSql,27,1000,937,63,1.03412616339193,2.1,3.71184029708584e-12
2009,University of Waterloo (Smucker),WatSql,28,1000,932,68,1.04166666666667,2.42857142857143,0.0350910912859827
2009,University of Waterloo (Smucker),WatSql,29,1000,965,35,1.0183299389002,2.05882352941176,6.04212894754781e-08
2009,University of Waterloo (Smucker),WatSql,30,1000,961,39,1.02040816326531,2.05263157894737,0.0536794984080286
2009,University of Waterloo (Smucker),WatSql,31,1000,927,73,1.03842159916926,2.02777777777778,0.00118038746364392
2009,University of Waterloo (Smucker),WatSql,32,1000,878,122,1.06723585912487,2.06779661016949,0.0192937913184189
2009,University of Waterloo (Smucker),WatSql,33,1000,976,24,1.01214574898785,2,1.52039207256578e-08
2009,University of Waterloo (Smucker),WatSql,34,1000,949,51,1.02774922918808,2.125,0.00930745568185958
2009,University of Waterloo (Smucker),WatSql,35,1000,917,83,1.04712041884817,2.18421052631579,1.33886258200414e-05
2009,University of Waterloo (Smucker),WatSql,36,1000,916,84,1.0482180293501,2.21052631578947,5.60741377882515e-06
2009,University of Waterloo (Smucker),WatSql,37,1000,955,45,1.02774922918808,2.5,1.34131499334357e-10
2009,University of Waterloo (Smucker),WatSql,38,1000,904,96,1.05263157894737,2.08695652173913,0.000502963713446043
2009,University of Waterloo (Smucker),WatSql,39,1000,967,33,1.01729399796541,2.0625,0.0851749492770182
2009,University of Waterloo (Smucker),WatSql,40,1000,583,417,1.32802124833997,2.45294117647059,0.00118547515182098
2009,University of Waterloo (Smucker),WatSql,41,1000,723,277,1.22399020807834,2.9468085106383,1.60835657659558e-05
2009,University of Waterloo (Smucker),WatSql,42,1000,922,78,1.04602510460251,2.29411764705882,0.000176732509251386
2009,University of Waterloo (Smucker),WatSql,43,1000,947,53,1.03092783505155,2.30434782608696,2.96013664202588e-10
2009,University of Waterloo (Smucker),WatSql,44,1000,913,87,1.05485232067511,2.48571428571429,7.19582126264791e-12
2009,University of Waterloo (Smucker),WatSql,45,1000,954,46,1.02459016393443,2.09090909090909,8.53061226835548e-13
2009,University of Waterloo (Smucker),WatSql,46,1000,949,51,1.02774922918808,2.125,0.000894602951523285
2009,University of Waterloo (Smucker),WatSql,47,1000,974,26,1.01317122593718,2,8.91919849209133e-09
2009,University of Waterloo (Smucker),WatSql,48,1000,914,86,1.05932203389831,2.86666666666667,1.62658940562143e-16
2009,University of Waterloo (Smucker),WatSql,49,1000,915,85,1.05263157894737,2.42857142857143,0.0187305814297118
2009,University of Waterloo (Smucker),WatSql,50,1000,962,38,1.02040816326531,2.11111111111111,0.00497629074187893
2009,"ARSC, Univ of Alaska Fairbanks",arsc09web,1,1000,348,652,1.92307692307692,3.7906976744186,0.16673304125652
2009,"ARSC, Univ of Alaska Fairbanks",arsc09web,2,1000,738,262,1.20772946859903,2.91111111111111,0.0182797169383874
2009,"ARSC, Univ of Alaska Fairbanks",arsc09web,3,1000,72,928,6.5359477124183,11.4567901234568,0.491166596586213
2009,"ARSC, Univ of Alaska Fairbanks",arsc09web,4,1000,35,965,13.5135135135135,24.7435897435897,0.346785236826227
2009,"ARSC, Univ of Alaska Fairbanks",arsc09web,5,1000,252,748,2.5062656641604,5.08843537414966,0.117848539981811
2009,"ARSC, Univ of Alaska Fairbanks",arsc09web,6,123,15,108,4.73076923076923,9.81818181818182,0.406563789263188
2009,"ARSC, Univ of Alaska Fairbanks",arsc09web,7,1000,509,491,1.57728706624606,3.928,0.181236656208693
2009,"ARSC, Univ of Alaska Fairbanks",arsc09web,8,543,18,525,10.6470588235294,15.9090909090909,0.444643616079102
2009,"ARSC, Univ of Alaska Fairbanks",arsc09web,9,1000,709,291,1.25944584382872,3.42352941176471,0.00531654716092616
2009,"ARSC, Univ of Alaska Fairbanks",arsc09web,10,1000,221,779,2.9585798816568,6.65811965811966,0.138444025144791
2009,"ARSC, Univ of Alaska Fairbanks",arsc09web,11,1000,166,834,3.7037037037037,8.01923076923077,0.023314895049897
2009,"ARSC, Univ of Alaska Fairbanks",arsc09web,12,1000,11,989,19.6078431372549,24.725,0.703526526045155
2009,"ARSC, Univ of Alaska Fairbanks",arsc09web,13,1000,51,949,8.69565217391304,14.828125,0.48165124477254
2009,"ARSC, Univ of Alaska Fairbanks",arsc09web,14,1000,26,974,14.7058823529412,23.1904761904762,0.86288387507479
2009,"ARSC, Univ of Alaska Fairbanks",arsc09web,15,1000,225,775,2.68096514745308,5.23648648648649,0.1233654689056
2009,"ARSC, Univ of Alaska Fairbanks",arsc09web,16,1000,725,275,1.20192307692308,2.57009345794393,0.00291627272185025
2009,"ARSC, Univ of Alaska Fairbanks",arsc09web,17,1000,224,776,3.003003003003,7.11926605504587,0.0200659153763932
2009,"ARSC, Univ of Alaska Fairbanks",arsc09web,18,1000,265,735,2.61780104712042,6.28205128205128,0.126477713732408
2009,"ARSC, Univ of Alaska Fairbanks",arsc09web,19,1000,282,718,2.24719101123596,4.40490797546012,0.133080279192284
2009,"ARSC, Univ of Alaska Fairbanks",arsc09web,20,1000,11,989,25.6410256410256,35.3214285714286,0.753202937084147
2009,"ARSC, Univ of Alaska Fairbanks",arsc09web,21,1000,34,966,14.2857142857143,26.8333333333333,0.170464722605935
2009,"ARSC, Univ of Alaska Fairbanks",arsc09web,22,1000,146,854,3.73134328358209,7,0.276633405851052
2009,"ARSC, Univ of Alaska Fairbanks",arsc09web,23,1000,47,953,8.84955752212389,14.4393939393939,0.751530605676607
2009,"ARSC, Univ of Alaska Fairbanks",arsc09web,24,1000,35,965,14.0845070422535,26.8055555555556,0.366677659432853
2009,"ARSC, Univ of Alaska Fairbanks",arsc09web,25,1000,13,987,19.6078431372549,25.9736842105263,0.567849700927765
2009,"ARSC, Univ of Alaska Fairbanks",arsc09web,26,1000,442,558,1.68918918918919,3.72,0.164840562681623
2009,"ARSC, Univ of Alaska Fairbanks",arsc09web,27,1000,19,981,37.037037037037,122.625,0.254561378394174
2009,"ARSC, Univ of Alaska Fairbanks",arsc09web,28,848,16,832,18.8444444444444,28.6896551724138,0.564251563783746
2009,"ARSC, Univ of Alaska Fairbanks",arsc09web,29,1000,142,858,4.0983606557377,8.41176470588235,0.450370393647701
2009,"ARSC, Univ of Alaska Fairbanks",arsc09web,30,1000,204,796,3.04878048780488,6.41935483870968,0.199430621779565
2009,"ARSC, Univ of Alaska Fairbanks",arsc09web,31,941,45,896,7.90756302521008,12.1081081081081,0.421568993522113
2009,"ARSC, Univ of Alaska Fairbanks",arsc09web,32,1000,412,588,1.99203187250996,6.53333333333333,0.307077771397267
2009,"ARSC, Univ of Alaska Fairbanks",arsc09web,33,1000,65,935,6.94444444444445,11.8354430379747,0.16761772660706
2009,"ARSC, Univ of Alaska Fairbanks",arsc09web,34,1000,289,711,2.6525198938992,8.07954545454546,0.14326938913249
2009,"ARSC, Univ of Alaska Fairbanks",arsc09web,35,518,11,507,11.0212765957447,14.0833333333333,0.690979174868282
2009,"ARSC, Univ of Alaska Fairbanks",arsc09web,36,1000,57,943,9.34579439252336,18.86,0.145977586914822
2009,"ARSC, Univ of Alaska Fairbanks",arsc09web,37,1000,56,944,7.57575757575758,12.4210526315789,0.40898728700151
2009,"ARSC, Univ of Alaska Fairbanks",arsc09web,38,1000,591,409,1.32275132275132,2.47878787878788,0.119977799785492
2009,"ARSC, Univ of Alaska Fairbanks",arsc09web,39,1000,179,821,3.18471337579618,6.08148148148148,0.408419462958315
2009,"ARSC, Univ of Alaska Fairbanks",arsc09web,40,1,1,0,1,,0
2009,"ARSC, Univ of Alaska Fairbanks",arsc09web,41,1000,649,351,1.2970168612192,2.87704918032787,0.227756449528467
2009,"ARSC, Univ of Alaska Fairbanks",arsc09web,42,1000,802,198,1.12612612612613,2.30232558139535,0.0213212133880762
2009,"ARSC, Univ of Alaska Fairbanks",arsc09web,43,1000,586,414,1.37174211248285,2.8951048951049,0.183209177471018
2009,"ARSC, Univ of Alaska Fairbanks",arsc09web,44,1000,762,238,1.19189511323004,3.09090909090909,0.224257609185074
2009,"ARSC, Univ of Alaska Fairbanks",arsc09web,45,1000,179,821,3.2258064516129,6.26717557251908,0.0833425167989766
2009,"ARSC, Univ of Alaska Fairbanks",arsc09web,46,1000,190,810,3.02114803625378,5.74468085106383,0.0876796631477705
2009,"ARSC, Univ of Alaska Fairbanks",arsc09web,47,1000,31,969,10.4166666666667,14.9076923076923,0.370780492757486
2009,"ARSC, Univ of Alaska Fairbanks",arsc09web,48,1000,95,905,4.76190476190476,7.86956521739131,0.406049877006256
2009,"ARSC, Univ of Alaska Fairbanks",arsc09web,49,1000,75,925,5.91715976331361,9.84042553191489,0.465744539845574
2009,"ARSC, Univ of Alaska Fairbanks",arsc09web,50,990,157,833,3.21428571428571,5.51655629139073,0.108004681816776
2009,Mugla University,irra1a,1,1000,1000,0,1,,0
2009,Mugla University,irra1a,2,1000,1000,0,1,,0
2009,Mugla University,irra1a,3,1000,1000,0,1,,0
2009,Mugla University,irra1a,4,1000,1000,0,1,,0
2009,Mugla University,irra1a,5,1000,1000,0,1,,0
2009,Mugla University,irra1a,6,1000,1000,0,1,,0
2009,Mugla University,irra1a,7,1000,1000,0,1,,0
2009,Mugla University,irra1a,8,1000,1000,0,1,,0
2009,Mugla University,irra1a,9,1000,1000,0,1,,0
2009,Mugla University,irra1a,10,1000,1000,0,1,,0
2009,Mugla University,irra1a,11,1000,1000,0,1,,0
2009,Mugla University,irra1a,12,1000,1000,0,1,,0
2009,Mugla University,irra1a,13,1000,1000,0,1,,0
2009,Mugla University,irra1a,14,1000,1000,0,1,,0
2009,Mugla University,irra1a,15,1000,1000,0,1,,0
2009,Mugla University,irra1a,16,1000,1000,0,1,,0
2009,Mugla University,irra1a,17,1000,1000,0,1,,0
2009,Mugla University,irra1a,18,1000,1000,0,1,,0
2009,Mugla University,irra1a,19,1000,1000,0,1,,0
2009,Mugla University,irra1a,20,1000,1000,0,1,,0
2009,Mugla University,irra1a,21,1000,1000,0,1,,0
2009,Mugla University,irra1a,22,1000,1000,0,1,,0
2009,Mugla University,irra1a,23,1000,1000,0,1,,0
2009,Mugla University,irra1a,24,1000,1000,0,1,,0
2009,Mugla University,irra1a,25,1000,1000,0,1,,0
2009,Mugla University,irra1a,26,1000,1000,0,1,,0
2009,Mugla University,irra1a,27,1000,1000,0,1,,0
2009,Mugla University,irra1a,28,1000,1000,0,1,,0
2009,Mugla University,irra1a,29,1000,1000,0,1,,0
2009,Mugla University,irra1a,30,1000,1000,0,1,,0
2009,Mugla University,irra1a,31,1000,1000,0,1,,0
2009,Mugla University,irra1a,32,1000,1000,0,1,,0
2009,Mugla University,irra1a,33,1000,1000,0,1,,0
2009,Mugla University,irra1a,34,1000,1000,0,1,,0
2009,Mugla University,irra1a,35,1000,1000,0,1,,0
2009,Mugla University,irra1a,36,1000,1000,0,1,,0
2009,Mugla University,irra1a,37,1000,1000,0,1,,0
2009,Mugla University,irra1a,38,1000,1000,0,1,,0
2009,Mugla University,irra1a,39,1000,1000,0,1,,0
2009,Mugla University,irra1a,40,130,130,0,1,,0
2009,Mugla University,irra1a,41,1000,1000,0,1,,0
2009,Mugla University,irra1a,42,1000,1000,0,1,,0
2009,Mugla University,irra1a,43,1000,1000,0,1,,0
2009,Mugla University,irra1a,44,1000,1000,0,1,,0
2009,Mugla University,irra1a,45,1000,1000,0,1,,0
2009,Mugla University,irra1a,46,1000,1000,0,1,,0
2009,Mugla University,irra1a,47,1000,1000,0,1,,0
2009,Mugla University,irra1a,48,1000,1000,0,1,,0
2009,Mugla University,irra1a,49,1000,1000,0,1,,0
2009,Mugla University,irra1a,50,1000,1000,0,1,,0
2009,Mugla University,irra2a,1,1000,1000,0,1,,0
2009,Mugla University,irra2a,2,1000,1000,0,1,,0
2009,Mugla University,irra2a,3,1000,980,20,1.01010101010101,2,0
2009,Mugla University,irra2a,4,1000,992,8,1.00401606425703,2,0
2009,Mugla University,irra2a,5,1000,998,2,1.001001001001,2,0
2009,Mugla University,irra2a,6,1000,996,4,1.00200400801603,2,0
2009,Mugla University,irra2a,7,1000,998,2,1.001001001001,2,0
2009,Mugla University,irra2a,8,1000,994,6,1.00300902708124,2,0
2009,Mugla University,irra2a,9,1000,1000,0,1,,0
2009,Mugla University,irra2a,10,1000,1000,0,1,,0
2009,Mugla University,irra2a,11,1000,1000,0,1,,0
2009,Mugla University,irra2a,12,1000,994,6,1.00300902708124,2,0
2009,Mugla University,irra2a,13,1000,994,6,1.00300902708124,2,0
2009,Mugla University,irra2a,14,1000,992,8,1.00401606425703,2,0
2009,Mugla University,irra2a,15,1000,1000,0,1,,0
2009,Mugla University,irra2a,16,1000,1000,0,1,,0
2009,Mugla University,irra2a,17,1000,1000,0,1,,0
2009,Mugla University,irra2a,18,1000,1000,0,1,,0
2009,Mugla University,irra2a,19,1000,988,12,1.00603621730382,2,0
2009,Mugla University,irra2a,20,1000,988,12,1.00603621730382,2,0
2009,Mugla University,irra2a,21,1000,996,4,1.00200400801603,2,0
2009,Mugla University,irra2a,22,1000,998,2,1.001001001001,2,0
2009,Mugla University,irra2a,23,1000,996,4,1.00200400801603,2,0
2009,Mugla University,irra2a,24,1000,988,12,1.00603621730382,2,0
2009,Mugla University,irra2a,25,1000,992,8,1.00401606425703,2,0
2009,Mugla University,irra2a,26,1000,1000,0,1,,0
2009,Mugla University,irra2a,27,1000,990,10,1.00502512562814,2,0
2009,Mugla University,irra2a,28,1000,994,6,1.00300902708124,2,0
2009,Mugla University,irra2a,29,1000,1000,0,1,,0
2009,Mugla University,irra2a,30,1000,1000,0,1,,0
2009,Mugla University,irra2a,31,1000,992,8,1.00401606425703,2,0
2009,Mugla University,irra2a,32,1000,1000,0,1,,0
2009,Mugla University,irra2a,33,1000,1000,0,1,,0
2009,Mugla University,irra2a,34,1000,994,6,1.00300902708124,2,0
2009,Mugla University,irra2a,35,1000,990,10,1.00502512562814,2,0
2009,Mugla University,irra2a,36,1000,992,8,1.00401606425703,2,0
2009,Mugla University,irra2a,37,1000,998,2,1.001001001001,2,0
2009,Mugla University,irra2a,38,1000,1000,0,1,,0
2009,Mugla University,irra2a,39,1000,1000,0,1,,0
2009,Mugla University,irra2a,40,130,130,0,1,,0
2009,Mugla University,irra2a,41,1000,1000,0,1,,0
2009,Mugla University,irra2a,42,1000,994,6,1.00300902708124,2,0
2009,Mugla University,irra2a,43,1000,998,2,1.001001001001,2,0
2009,Mugla University,irra2a,44,1000,1000,0,1,,0
2009,Mugla University,irra2a,45,1000,998,2,1.001001001001,2,0
2009,Mugla University,irra2a,46,1000,1000,0,1,,0
2009,Mugla University,irra2a,47,1000,1000,0,1,,0
2009,Mugla University,irra2a,48,1000,1000,0,1,,0
2009,Mugla University,irra2a,49,1000,1000,0,1,,0
2009,Mugla University,irra2a,50,1000,1000,0,1,,0
2009,Mugla University,irra3a,1,1000,1000,0,1,,0
2009,Mugla University,irra3a,2,1000,1000,0,1,,0
2009,Mugla University,irra3a,3,1000,1000,0,1,,0
2009,Mugla University,irra3a,4,1000,1000,0,1,,0
2009,Mugla University,irra3a,5,1000,1000,0,1,,0
2009,Mugla University,irra3a,6,1000,1000,0,1,,0
2009,Mugla University,irra3a,7,1000,1000,0,1,,0
2009,Mugla University,irra3a,8,1000,1000,0,1,,0
2009,Mugla University,irra3a,9,1000,1000,0,1,,0
2009,Mugla University,irra3a,10,1000,1000,0,1,,0
2009,Mugla University,irra3a,11,1000,1000,0,1,,0
2009,Mugla University,irra3a,12,1000,1000,0,1,,0
2009,Mugla University,irra3a,13,1000,1000,0,1,,0
2009,Mugla University,irra3a,14,1000,1000,0,1,,0
2009,Mugla University,irra3a,15,1000,1000,0,1,,0
2009,Mugla University,irra3a,16,1000,1000,0,1,,0
2009,Mugla University,irra3a,17,1000,1000,0,1,,0
2009,Mugla University,irra3a,18,1000,1000,0,1,,0
2009,Mugla University,irra3a,19,1000,1000,0,1,,0
2009,Mugla University,irra3a,20,1000,1000,0,1,,0
2009,Mugla University,irra3a,21,1000,1000,0,1,,0
2009,Mugla University,irra3a,22,1000,1000,0,1,,0
2009,Mugla University,irra3a,23,1000,1000,0,1,,0
2009,Mugla University,irra3a,24,1000,1000,0,1,,0
2009,Mugla University,irra3a,25,1000,1000,0,1,,0
2009,Mugla University,irra3a,26,1000,1000,0,1,,0
2009,Mugla University,irra3a,27,1000,1000,0,1,,0
2009,Mugla University,irra3a,28,1000,1000,0,1,,0
2009,Mugla University,irra3a,29,1000,1000,0,1,,0
2009,Mugla University,irra3a,30,1000,1000,0,1,,0
2009,Mugla University,irra3a,31,1000,1000,0,1,,0
2009,Mugla University,irra3a,32,1000,1000,0,1,,0
2009,Mugla University,irra3a,33,1000,1000,0,1,,0
2009,Mugla University,irra3a,34,1000,1000,0,1,,0
2009,Mugla University,irra3a,35,1000,1000,0,1,,0
2009,Mugla University,irra3a,36,1000,1000,0,1,,0
2009,Mugla University,irra3a,37,1000,1000,0,1,,0
2009,Mugla University,irra3a,38,1000,1000,0,1,,0
2009,Mugla University,irra3a,39,1000,1000,0,1,,0
2009,Mugla University,irra3a,40,130,130,0,1,,0
2009,Mugla University,irra3a,41,1000,1000,0,1,,0
2009,Mugla University,irra3a,42,1000,1000,0,1,,0
2009,Mugla University,irra3a,43,1000,1000,0,1,,0
2009,Mugla University,irra3a,44,1000,1000,0,1,,0
2009,Mugla University,irra3a,45,1000,1000,0,1,,0
2009,Mugla University,irra3a,46,1000,1000,0,1,,0
2009,Mugla University,irra3a,47,1000,1000,0,1,,0
2009,Mugla University,irra3a,48,1000,1000,0,1,,0
2009,Mugla University,irra3a,49,1000,1000,0,1,,0
2009,Mugla University,irra3a,50,1000,1000,0,1,,0
2009,The University of Melbourne,muadanchor,1,1000,7,993,25.6410256410256,31.03125,0.693346197640939
2009,The University of Melbourne,muadanchor,2,1000,7,993,27.027027027027,33.1,0.65253511849684
2009,The University of Melbourne,muadanchor,3,1000,4,996,71.4285714285714,99.6,0.8612579511
2009,The University of Melbourne,muadanchor,4,1000,0,1000,250,250,1
2009,The University of Melbourne,muadanchor,5,1000,8,992,58.8235294117647,110.222222222222,0.77405462962357
2009,The University of Melbourne,muadanchor,6,1000,0,1000,166.666666666667,166.666666666667,1
2009,The University of Melbourne,muadanchor,7,1000,11,989,22.2222222222222,29.0882352941177,0.459246476543929
2009,The University of Melbourne,muadanchor,8,1000,0,1000,200,200,1
2009,The University of Melbourne,muadanchor,9,1000,4,996,27.7777777777778,31.125,0.859229902952872
2009,The University of Melbourne,muadanchor,10,1000,4,996,29.4117647058824,33.2,0.839705033556927
2009,The University of Melbourne,muadanchor,11,1000,10,990,24.390243902439,31.9354838709677,0.713472970211597
2009,The University of Melbourne,muadanchor,12,1000,0,1000,333.333333333333,333.333333333333,1
2009,The University of Melbourne,muadanchor,13,1000,0,1000,500,500,1
2009,The University of Melbourne,muadanchor,14,1000,0,1000,333.333333333333,333.333333333333,1
2009,The University of Melbourne,muadanchor,15,1000,6,994,23.2558139534884,26.8648648648649,0.874233575838919
2009,The University of Melbourne,muadanchor,16,1000,11,989,18.1818181818182,22.4772727272727,0.649140563847059
2009,The University of Melbourne,muadanchor,17,1000,4,996,25.6410256410256,28.4571428571429,0.729
2009,The University of Melbourne,muadanchor,18,1000,12,988,23.2558139534884,31.8709677419355,0.558824539514859
2009,The University of Melbourne,muadanchor,19,1000,0,1000,1000,1000,1
2009,The University of Melbourne,muadanchor,20,1000,0,1000,166.666666666667,166.666666666667,1
2009,The University of Melbourne,muadanchor,21,1000,0,1000,166.666666666667,166.666666666667,1
2009,The University of Melbourne,muadanchor,22,1000,14,986,25.6410256410256,39.44,0.995899969081208
2009,The University of Melbourne,muadanchor,23,1000,0,1000,500,500,1
2009,The University of Melbourne,muadanchor,24,1000,0,1000,333.333333333333,333.333333333333,1
2009,The University of Melbourne,muadanchor,25,963,0,963,120.375,120.375,1
2009,The University of Melbourne,muadanchor,26,1000,6,994,26.3157894736842,31.0625,0.759782224460483
2009,The University of Melbourne,muadanchor,27,1000,0,1000,166.666666666667,166.666666666667,1
2009,The University of Melbourne,muadanchor,28,1000,0,1000,166.666666666667,166.666666666667,1
2009,The University of Melbourne,muadanchor,29,1000,5,995,22.2222222222222,24.875,0.677645150391
2009,The University of Melbourne,muadanchor,30,1000,6,994,37.037037037037,47.3333333333333,0.777330939384176
2009,The University of Melbourne,muadanchor,31,1000,0,1000,166.666666666667,166.666666666667,1
2009,The University of Melbourne,muadanchor,32,1000,3,997,24.390243902439,26.2368421052632,0.852170184892393
2009,The University of Melbourne,muadanchor,33,1000,5,995,28.5714285714286,33.1666666666667,0.890924092278484
2009,The University of Melbourne,muadanchor,34,1000,2,998,71.4285714285714,83.1666666666667,0.9
2009,The University of Melbourne,muadanchor,35,759,0,759,108.428571428571,108.428571428571,1
2009,The University of Melbourne,muadanchor,36,1000,0,1000,500,500,1
2009,The University of Melbourne,muadanchor,37,1000,1,999,66.6666666666667,71.3571428571429,0.995289871302754
2009,The University of Melbourne,muadanchor,38,1000,7,993,35.7142857142857,47.2857142857143,0.755095128898889
2009,The University of Melbourne,muadanchor,39,1000,8,992,25,31,0.826227203523713
2009,The University of Melbourne,muadanchor,40,9,2,7,2.25,3.5,0.748767307367549
2009,The University of Melbourne,muadanchor,41,1000,9,991,23.2558139534884,29.1470588235294,0.546184454729823
2009,The University of Melbourne,muadanchor,42,1000,12,988,22.2222222222222,29.9393939393939,0.316991794870634
2009,The University of Melbourne,muadanchor,43,1000,3,997,32.258064516129,35.6071428571429,0.974534737987252
2009,The University of Melbourne,muadanchor,44,1000,8,992,19.6078431372549,23.0697674418605,0.777540910590833
2009,The University of Melbourne,muadanchor,45,1000,5,995,29.4117647058824,34.3103448275862,0.999882079193384
2009,The University of Melbourne,muadanchor,46,1000,9,991,50,90.0909090909091,0.590483829634808
2009,The University of Melbourne,muadanchor,47,1000,8,992,34.4827586206897,47.2380952380952,0.855803583675018
2009,The University of Melbourne,muadanchor,48,1000,10,990,58.8235294117647,141.428571428571,0.471772900741444
2009,The University of Melbourne,muadanchor,49,1000,0,1000,111.111111111111,111.111111111111,1
2009,The University of Melbourne,muadanchor,50,1000,9,991,55.5555555555556,110.111111111111,0.687718438726668
2009,The University of Melbourne,muadibm5,1,1000,61,939,5.4945054945055,7.7603305785124,0.522654067274817
2009,The University of Melbourne,muadibm5,2,1000,248,752,2.44498777506113,4.67080745341615,0.584953317982923
2009,The University of Melbourne,muadibm5,3,1000,0,1000,500,500,1
2009,The University of Melbourne,muadibm5,4,1000,0,1000,1000,1000,1
2009,The University of Melbourne,muadibm5,5,1000,2,998,40,43.3913043478261,0.9
2009,The University of Melbourne,muadibm5,6,1000,0,1000,1000,1000,1
2009,The University of Melbourne,muadibm5,7,1000,10,990,19.2307692307692,23.5714285714286,0.896563982341797
2009,The University of Melbourne,muadibm5,8,1000,0,1000,1000,1000,1
2009,The University of Melbourne,muadibm5,9,1000,0,1000,333.333333333333,333.333333333333,1
2009,The University of Melbourne,muadibm5,10,1000,0,1000,125,125,1
2009,The University of Melbourne,muadibm5,11,1000,29,971,10.8695652173913,15.4126984126984,0.823840493639646
2009,The University of Melbourne,muadibm5,12,1000,0,1000,1000,1000,1
2009,The University of Melbourne,muadibm5,13,1000,0,1000,1000,1000,1
2009,The University of Melbourne,muadibm5,14,1000,0,1000,1000,1000,1
2009,The University of Melbourne,muadibm5,15,1000,0,1000,500,500,1
2009,The University of Melbourne,muadibm5,16,1000,17,983,11.7647058823529,14.4558823529412,0.655672898942151
2009,The University of Melbourne,muadibm5,17,1000,0,1000,250,250,1
2009,The University of Melbourne,muadibm5,18,1000,49,951,7.14285714285714,10.4505494505495,0.733590381268268
2009,The University of Melbourne,muadibm5,19,1000,1,999,500,999,1
2009,The University of Melbourne,muadibm5,20,1000,0,1000,1000,1000,1
2009,The University of Melbourne,muadibm5,21,1000,0,1000,1000,1000,1
2009,The University of Melbourne,muadibm5,22,1000,0,1000,250,250,1
2009,The University of Melbourne,muadibm5,23,1000,0,1000,1000,1000,1
2009,The University of Melbourne,muadibm5,24,1000,0,1000,1000,1000,1
2009,The University of Melbourne,muadibm5,25,1000,0,1000,1000,1000,1
2009,The University of Melbourne,muadibm5,26,1000,8,992,21.2765957446809,25.4358974358974,0.793322373296411
2009,The University of Melbourne,muadibm5,27,1000,0,1000,1000,1000,1
2009,The University of Melbourne,muadibm5,28,1000,0,1000,1000,1000,1
2009,The University of Melbourne,muadibm5,29,1000,0,1000,50,50,1
2009,The University of Melbourne,muadibm5,30,1000,0,1000,250,250,1
2009,The University of Melbourne,muadibm5,31,1000,0,1000,1000,1000,1
2009,The University of Melbourne,muadibm5,32,1000,3,997,38.4615384615385,43.3478260869565,0.966976620064174
2009,The University of Melbourne,muadibm5,33,1000,0,1000,166.666666666667,166.666666666667,1
2009,The University of Melbourne,muadibm5,34,1000,0,1000,333.333333333333,333.333333333333,1
2009,The University of Melbourne,muadibm5,35,1000,0,1000,1000,1000,1
2009,The University of Melbourne,muadibm5,36,1000,0,1000,1000,1000,1
2009,The University of Melbourne,muadibm5,37,1000,0,1000,76.9230769230769,76.9230769230769,1
2009,The University of Melbourne,muadibm5,38,1000,3,997,90.9090909090909,124.625,0.977089908581386
2009,The University of Melbourne,muadibm5,39,1000,0,1000,333.333333333333,333.333333333333,1
2009,The University of Melbourne,muadibm5,40,1000,0,1000,142.857142857143,142.857142857143,1
2009,The University of Melbourne,muadibm5,41,1000,229,771,2.37529691211401,4.015625,0.629611155290833
2009,The University of Melbourne,muadibm5,42,1000,0,1000,111.111111111111,111.111111111111,1
2009,The University of Melbourne,muadibm5,43,1000,0,1000,125,125,1
2009,The University of Melbourne,muadibm5,44,1000,7,993,40,55.1666666666667,0.899484613497818
2009,The University of Melbourne,muadibm5,45,1000,0,1000,250,250,1
2009,The University of Melbourne,muadibm5,46,1000,40,960,8.40336134453782,12.1518987341772,0.721164371674768
2009,The University of Melbourne,muadibm5,47,1000,0,1000,111.111111111111,111.111111111111,1
2009,The University of Melbourne,muadibm5,48,1000,0,1000,83.3333333333333,83.3333333333333,1
2009,The University of Melbourne,muadibm5,49,1000,0,1000,125,125,1
2009,The University of Melbourne,muadibm5,50,1000,0,1000,250,250,1
2009,The University of Melbourne,muadimp,1,1000,3,997,31.25,34.3793103448276,0.814942334540943
2009,The University of Melbourne,muadimp,2,1000,6,994,15.3846153846154,16.8474576271186,0.860151096509172
2009,The University of Melbourne,muadimp,3,1000,0,1000,500,500,1
2009,The University of Melbourne,muadimp,4,1000,0,1000,1000,1000,1
2009,The University of Melbourne,muadimp,5,1000,1,999,62.5,66.6,0.9
2009,The University of Melbourne,muadimp,6,1000,0,1000,1000,1000,1
2009,The University of Melbourne,muadimp,7,1000,1,999,66.6666666666667,71.3571428571429,0.9
2009,The University of Melbourne,muadimp,8,1000,0,1000,1000,1000,1
2009,The University of Melbourne,muadimp,9,1000,0,1000,333.333333333333,333.333333333333,1
2009,The University of Melbourne,muadimp,10,1000,0,1000,166.666666666667,166.666666666667,1
2009,The University of Melbourne,muadimp,11,1000,5,995,35.7142857142857,43.2608695652174,0.82456530672686
2009,The University of Melbourne,muadimp,12,1000,0,1000,1000,1000,1
2009,The University of Melbourne,muadimp,13,1000,0,1000,1000,1000,1
2009,The University of Melbourne,muadimp,14,1000,0,1000,1000,1000,1
2009,The University of Melbourne,muadimp,15,1000,0,1000,500,500,1
2009,The University of Melbourne,muadimp,16,1000,2,998,41.6666666666667,45.3636363636364,0.899999809316252
2009,The University of Melbourne,muadimp,17,1000,0,1000,333.333333333333,333.333333333333,1
2009,The University of Melbourne,muadimp,18,1000,5,995,22.2222222222222,24.875,0.769463368424874
2009,The University of Melbourne,muadimp,19,1000,0,1000,1000,1000,1
2009,The University of Melbourne,muadimp,20,1000,0,1000,1000,1000,1
2009,The University of Melbourne,muadimp,21,1000,0,1000,1000,1000,1
2009,The University of Melbourne,muadimp,22,1000,0,1000,250,250,1
2009,The University of Melbourne,muadimp,23,1000,0,1000,1000,1000,1
2009,The University of Melbourne,muadimp,24,1000,0,1000,1000,1000,1
2009,The University of Melbourne,muadimp,25,1000,0,1000,1000,1000,1
2009,The University of Melbourne,muadimp,26,1000,3,997,38.4615384615385,43.3478260869565,0.793322818300334
2009,The University of Melbourne,muadimp,27,1000,0,1000,1000,1000,1
2009,The University of Melbourne,muadimp,28,1000,0,1000,1000,1000,1
2009,The University of Melbourne,muadimp,29,1000,0,1000,111.111111111111,111.111111111111,1
2009,The University of Melbourne,muadimp,30,1000,0,1000,333.333333333333,333.333333333333,1
2009,The University of Melbourne,muadimp,31,1000,0,1000,1000,1000,1
2009,The University of Melbourne,muadimp,32,1000,2,998,83.3333333333333,99.8,0.998357679673174
2009,The University of Melbourne,muadimp,33,1000,0,1000,200,200,1
2009,The University of Melbourne,muadimp,34,1000,0,1000,333.333333333333,333.333333333333,1
2009,The University of Melbourne,muadimp,35,1000,0,1000,1000,1000,1
2009,The University of Melbourne,muadimp,36,1000,0,1000,1000,1000,1
2009,The University of Melbourne,muadimp,37,1000,0,1000,111.111111111111,111.111111111111,1
2009,The University of Melbourne,muadimp,38,1000,2,998,125,166.333333333333,0.977089908581386
2009,The University of Melbourne,muadimp,39,1000,0,1000,333.333333333333,333.333333333333,1
2009,The University of Melbourne,muadimp,40,1000,0,1000,142.857142857143,142.857142857143,1
2009,The University of Melbourne,muadimp,41,1000,8,992,20.4081632653061,24.1951219512195,0.753297518749943
2009,The University of Melbourne,muadimp,42,1000,0,1000,142.857142857143,142.857142857143,1
2009,The University of Melbourne,muadimp,43,1000,0,1000,166.666666666667,166.666666666667,1
2009,The University of Melbourne,muadimp,44,1000,3,997,76.9230769230769,99.7,0.899484622479268
2009,The University of Melbourne,muadimp,45,1000,0,1000,333.333333333333,333.333333333333,1
2009,The University of Melbourne,muadimp,46,1000,2,998,28.5714285714286,30.2424242424242,0.875341
2009,The University of Melbourne,muadimp,47,1000,0,1000,125,125,1
2009,The University of Melbourne,muadimp,48,1000,0,1000,111.111111111111,111.111111111111,1
2009,The University of Melbourne,muadimp,49,1000,0,1000,125,125,1
2009,The University of Melbourne,muadimp,50,1000,0,1000,250,250,1
2009,Peking University,pkuLink,1,1000,905,95,1.06723585912487,2.96875,4.53386016756913e-13
2009,Peking University,pkuLink,2,1000,958,42,1.02459016393443,2.33333333333333,0.00250642388422385
2009,Peking University,pkuLink,3,1000,816,184,1.10619469026549,2.09090909090909,4.50113829550404e-05
2009,Peking University,pkuLink,4,1000,736,264,1.20048019207683,2.72164948453608,0.00209811894417678
2009,Peking University,pkuLink,5,1000,890,110,1.05932203389831,2.03703703703704,1.47712052453639e-05
2009,Peking University,pkuLink,6,1000,912,88,1.04931794333683,2.14634146341463,0.0416613378393906
2009,Peking University,pkuLink,7,1000,853,147,1.08342361863489,2.1,0.0110530527751657
2009,Peking University,pkuLink,8,1000,562,438,1.31752305665349,2.22335025380711,0.00095777261504888
2009,Peking University,pkuLink,9,1000,679,321,1.21359223300971,2.21379310344828,0.00123875371562187
2009,Peking University,pkuLink,10,1000,890,110,1.05932203389831,2.03703703703704,0.0211199790642858
2009,Peking University,pkuLink,11,1000,849,151,1.11111111111111,2.96078431372549,0.00172398263973683
2009,Peking University,pkuLink,12,1000,766,234,1.14155251141553,2.12727272727273,0.000528162647678874
2009,Peking University,pkuLink,13,1000,857,143,1.07991360691145,2.07246376811594,0.0664441964099532
2009,Peking University,pkuLink,14,1000,818,182,1.10253583241455,2.04494382022472,0.0102973386911036
2009,Peking University,pkuLink,15,1000,917,83,1.05042016806723,2.37142857142857,1.82148960124519e-06
2009,Peking University,pkuLink,16,1000,942,58,1.03199174406605,2.14814814814815,0.000654532406181142
2009,Peking University,pkuLink,17,1000,837,163,1.09051254089422,2.0375,0.00116235450404628
2009,Peking University,pkuLink,18,1000,945,55,1.03092783505155,2.2,1.46872293850526e-08
2009,Peking University,pkuLink,19,1000,799,201,1.15740740740741,3.09230769230769,0.0704292564761029
2009,Peking University,pkuLink,20,1000,694,306,1.20048019207683,2.20143884892086,0.0736134893057617
2009,Peking University,pkuLink,21,1000,737,263,1.16279069767442,2.13821138211382,0.0174272403617317
2009,Peking University,pkuLink,22,1000,918,82,1.04384133611691,2.05,7.5750627846529e-07
2009,Peking University,pkuLink,23,1000,462,538,1.48148148148148,2.52582159624413,0.00611005968420777
2009,Peking University,pkuLink,24,1000,628,372,1.26103404791929,2.25454545454545,0.0207935325680871
2009,Peking University,pkuLink,25,1000,859,141,1.09051254089422,2.43103448275862,1.96442855788924e-08
2009,Peking University,pkuLink,26,1000,900,100,1.05708245243129,2.17391304347826,4.2761226824018e-11
2009,Peking University,pkuLink,27,1000,811,189,1.10987791342952,2.1,2.47239290449755e-05
2009,Peking University,pkuLink,28,1000,861,139,1.07758620689655,2.07462686567164,0.012284361190804
2009,Peking University,pkuLink,29,1000,750,250,1.14810562571757,2.06611570247934,0.0184279246831138
2009,Peking University,pkuLink,30,1000,874,126,1.06951871657754,2.0655737704918,1.57138031246819e-05
2009,Peking University,pkuLink,31,1000,827,173,1.11234705228031,2.40277777777778,0.0317135939312224
2009,Peking University,pkuLink,32,1000,799,201,1.11856823266219,2.11578947368421,3.68220651893526e-08
2009,Peking University,pkuLink,33,1000,918,82,1.04384133611691,2.05,5.54992278912024e-06
2009,Peking University,pkuLink,34,1000,615,385,1.27226463104326,2.25146198830409,0.00681024077470592
2009,Peking University,pkuLink,35,1000,904,96,1.05485232067511,2.18181818181818,0.00589366437745459
2009,Peking University,pkuLink,36,1000,628,372,1.25944584382872,2.24096385542169,0.0367842371117284
2009,Peking University,pkuLink,37,1000,945,55,1.02880658436214,2.03703703703704,0.0285182033175138
2009,Peking University,pkuLink,38,1000,886,114,1.06609808102345,2.19230769230769,0.00079317634831372
2009,Peking University,pkuLink,39,1000,904,96,1.05263157894737,2.08695652173913,9.03177806254838e-08
2009,Peking University,pkuLink,40,1000,878,122,1.09289617486339,3.2972972972973,0.00150701954435703
2009,Peking University,pkuLink,41,1000,964,36,1.0183299389002,2,3.56781633723619e-08
2009,Peking University,pkuLink,42,1000,852,148,1.09769484083425,2.50847457627119,2.59332672028982e-07
2009,Peking University,pkuLink,43,1000,889,111,1.06609808102345,2.26530612244898,7.35283624723187e-09
2009,Peking University,pkuLink,44,1000,800,200,1.16144018583043,3.27868852459016,0.00264997785781815
2009,Peking University,pkuLink,45,1000,855,145,1.07874865156419,2.01388888888889,0.161199136801747
2009,Peking University,pkuLink,46,1000,973,27,1.0183299389002,3,0.000224013509776219
2009,Peking University,pkuLink,47,1000,926,74,1.04384133611691,2.3125,3.36232333629937e-05
2009,Peking University,pkuLink,48,1000,933,67,1.03626943005181,2.09375,9.10435847524191e-11
2009,Peking University,pkuLink,49,1000,880,120,1.06837606837607,2.14285714285714,2.46317371862651e-05
2009,Peking University,pkuLink,50,1000,935,65,1.0351966873706,2.09677419354839,0.015155624771324
2009,Peking University,pkuSewmTp,1,1000,912,88,1.04602510460251,2,0.00060555679330833
2009,Peking University,pkuSewmTp,2,1000,947,53,1.03199174406605,2.40909090909091,0.000621008154329757
2009,Peking University,pkuSewmTp,3,1000,604,396,1.29533678756477,2.35714285714286,0.346848557282061
2009,Peking University,pkuSewmTp,4,1000,424,576,1.57728706624606,2.74285714285714,0.447148747597319
2009,Peking University,pkuSewmTp,5,1000,868,132,1.07296137339056,2.0625,2.24526424730905e-05
2009,Peking University,pkuSewmTp,6,1000,878,122,1.07066381156317,2.17857142857143,0.00143042902669326
2009,Peking University,pkuSewmTp,7,1000,729,271,1.17785630153121,2.25833333333333,0.00376448094748247
2009,Peking University,pkuSewmTp,8,1000,266,734,1.91204588910134,2.85603112840467,0.473659224116011
2009,Peking University,pkuSewmTp,9,1000,290,710,1.88323917137476,2.94605809128631,0.125343433840084
2009,Peking University,pkuSewmTp,10,1000,698,302,1.20481927710843,2.28787878787879,0.0494582548787302
2009,Peking University,pkuSewmTp,11,1000,879,121,1.07991360691145,2.57446808510638,0.0043253408635799
2009,Peking University,pkuSewmTp,12,1000,165,835,2.82485875706215,4.41798941798942,0.429398932247748
2009,Peking University,pkuSewmTp,13,1000,236,764,2.16450216450216,3.38053097345133,0.43374858072686
2009,Peking University,pkuSewmTp,14,1000,471,529,1.45560407569141,2.44907407407407,0.223417848267324
2009,Peking University,pkuSewmTp,15,1000,827,173,1.10497237569061,2.21794871794872,0.0337205439519784
2009,Peking University,pkuSewmTp,16,1000,894,106,1.05820105820106,2.07843137254902,0.000220487484866532
2009,Peking University,pkuSewmTp,17,1000,725,275,1.17370892018779,2.16535433070866,0.0303773394476267
2009,Peking University,pkuSewmTp,18,1000,913,87,1.05042016806723,2.23076923076923,0.00428146758106521
2009,Peking University,pkuSewmTp,19,1000,644,356,1.25470514429109,2.32679738562092,0.100925218336723
2009,Peking University,pkuSewmTp,20,1000,856,144,1.08342361863489,2.14925373134328,1.73148617297722e-07
2009,Peking University,pkuSewmTp,21,1000,323,677,1.75131348511384,2.72983870967742,0.0178896598932889
2009,Peking University,pkuSewmTp,22,1000,871,129,1.07066381156317,2.04761904761905,2.20764609082198e-05
2009,Peking University,pkuSewmTp,23,1000,665,335,1.23762376237624,2.34265734265734,0.0908929002539575
2009,Peking University,pkuSewmTp,24,1000,778,222,1.16279069767442,2.70731707317073,4.19387170994764e-07
2009,Peking University,pkuSewmTp,25,1000,778,222,1.14025085518814,2.24242424242424,0.214260802532661
2009,Peking University,pkuSewmTp,26,1000,881,119,1.06723585912487,2.125,1.72160371951981e-08
2009,Peking University,pkuSewmTp,27,1000,561,439,1.33155792276964,2.31052631578947,0.253727151145841
2009,Peking University,pkuSewmTp,28,1000,544,456,1.36798905608755,2.43850267379679,0.12871777890299
2009,Peking University,pkuSewmTp,29,1000,553,447,1.34770889487871,2.36507936507937,0.0465847695943392
2009,Peking University,pkuSewmTp,30,1000,731,269,1.16414435389988,2.1015625,0.0696338540376414
2009,Peking University,pkuSewmTp,31,1000,561,439,1.32275132275132,2.25128205128205,0.280474814259496
2009,Peking University,pkuSewmTp,32,1000,589,411,1.30718954248366,2.33522727272727,0.594742706380058
2009,Peking University,pkuSewmTp,33,1000,840,160,1.09289617486339,2.13333333333333,2.01882914815492e-05
2009,Peking University,pkuSewmTp,34,1000,262,738,1.85528756957328,2.66425992779783,0.46628493536883
2009,Peking University,pkuSewmTp,35,1000,710,290,1.18906064209275,2.21374045801527,0.171258284961674
2009,Peking University,pkuSewmTp,36,1000,744,256,1.16279069767442,2.20689655172414,0.00528701566549626
2009,Peking University,pkuSewmTp,37,1000,865,135,1.0752688172043,2.07692307692308,0.0110488535712774
2009,Peking University,pkuSewmTp,38,1000,599,401,1.29533678756477,2.31791907514451,0.000423292696899514
2009,Peking University,pkuSewmTp,39,1000,787,213,1.12359550561798,2.06796116504854,0.0081249990359678
2009,Peking University,pkuSewmTp,40,1000,777,223,1.16009280742459,2.62352941176471,0.00130822144033597
2009,Peking University,pkuSewmTp,41,1000,878,122,1.07874865156419,2.48979591836735,0.00475599936432093
2009,Peking University,pkuSewmTp,42,1000,228,772,2.24719101123596,3.55760368663595,0.31332526689621
2009,Peking University,pkuSewmTp,43,1000,832,168,1.10497237569061,2.3013698630137,0.124681591928216
2009,Peking University,pkuSewmTp,44,1000,795,205,1.14285714285714,2.5625,0.0536656161406138
2009,Peking University,pkuSewmTp,45,1000,641,359,1.24843945068664,2.24375,0.061436493228942
2009,Peking University,pkuSewmTp,46,1000,935,65,1.03842159916926,2.32142857142857,0.00290182341871853
2009,Peking University,pkuSewmTp,47,1000,887,113,1.06496272630458,2.17307692307692,0.117391364460158
2009,Peking University,pkuSewmTp,48,1000,880,120,1.06951871657754,2.18181818181818,0.000206741714128087
2009,Peking University,pkuSewmTp,49,1000,848,152,1.08932461873638,2.17142857142857,0.0516179991888922
2009,Peking University,pkuSewmTp,50,1000,871,129,1.07874865156419,2.30357142857143,0.0316069299504297
2009,Peking University,pkuStruct,1,1000,926,74,1.03950103950104,2.05555555555556,0.000341496232913407
2009,Peking University,pkuStruct,2,1000,945,55,1.03305785123967,2.39130434782609,0.000635698627841769
2009,Peking University,pkuStruct,3,1000,564,436,1.33689839572193,2.3695652173913,0.343047454786288
2009,Peking University,pkuStruct,4,1000,453,547,1.51975683890578,2.66829268292683,0.490895994523018
2009,Peking University,pkuStruct,5,1000,852,148,1.08108108108108,2.02739726027397,1.30302624260061e-05
2009,Peking University,pkuStruct,6,1000,877,123,1.07066381156317,2.15789473684211,0.00134408854609249
2009,Peking University,pkuStruct,7,1000,737,263,1.16144018583043,2.12096774193548,0.0123078570445366
2009,Peking University,pkuStruct,8,1000,306,694,1.82149362477231,2.8559670781893,0.521083422183105
2009,Peking University,pkuStruct,9,1000,231,769,2.12765957446809,3.21757322175732,0.128516618334914
2009,Peking University,pkuStruct,10,1000,711,289,1.18623962040332,2.18939393939394,0.0502297669953401
2009,Peking University,pkuStruct,11,1000,883,117,1.07758620689655,2.6,0.00356080372518459
2009,Peking University,pkuStruct,12,1000,180,820,2.68096514745308,4.24870466321244,0.365886371365469
2009,Peking University,pkuStruct,13,1000,240,760,2.14132762312634,3.34801762114537,0.286276934805903
2009,Peking University,pkuStruct,14,1000,492,508,1.42045454545455,2.39622641509434,0.328658670305244
2009,Peking University,pkuStruct,15,1000,839,161,1.09649122807018,2.20547945205479,0.0338720648308878
2009,Peking University,pkuStruct,16,1000,884,116,1.06382978723404,2.07142857142857,0.000396069358248782
2009,Peking University,pkuStruct,17,1000,728,272,1.16550116550117,2.09230769230769,0.0293171898294586
2009,Peking University,pkuStruct,18,1000,909,91,1.0515247108307,2.16666666666667,0.00385321747897186
2009,Peking University,pkuStruct,19,1000,626,374,1.27388535031847,2.35220125786164,0.0270557488797582
2009,Peking University,pkuStruct,20,1000,854,146,1.085776330076,2.17910447761194,0.00534821815005829
2009,Peking University,pkuStruct,21,1000,336,664,1.69491525423729,2.61417322834646,0.206471715962909
2009,Peking University,pkuStruct,22,1000,886,114,1.06269925611052,2.07272727272727,0.00280898148852519
2009,Peking University,pkuStruct,23,1000,712,288,1.20336943441637,2.42016806722689,0.0072650151561739
2009,Peking University,pkuStruct,24,1000,797,203,1.14942528735632,2.78082191780822,2.94197569386402e-07
2009,Peking University,pkuStruct,25,1000,789,211,1.13122171945701,2.22105263157895,0.21120438740411
2009,Peking University,pkuStruct,26,1000,879,121,1.06609808102345,2.05084745762712,0.000642476825770708
2009,Peking University,pkuStruct,27,1000,601,399,1.2970168612192,2.34705882352941,0.269034555981
2009,Peking University,pkuStruct,28,1000,574,426,1.32802124833997,2.37988826815642,0.224977646062535
2009,Peking University,pkuStruct,29,1000,589,411,1.29366106080207,2.23369565217391,0.0447611749348341
2009,Peking University,pkuStruct,30,1000,762,238,1.14285714285714,2.10619469026549,0.0596875084637662
2009,Peking University,pkuStruct,31,1000,581,419,1.30378096479791,2.25268817204301,0.276119755777811
2009,Peking University,pkuStruct,32,1000,608,392,1.29198966408269,2.36144578313253,0.601228582086662
2009,Peking University,pkuStruct,33,1000,837,163,1.09409190371991,2.11688311688312,0.0231801233446694
2009,Peking University,pkuStruct,34,1000,277,723,1.8018018018018,2.60071942446043,0.55342912543185
2009,Peking University,pkuStruct,35,1000,739,261,1.17096018735363,2.2695652173913,0.171211320566068
2009,Peking University,pkuStruct,36,1000,203,797,2.15982721382289,3.06538461538462,0.408194991533511
2009,Peking University,pkuStruct,37,1000,885,115,1.06269925611052,2.05357142857143,6.86986080742209e-08
2009,Peking University,pkuStruct,38,1000,583,417,1.31752305665349,2.36931818181818,0.000470452746165264
2009,Peking University,pkuStruct,39,1000,792,208,1.12359550561798,2.12244897959184,6.54540759949151e-08
2009,Peking University,pkuStruct,40,1000,779,221,1.15874855156431,2.63095238095238,0.00117739929630236
2009,Peking University,pkuStruct,41,1000,868,132,1.08342361863489,2.4,0.00483157361234311
2009,Peking University,pkuStruct,42,1000,182,818,2.5974025974026,4.02955665024631,0.317825807094426
2009,Peking University,pkuStruct,43,1000,852,148,1.09170305676856,2.3125,0.127250298979017
2009,Peking University,pkuStruct,44,1000,759,241,1.16959064327485,2.51041666666667,0.100245505414013
2009,Peking University,pkuStruct,45,1000,649,351,1.22850122850123,2.12727272727273,0.00211409237108765
2009,Peking University,pkuStruct,46,1000,930,70,1.04166666666667,2.33333333333333,0.00261135948900298
2009,Peking University,pkuStruct,47,1000,904,96,1.05485232067511,2.18181818181818,0.125486132880629
2009,Peking University,pkuStruct,48,1000,882,118,1.06723585912487,2.14545454545455,0.0139133623929495
2009,Peking University,pkuStruct,49,1000,825,175,1.10253583241455,2.13414634146341,0.0551046956492166
2009,Peking University,pkuStruct,50,1000,872,128,1.07758620689655,2.28571428571429,0.0263651941945462
2009,South China Unviersity of Tehcnology,scutrun1,1,1000,836,164,1.12612612612613,3.15384615384615,0.00429796394819374
2009,South China Unviersity of Tehcnology,scutrun1,2,1000,843,157,1.1454753722795,5.23333333333333,0.00539518650568519
2009,South China Unviersity of Tehcnology,scutrun1,3,1000,847,153,1.12485939257593,3.64285714285714,0.000132277740222186
2009,South China Unviersity of Tehcnology,scutrun1,4,1000,820,180,1.14025085518814,3.15789473684211,0.0392157458628454
2009,South China Unviersity of Tehcnology,scutrun1,5,1000,831,169,1.11111111111111,2.44927536231884,8.69452231606099e-05
2009,South China Unviersity of Tehcnology,scutrun1,6,1000,506,494,1.76991150442478,8.3728813559322,0.0541183243539935
2009,South China Unviersity of Tehcnology,scutrun1,7,1000,979,21,1.01317122593718,2.625,3.02609349537323e-05
2009,South China Unviersity of Tehcnology,scutrun1,8,1000,856,144,1.11358574610245,3.42857142857143,0.00227572185028306
2009,South China Unviersity of Tehcnology,scutrun1,9,1000,927,73,1.04602510460251,2.51724137931035,0.162084221317594
2009,South China Unviersity of Tehcnology,scutrun1,10,1000,617,383,1.50829562594268,8.32608695652174,0.000101911680402814
2009,South China Unviersity of Tehcnology,scutrun1,11,1000,941,59,1.03412616339193,2.26923076923077,0.000132301640986654
2009,South China Unviersity of Tehcnology,scutrun1,12,1000,432,568,2.04081632653061,9.79310344827586,0.00487508213838495
2009,South China Unviersity of Tehcnology,scutrun1,13,1000,828,172,1.14025085518814,3.51020408163265,0.0752850357597541
2009,South China Unviersity of Tehcnology,scutrun1,14,1000,898,102,1.06951871657754,2.75675675675676,5.64538704814203e-08
2009,South China Unviersity of Tehcnology,scutrun1,15,1000,799,201,1.13507377979569,2.45121951219512,9.44140667509396e-05
2009,South China Unviersity of Tehcnology,scutrun1,16,1000,856,144,1.08932461873638,2.32258064516129,0.00842256233617534
2009,South China Unviersity of Tehcnology,scutrun1,17,1000,937,63,1.05042016806723,4.2,6.26962953175541e-15
2009,South China Unviersity of Tehcnology,scutrun1,18,1000,901,99,1.07296137339056,3.19354838709677,2.08585446583308e-05
2009,South China Unviersity of Tehcnology,scutrun1,19,1000,762,238,1.19047619047619,3.05128205128205,5.90298992412604e-05
2009,South China Unviersity of Tehcnology,scutrun1,20,1000,795,205,1.17508813160987,3.66071428571429,3.36232256316725e-05
2009,South China Unviersity of Tehcnology,scutrun1,21,1000,908,92,1.05820105820106,2.48648648648649,4.25347108037859e-07
2009,South China Unviersity of Tehcnology,scutrun1,22,1000,909,91,1.06496272630458,3.03333333333333,0.028517980785583
2009,South China Unviersity of Tehcnology,scutrun1,23,1000,626,374,1.42045454545455,4.7948717948718,0.066246358995944
2009,South China Unviersity of Tehcnology,scutrun1,24,1000,894,106,1.06837606837607,2.52380952380952,0.000110823985345336
2009,South China Unviersity of Tehcnology,scutrun1,25,1000,680,320,1.30208333333333,3.63636363636364,0.00109464800964743
2009,South China Unviersity of Tehcnology,scutrun1,26,1000,885,115,1.0752688172043,2.55555555555556,1.47065608164522e-06
2009,South China Unviersity of Tehcnology,scutrun1,27,1000,906,94,1.06044538706257,2.54054054054054,1.78783587590676e-05
2009,South China Unviersity of Tehcnology,scutrun1,28,1000,672,328,1.35869565217391,5.125,0.0296554699772748
2009,South China Unviersity of Tehcnology,scutrun1,29,1000,908,92,1.06044538706257,2.62857142857143,0.0596446929979789
2009,South China Unviersity of Tehcnology,scutrun1,30,1000,968,32,1.01626016260163,2,2.3277069486437e-10
2009,South China Unviersity of Tehcnology,scutrun1,31,1000,757,243,1.19331742243437,3,2.93462936794378e-07
2009,South China Unviersity of Tehcnology,scutrun1,32,1000,941,59,1.03626943005181,2.45833333333333,0.000342512401558341
2009,South China Unviersity of Tehcnology,scutrun1,33,1000,925,75,1.0482180293501,2.58620689655172,0.000879390814211262
2009,South China Unviersity of Tehcnology,scutrun1,34,1000,946,54,1.0351966873706,2.7,0.0667876361104532
2009,South China Unviersity of Tehcnology,scutrun1,35,1000,673,327,1.30039011703511,3.40625,0.0004287282279752
2009,South China Unviersity of Tehcnology,scutrun1,36,1000,947,53,1.0351966873706,2.78947368421053,2.27992103640732e-05
2009,South China Unviersity of Tehcnology,scutrun1,37,1000,655,345,1.39082058414465,5.390625,0.217370949835274
2009,South China Unviersity of Tehcnology,scutrun1,38,1000,929,71,1.0482180293501,2.84,0.0171616212021656
2009,South China Unviersity of Tehcnology,scutrun1,39,1000,916,84,1.05596620908131,2.70967741935484,0.000126999186518379
2009,South China Unviersity of Tehcnology,scutrun1,40,130,74,56,1.56626506024096,6.22222222222222,0.0808086422939043
2009,South China Unviersity of Tehcnology,scutrun1,41,1000,907,93,1.06609808102345,3,0.00522186117766119
2009,South China Unviersity of Tehcnology,scutrun1,42,1000,908,92,1.05932203389831,2.55555555555556,0.00123525959837403
2009,South China Unviersity of Tehcnology,scutrun1,43,1000,841,159,1.11482720178372,2.83928571428571,1.22228078758179e-06
2009,South China Unviersity of Tehcnology,scutrun1,44,1000,726,274,1.29198966408269,5.70833333333333,0.257684012269505
2009,South China Unviersity of Tehcnology,scutrun1,45,1000,891,109,1.09170305676856,4.36,6.6597484395018e-06
2009,South China Unviersity of Tehcnology,scutrun1,46,1000,758,242,1.21212121212121,3.61194029850746,0.000593145251860512
2009,South China Unviersity of Tehcnology,scutrun1,47,1000,875,125,1.08813928182807,2.84090909090909,0.0112117664339412
2009,South China Unviersity of Tehcnology,scutrun1,48,1000,868,132,1.10987791342952,4,3.02693382854259e-05
2009,South China Unviersity of Tehcnology,scutrun1,49,1000,814,186,1.14678899082569,3.20689655172414,0.190000000484631
2009,South China Unviersity of Tehcnology,scutrun1,50,1000,952,48,1.02669404517454,2.18181818181818,0.000156025291103664
2009,South China Unviersity of Tehcnology,scutrun2,1,1000,836,164,1.12612612612613,3.15384615384615,0.00386658845339658
2009,South China Unviersity of Tehcnology,scutrun2,2,1000,841,159,1.14678899082569,5.12903225806452,0.00437010106960005
2009,South China Unviersity of Tehcnology,scutrun2,3,1000,847,153,1.12485939257593,3.64285714285714,9.6430472148966e-05
2009,South China Unviersity of Tehcnology,scutrun2,4,1000,818,182,1.14155251141553,3.13793103448276,0.039215745808071
2009,South China Unviersity of Tehcnology,scutrun2,5,1000,831,169,1.11111111111111,2.44927536231884,8.69208764669319e-05
2009,South China Unviersity of Tehcnology,scutrun2,6,1000,506,494,1.76991150442478,8.3728813559322,0.0437102028219086
2009,South China Unviersity of Tehcnology,scutrun2,7,1000,979,21,1.01317122593718,2.625,1.98541937537951e-05
2009,South China Unviersity of Tehcnology,scutrun2,8,1000,855,145,1.11482720178372,3.45238095238095,0.00101852251762581
2009,South China Unviersity of Tehcnology,scutrun2,9,1000,927,73,1.04712041884817,2.60714285714286,0.145889303967149
2009,South China Unviersity of Tehcnology,scutrun2,10,1000,617,383,1.50829562594268,8.32608695652174,8.25500987612143e-05
2009,South China Unviersity of Tehcnology,scutrun2,11,1000,941,59,1.03412616339193,2.26923076923077,3.36304353179368e-05
2009,South China Unviersity of Tehcnology,scutrun2,12,1000,432,568,2.04081632653061,9.79310344827586,0.0066873089600693
2009,South China Unviersity of Tehcnology,scutrun2,13,1000,830,170,1.13895216400911,3.54166666666667,0.0658252646878779
2009,South China Unviersity of Tehcnology,scutrun2,14,1000,898,102,1.06951871657754,2.75675675675676,5.64538595946762e-08
2009,South China Unviersity of Tehcnology,scutrun2,15,1000,801,199,1.13378684807256,2.45679012345679,3.37255549365437e-05
2009,South China Unviersity of Tehcnology,scutrun2,16,1000,858,142,1.08813928182807,2.32786885245902,0.000365084034769599
2009,South China Unviersity of Tehcnology,scutrun2,17,1000,935,65,1.0515247108307,4.0625,0.0187106471414937
2009,South China Unviersity of Tehcnology,scutrun2,18,1000,901,99,1.07296137339056,3.19354838709677,1.61555745758974e-05
2009,South China Unviersity of Tehcnology,scutrun2,19,1000,761,239,1.19047619047619,3.0253164556962,3.53962286774876e-05
2009,South China Unviersity of Tehcnology,scutrun2,20,1000,795,205,1.17508813160987,3.66071428571429,1.78687606530189e-05
2009,South China Unviersity of Tehcnology,scutrun2,21,1000,907,93,1.05932203389831,2.51351351351351,2.04710038086709e-07
2009,South China Unviersity of Tehcnology,scutrun2,22,1000,909,91,1.06496272630458,3.03333333333333,0.0230995644241405
2009,South China Unviersity of Tehcnology,scutrun2,23,1000,624,376,1.42247510668563,4.75949367088608,0.0562231372383131
2009,South China Unviersity of Tehcnology,scutrun2,24,1000,894,106,1.06837606837607,2.52380952380952,5.8700891437951e-05
2009,South China Unviersity of Tehcnology,scutrun2,25,1000,678,322,1.30378096479791,3.61797752808989,0.0124399619525792
2009,South China Unviersity of Tehcnology,scutrun2,26,1000,885,115,1.0752688172043,2.55555555555556,1.47065447776192e-06
2009,South China Unviersity of Tehcnology,scutrun2,27,1000,906,94,1.06044538706257,2.54054054054054,1.78738081498677e-05
2009,South China Unviersity of Tehcnology,scutrun2,28,1000,672,328,1.35869565217391,5.125,0.0266895467209578
2009,South China Unviersity of Tehcnology,scutrun2,29,1000,908,92,1.06044538706257,2.62857142857143,0.0483140625051804
2009,South China Unviersity of Tehcnology,scutrun2,30,1000,968,32,1.01626016260163,2,5.52339788733296e-07
2009,South China Unviersity of Tehcnology,scutrun2,31,1000,757,243,1.19331742243437,3,2.64116707952311e-07
2009,South China Unviersity of Tehcnology,scutrun2,32,1000,939,61,1.03734439834025,2.44,0.000164014711512688
2009,South China Unviersity of Tehcnology,scutrun2,33,1000,927,73,1.04712041884817,2.60714285714286,0.000328970134198195
2009,South China Unviersity of Tehcnology,scutrun2,34,1000,946,54,1.0351966873706,2.7,0.0600603746242033
2009,South China Unviersity of Tehcnology,scutrun2,35,1000,674,326,1.30039011703511,3.43157894736842,0.000101717493003507
2009,South China Unviersity of Tehcnology,scutrun2,36,1000,945,55,1.03626943005181,2.75,1.8499967315827e-05
2009,South China Unviersity of Tehcnology,scutrun2,37,1000,655,345,1.39082058414465,5.390625,0.171505626347038
2009,South China Unviersity of Tehcnology,scutrun2,38,1000,931,69,1.04712041884817,2.875,0.0059333423713144
2009,South China Unviersity of Tehcnology,scutrun2,39,1000,916,84,1.05596620908131,2.70967741935484,0.0001269991823124
2009,South China Unviersity of Tehcnology,scutrun2,40,130,74,56,1.56626506024096,6.22222222222222,0.0714154315263378
2009,South China Unviersity of Tehcnology,scutrun2,41,1000,907,93,1.06609808102345,3,0.00401894077503532
2009,South China Unviersity of Tehcnology,scutrun2,42,1000,908,92,1.05932203389831,2.55555555555556,0.00112950514853581
2009,South China Unviersity of Tehcnology,scutrun2,43,1000,841,159,1.11482720178372,2.83928571428571,1.22223107962713e-06
2009,South China Unviersity of Tehcnology,scutrun2,44,1000,726,274,1.29032258064516,5.59183673469388,0.231946874892603
2009,South China Unviersity of Tehcnology,scutrun2,45,1000,891,109,1.09170305676856,4.36,5.82510534076621e-06
2009,South China Unviersity of Tehcnology,scutrun2,46,1000,758,242,1.21212121212121,3.61194029850746,0.000533573743785153
2009,South China Unviersity of Tehcnology,scutrun2,47,1000,875,125,1.08813928182807,2.84090909090909,0.00906830222074528
2009,South China Unviersity of Tehcnology,scutrun2,48,1000,868,132,1.10987791342952,4,1.78732422476369e-05
2009,South China Unviersity of Tehcnology,scutrun2,49,1000,813,187,1.14810562571757,3.22413793103448,0.190000000234039
2009,South China Unviersity of Tehcnology,scutrun2,50,1000,950,50,1.02880658436214,2.27272727272727,0.000113742437214545
2009,South China Unviersity of Tehcnology,scutrun3,1,1000,836,164,1.12612612612613,3.15384615384615,0.00430062059673259
2009,South China Unviersity of Tehcnology,scutrun3,2,1000,843,157,1.1454753722795,5.23333333333333,0.00666072408109283
2009,South China Unviersity of Tehcnology,scutrun3,3,1000,847,153,1.12485939257593,3.64285714285714,0.000224013516568444
2009,South China Unviersity of Tehcnology,scutrun3,4,1000,820,180,1.14025085518814,3.15789473684211,0.0392264604308491
2009,South China Unviersity of Tehcnology,scutrun3,5,1000,831,169,1.11111111111111,2.44927536231884,9.85257323008274e-05
2009,South China Unviersity of Tehcnology,scutrun3,6,1000,506,494,1.76991150442478,8.3728813559322,0.0669133756893712
2009,South China Unviersity of Tehcnology,scutrun3,7,1000,979,21,1.01317122593718,2.625,6.32680795396116e-05
2009,South China Unviersity of Tehcnology,scutrun3,8,1000,855,145,1.11482720178372,3.45238095238095,0.0141848428177178
2009,South China Unviersity of Tehcnology,scutrun3,9,1000,927,73,1.04602510460251,2.51724137931035,0.180096974306626
2009,South China Unviersity of Tehcnology,scutrun3,10,1000,617,383,1.50829562594268,8.32608695652174,0.000113233617398083
2009,South China Unviersity of Tehcnology,scutrun3,11,1000,941,59,1.03412616339193,2.26923076923077,0.000201704185462011
2009,South China Unviersity of Tehcnology,scutrun3,12,1000,432,568,2.04081632653061,9.79310344827586,0.00317188557693356
2009,South China Unviersity of Tehcnology,scutrun3,13,1000,830,170,1.13895216400911,3.54166666666667,0.082484749739269
2009,South China Unviersity of Tehcnology,scutrun3,14,1000,896,104,1.07066381156317,2.73684210526316,5.69409401926366e-08
2009,South China Unviersity of Tehcnology,scutrun3,15,1000,801,199,1.13378684807256,2.45679012345679,4.62783592386213e-05
2009,South China Unviersity of Tehcnology,scutrun3,16,1000,854,146,1.09051254089422,2.31746031746032,0.012688465330577
2009,South China Unviersity of Tehcnology,scutrun3,17,1000,937,63,1.05042016806723,4.2,6.96626354677728e-15
2009,South China Unviersity of Tehcnology,scutrun3,18,1000,901,99,1.07296137339056,3.19354838709677,2.46235928379597e-05
2009,South China Unviersity of Tehcnology,scutrun3,19,1000,761,239,1.19047619047619,3.0253164556962,8.23551065478905e-05
2009,South China Unviersity of Tehcnology,scutrun3,20,1000,793,207,1.17647058823529,3.63157894736842,4.15101551008862e-05
2009,South China Unviersity of Tehcnology,scutrun3,21,1000,910,90,1.05708245243129,2.5,6.56481626009188e-07
2009,South China Unviersity of Tehcnology,scutrun3,22,1000,909,91,1.06496272630458,3.03333333333333,0.0391193152186252
2009,South China Unviersity of Tehcnology,scutrun3,23,1000,626,374,1.42045454545455,4.7948717948718,0.0802588518111255
2009,South China Unviersity of Tehcnology,scutrun3,24,1000,892,108,1.06951871657754,2.51162790697674,0.000168352512441555
2009,South China Unviersity of Tehcnology,scutrun3,25,1000,682,318,1.30039011703511,3.6551724137931,0.00121668381606184
2009,South China Unviersity of Tehcnology,scutrun3,26,1000,885,115,1.0752688172043,2.55555555555556,1.47065620551724e-06
2009,South China Unviersity of Tehcnology,scutrun3,27,1000,906,94,1.06044538706257,2.54054054054054,1.7893065883998e-05
2009,South China Unviersity of Tehcnology,scutrun3,28,1000,670,330,1.36054421768707,5.07692307692308,0.0407755065944527
2009,South China Unviersity of Tehcnology,scutrun3,29,1000,908,92,1.06044538706257,2.62857142857143,0.0662695833598788
2009,South China Unviersity of Tehcnology,scutrun3,30,1000,970,30,1.01522842639594,2,2.86058024265724e-10
2009,South China Unviersity of Tehcnology,scutrun3,31,1000,756,244,1.194743130227,3.01234567901235,7.0885244185353e-07
2009,South China Unviersity of Tehcnology,scutrun3,32,1000,941,59,1.03626943005181,2.45833333333333,0.000643946632259191
2009,South China Unviersity of Tehcnology,scutrun3,33,1000,927,73,1.04712041884817,2.60714285714286,0.00176875362116956
2009,South China Unviersity of Tehcnology,scutrun3,34,1000,944,56,1.03626943005181,2.66666666666667,0.0668475153328238
2009,South China Unviersity of Tehcnology,scutrun3,35,1000,670,330,1.30378096479791,3.4020618556701,0.000628485686163036
2009,South China Unviersity of Tehcnology,scutrun3,36,1000,947,53,1.0351966873706,2.78947368421053,2.30739322562769e-05
2009,South China Unviersity of Tehcnology,scutrun3,37,1000,655,345,1.39082058414465,5.390625,0.217818125343501
2009,South China Unviersity of Tehcnology,scutrun3,38,1000,929,71,1.0482180293501,2.84,0.0263859108732862
2009,South China Unviersity of Tehcnology,scutrun3,39,1000,914,86,1.05708245243129,2.6875,0.000129205211026505
2009,South China Unviersity of Tehcnology,scutrun3,40,130,74,56,1.56626506024096,6.22222222222222,0.0927954151296854
2009,South China Unviersity of Tehcnology,scutrun3,41,1000,907,93,1.06609808102345,3,0.00697496886316274
2009,South China Unviersity of Tehcnology,scutrun3,42,1000,908,92,1.05932203389831,2.55555555555556,0.00273290186884301
2009,South China Unviersity of Tehcnology,scutrun3,43,1000,841,159,1.11482720178372,2.83928571428571,1.39444094695405e-06
2009,South China Unviersity of Tehcnology,scutrun3,44,1000,726,274,1.29198966408269,5.70833333333333,0.259615697459274
2009,South China Unviersity of Tehcnology,scutrun3,45,1000,891,109,1.09170305676856,4.36,1.35945998169255e-05
2009,South China Unviersity of Tehcnology,scutrun3,46,1000,758,242,1.21212121212121,3.61194029850746,0.000624847650643986
2009,South China Unviersity of Tehcnology,scutrun3,47,1000,875,125,1.08813928182807,2.84090909090909,0.0138416870981244
2009,South China Unviersity of Tehcnology,scutrun3,48,1000,868,132,1.10987791342952,4,3.73751242699945e-05
2009,South China Unviersity of Tehcnology,scutrun3,49,1000,814,186,1.14678899082569,3.20689655172414,0.153900001078402
2009,South China Unviersity of Tehcnology,scutrun3,50,1000,950,50,1.02774922918808,2.17391304347826,0.000237807180465995
2009,University of Twente,twCSrs9N,1,999,840,159,1.11,2.65,0.0110677863972911
2009,University of Twente,twCSrs9N,2,999,954,45,1.02566735112936,2.25,1.7596635548975e-06
2009,University of Twente,twCSrs9N,3,999,942,57,1.03523316062176,2.47826086956522,0.00873609269026898
2009,University of Twente,twCSrs9N,4,999,960,39,1.02251791197544,2.29411764705882,1.40501543453471e-07
2009,University of Twente,twCSrs9N,5,999,921,78,1.04826862539349,2.4375,1.05541825814969e-05
2009,University of Twente,twCSrs9N,6,999,903,96,1.06959314775161,3.09677419354839,7.2289298715765e-05
2009,University of Twente,twCSrs9N,7,999,882,117,1.07650862068966,2.54347826086957,0.0325865694441251
2009,University of Twente,twCSrs9N,8,999,981,18,1.00909090909091,2,1.73286882515339e-07
2009,University of Twente,twCSrs9N,9,999,562,437,1.66222961730449,11.2051282051282,0.583076838363862
2009,University of Twente,twCSrs9N,10,999,919,80,1.06050955414013,3.47826086956522,0.131438061738349
2009,University of Twente,twCSrs9N,11,999,945,54,1.03202479338843,2.34782608695652,3.26069259165394e-07
2009,University of Twente,twCSrs9N,12,999,896,103,1.07766990291262,3.32258064516129,0.00474004718322884
2009,University of Twente,twCSrs9N,13,999,768,231,1.15893271461717,2.45744680851064,0.00281032777487733
2009,University of Twente,twCSrs9N,14,999,973,26,1.0131845841785,2,5.99312253868873e-06
2009,University of Twente,twCSrs9N,15,999,959,40,1.02251791197544,2.22222222222222,2.24406889083303e-05
2009,University of Twente,twCSrs9N,16,999,909,90,1.06616862326574,3.21428571428571,0.413050201978967
2009,University of Twente,twCSrs9N,17,999,904,95,1.06844919786096,3.06451612903226,0.00314546405841926
2009,University of Twente,twCSrs9N,18,999,969,30,1.01627670396745,2.14285714285714,0.000578276592230239
2009,University of Twente,twCSrs9N,19,999,835,164,1.11744966442953,2.77966101694915,0.0407014802255678
2009,University of Twente,twCSrs9N,20,999,919,80,1.05047318611987,2.5,0.000175331283260701
2009,University of Twente,twCSrs9N,21,999,863,136,1.09539473684211,2.77551020408163,0.0736098929104148
2009,University of Twente,twCSrs9N,22,999,976,23,1.01215805471125,2.09090909090909,0.000658547573232101
2009,University of Twente,twCSrs9N,23,999,942,57,1.03523316062176,2.47826086956522,0.0981554473073399
2009,University of Twente,twCSrs9N,24,999,977,22,1.01113360323887,2,4.15101683048603e-05
2009,University of Twente,twCSrs9N,25,999,841,158,1.11870100783875,3.03846153846154,0.00253162015063482
2009,University of Twente,twCSrs9N,26,999,954,45,1.02989690721649,2.8125,1.86742502427057e-09
2009,University of Twente,twCSrs9N,27,999,981,18,1.01113360323887,2.57142857142857,2.32531511132201e-09
2009,University of Twente,twCSrs9N,28,999,904,95,1.07073954983923,3.27586206896552,0.000950617146323732
2009,University of Twente,twCSrs9N,29,999,905,94,1.07303974221267,3.61538461538462,0.000793166005760862
2009,University of Twente,twCSrs9N,30,999,968,31,1.01627670396745,2.06666666666667,4.5808111185828e-07
2009,University of Twente,twCSrs9N,31,999,959,40,1.02147239263804,2.10526315789474,0.0286681695592829
2009,University of Twente,twCSrs9N,32,999,690,309,1.34817813765182,6.05882352941176,0.217599776354761
2009,University of Twente,twCSrs9N,33,999,995,4,1.00200601805416,2,2.62617887366112e-42
2009,University of Twente,twCSrs9N,34,999,853,146,1.10143329658214,2.7037037037037,0.000323776876407318
2009,University of Twente,twCSrs9N,35,999,970,29,1.01627670396745,2.23076923076923,6.22042883903541e-05
2009,University of Twente,twCSrs9N,36,999,953,46,1.02461538461538,2.09090909090909,0.00246372715200818
2009,University of Twente,twCSrs9N,37,999,967,32,1.0173116089613,2.13333333333333,3.40043365137935e-18
2009,University of Twente,twCSrs9N,38,999,900,99,1.05714285714286,2.2,0.000149760982073563
2009,University of Twente,twCSrs9N,39,999,940,59,1.040625,2.95,4.44296674618702e-07
2009,University of Twente,twCSrs9N,40,999,786,213,1.14302059496568,2.42045454545455,0.245875587379135
2009,University of Twente,twCSrs9N,41,999,964,35,1.01834862385321,2.05882352941176,0.00476160301582532
2009,University of Twente,twCSrs9N,42,999,756,243,1.22127139364303,3.91935483870968,0.00328357243605664
2009,University of Twente,twCSrs9N,43,999,950,49,1.02672147995889,2.1304347826087,1.44576041074271e-05
2009,University of Twente,twCSrs9N,44,999,810,189,1.14827586206897,3.15,7.38834930449398e-07
2009,University of Twente,twCSrs9N,45,999,963,36,1.02042900919305,2.25,0.0136400789715933
2009,University of Twente,twCSrs9N,46,999,979,20,1.01113360323887,2.22222222222222,4.95956783648311e-14
2009,University of Twente,twCSrs9N,47,999,985,14,1.0070564516129,2,2.41270123384778e-27
2009,University of Twente,twCSrs9N,48,999,979,20,1.01011122345804,2,5.21863624596233e-11
2009,University of Twente,twCSrs9N,49,999,919,80,1.04716981132075,2.28571428571429,0.110483855912599
2009,University of Twente,twCSrs9N,50,999,884,115,1.08469055374593,3.10810810810811,0.0514734683409223
2009,University of Twente,twCSrsR,1,999,999,0,1,,0
2009,University of Twente,twCSrsR,2,999,999,0,1,,0
2009,University of Twente,twCSrsR,3,999,999,0,1,,0
2009,University of Twente,twCSrsR,4,999,999,0,1,,0
2009,University of Twente,twCSrsR,5,999,999,0,1,,0
2009,University of Twente,twCSrsR,6,999,999,0,1,,0
2009,University of Twente,twCSrsR,7,999,999,0,1,,0
2009,University of Twente,twCSrsR,8,999,999,0,1,,0
2009,University of Twente,twCSrsR,9,999,999,0,1,,0
2009,University of Twente,twCSrsR,10,999,999,0,1,,0
2009,University of Twente,twCSrsR,11,999,999,0,1,,0
2009,University of Twente,twCSrsR,12,999,999,0,1,,0
2009,University of Twente,twCSrsR,13,999,999,0,1,,0
2009,University of Twente,twCSrsR,14,999,999,0,1,,0
2009,University of Twente,twCSrsR,15,999,999,0,1,,0
2009,University of Twente,twCSrsR,16,999,999,0,1,,0
2009,University of Twente,twCSrsR,17,999,999,0,1,,0
2009,University of Twente,twCSrsR,18,999,999,0,1,,0
2009,University of Twente,twCSrsR,19,999,999,0,1,,0
2009,University of Twente,twCSrsR,20,999,999,0,1,,0
2009,University of Twente,twCSrsR,21,999,999,0,1,,0
2009,University of Twente,twCSrsR,22,999,999,0,1,,0
2009,University of Twente,twCSrsR,23,999,999,0,1,,0
2009,University of Twente,twCSrsR,24,999,999,0,1,,0
2009,University of Twente,twCSrsR,25,999,999,0,1,,0
2009,University of Twente,twCSrsR,26,999,999,0,1,,0
2009,University of Twente,twCSrsR,27,999,999,0,1,,0
2009,University of Twente,twCSrsR,28,999,999,0,1,,0
2009,University of Twente,twCSrsR,29,999,999,0,1,,0
2009,University of Twente,twCSrsR,30,999,999,0,1,,0
2009,University of Twente,twCSrsR,31,999,999,0,1,,0
2009,University of Twente,twCSrsR,32,999,999,0,1,,0
2009,University of Twente,twCSrsR,33,999,999,0,1,,0
2009,University of Twente,twCSrsR,34,999,999,0,1,,0
2009,University of Twente,twCSrsR,35,999,999,0,1,,0
2009,University of Twente,twCSrsR,36,999,999,0,1,,0
2009,University of Twente,twCSrsR,37,999,999,0,1,,0
2009,University of Twente,twCSrsR,38,999,999,0,1,,0
2009,University of Twente,twCSrsR,39,999,999,0,1,,0
2009,University of Twente,twCSrsR,40,999,999,0,1,,0
2009,University of Twente,twCSrsR,41,999,999,0,1,,0
2009,University of Twente,twCSrsR,42,999,999,0,1,,0
2009,University of Twente,twCSrsR,43,999,999,0,1,,0
2009,University of Twente,twCSrsR,44,999,999,0,1,,0
2009,University of Twente,twCSrsR,45,999,999,0,1,,0
2009,University of Twente,twCSrsR,46,999,999,0,1,,0
2009,University of Twente,twCSrsR,47,999,999,0,1,,0
2009,University of Twente,twCSrsR,48,999,999,0,1,,0
2009,University of Twente,twCSrsR,49,999,999,0,1,,0
2009,University of Twente,twCSrsR,50,999,999,0,1,,0
2009,University of Twente,twJ48rsU,1,999,767,232,1.18364928909953,3.01298701298701,0.00956909366985144
2009,University of Twente,twJ48rsU,2,999,850,149,1.08823529411765,2.19117647058824,0.00695672652694741
2009,University of Twente,twJ48rsU,3,999,886,113,1.0741935483871,2.56818181818182,0.00223814481883712
2009,University of Twente,twJ48rsU,4,999,983,16,1.00807265388496,2,2.93462473805356e-07
2009,University of Twente,twJ48rsU,5,999,975,24,1.01215805471125,2,1.11964309272587e-08
2009,University of Twente,twJ48rsU,6,999,939,60,1.03202479338843,2.06896551724138,0.138527868761706
2009,University of Twente,twJ48rsU,7,999,855,144,1.10143329658214,2.76923076923077,0.160779411357255
2009,University of Twente,twJ48rsU,8,999,977,22,1.01113360323887,2,4.26321484739534e-17
2009,University of Twente,twJ48rsU,9,999,538,461,1.77758007117438,19.2083333333333,0.318748819596346
2009,University of Twente,twJ48rsU,10,999,741,258,1.26937738246506,5.60869565217391,0.0732256731998316
2009,University of Twente,twJ48rsU,11,999,950,49,1.02883625128733,2.33333333333333,4.07937385491709e-13
2009,University of Twente,twJ48rsU,12,999,936,63,1.03630705394191,2.25,0.153301073662544
2009,University of Twente,twJ48rsU,13,999,856,143,1.09061135371179,2.38333333333333,0.0230995729094348
2009,University of Twente,twJ48rsU,14,999,983,16,1.00807265388496,2,0.0033350518567393
2009,University of Twente,twJ48rsU,15,999,809,190,1.13009049773756,2.53333333333333,0.21838418564732
2009,University of Twente,twJ48rsU,16,999,843,156,1.12881355932203,3.71428571428571,0.116989174967265
2009,University of Twente,twJ48rsU,17,999,970,29,1.01834862385321,2.63636363636364,7.17417018009693e-09
2009,University of Twente,twJ48rsU,18,999,943,56,1.02883625128733,2,0.000989723321161039
2009,University of Twente,twJ48rsU,19,999,825,174,1.10876803551609,2.28947368421053,0.0838198523148339
2009,University of Twente,twJ48rsU,20,999,765,234,1.21532846715328,4.10526315789474,0.000517369890987206
2009,University of Twente,twJ48rsU,21,999,930,69,1.04388714733542,2.55555555555556,0.037033692259167
2009,University of Twente,twJ48rsU,22,999,963,36,1.01938775510204,2.11764705882353,2.51193577669724e-24
2009,University of Twente,twJ48rsU,23,999,915,84,1.05268703898841,2.47058823529412,0.194790771886491
2009,University of Twente,twJ48rsU,24,999,933,66,1.03630705394191,2.12903225806452,1.49940339067249e-12
2009,University of Twente,twJ48rsU,25,999,979,20,1.01011122345804,2,9.11548089683554e-13
2009,University of Twente,twJ48rsU,26,999,946,53,1.03309203722854,2.52380952380952,1.53636767585116e-08
2009,University of Twente,twJ48rsU,27,999,983,16,1.01011122345804,2.66666666666667,0.00346761767092831
2009,University of Twente,twJ48rsU,28,999,959,40,1.02251791197544,2.22222222222222,0.0422844892284614
2009,University of Twente,twJ48rsU,29,999,908,91,1.07073954983923,3.64,0.000435994632154335
2009,University of Twente,twJ48rsU,30,999,970,29,1.01524390243902,2.07142857142857,0.000152474867651793
2009,University of Twente,twJ48rsU,31,999,935,64,1.03738317757009,2.28571428571429,0.0463682031696045
2009,University of Twente,twJ48rsU,32,999,803,196,1.19497607655502,5.93939393939394,0.299069543063567
2009,University of Twente,twJ48rsU,33,999,972,27,1.01421319796954,2.07692307692308,4.73646629023329e-17
2009,University of Twente,twJ48rsU,34,999,826,173,1.13265306122449,3.08928571428571,0.0148067510407849
2009,University of Twente,twJ48rsU,35,999,976,23,1.0131845841785,2.3,2.48048138932447e-05
2009,University of Twente,twJ48rsU,36,999,965,34,1.01834862385321,2.125,7.59271243458095e-05
2009,University of Twente,twJ48rsU,37,999,979,20,1.01011122345804,2,2.03323774765469e-25
2009,University of Twente,twJ48rsU,38,999,610,389,1.3355614973262,2.81884057971015,0.026696117163775
2009,University of Twente,twJ48rsU,39,999,970,29,1.01524390243902,2.07142857142857,3.51348170280711e-09
2009,University of Twente,twJ48rsU,40,999,647,352,1.31447368421053,3.11504424778761,0.00977215078707852
2009,University of Twente,twJ48rsU,41,999,956,43,1.02461538461538,2.26315789473684,0.00280836943690495
2009,University of Twente,twJ48rsU,42,999,595,404,1.45626822157434,4.43956043956044,0.0387601940320805
2009,University of Twente,twJ48rsU,43,999,848,151,1.11995515695067,3.43181818181818,0.00125824525866612
2009,University of Twente,twJ48rsU,44,999,644,355,1.33734939759036,3.44660194174757,0.40970211306483
2009,University of Twente,twJ48rsU,45,999,971,28,1.01627670396745,2.33333333333333,0.0316866712397093
2009,University of Twente,twJ48rsU,46,999,964,35,1.01834862385321,2.05882352941176,5.37608591473335e-08
2009,University of Twente,twJ48rsU,47,999,974,25,1.0131845841785,2.08333333333333,2.54553121086392e-18
2009,University of Twente,twJ48rsU,48,999,972,27,1.01421319796954,2.07692307692308,1.06924127571699e-11
2009,University of Twente,twJ48rsU,49,999,954,45,1.02566735112936,2.25,0.140790385291264
2009,University of Twente,twJ48rsU,50,999,955,44,1.02989690721649,2.93333333333333,2.44535300597548e-09
2009,University of Delaware,udelIndDMRM,1,1000,911,89,1.0482180293501,2.06976744186047,0.222185408686191
2009,University of Delaware,udelIndDMRM,2,1000,962,38,1.02040816326531,2.11111111111111,0.0110906207689245
2009,University of Delaware,udelIndDMRM,3,1000,938,62,1.03626943005181,2.2962962962963,2.93462289731214e-07
2009,University of Delaware,udelIndDMRM,4,1000,982,18,1.00908173562059,2,0.0230995863346329
2009,University of Delaware,udelIndDMRM,5,1000,962,38,1.01936799184506,2,8.16232075722389e-09
2009,University of Delaware,udelIndDMRM,6,1000,946,54,1.02774922918808,2,0.0448615760830534
2009,University of Delaware,udelIndDMRM,7,1000,969,31,1.01729399796541,2.21428571428571,1.40376376480697e-07
2009,University of Delaware,udelIndDMRM,8,1000,963,37,1.01936799184506,2.05555555555556,3.67903298128364e-06
2009,University of Delaware,udelIndDMRM,9,1000,940,60,1.03842159916926,2.60869565217391,5.85949910763649e-10
2009,University of Delaware,udelIndDMRM,10,1000,867,133,1.09051254089422,2.66,0.00227477789999516
2009,University of Delaware,udelIndDMRM,11,1000,976,24,1.01214574898785,2,6.13556743421746e-07
2009,University of Delaware,udelIndDMRM,12,1000,931,69,1.04384133611691,2.55555555555556,0.0187115824137393
2009,University of Delaware,udelIndDMRM,13,1000,856,144,1.08813928182807,2.28571428571429,5.30429559401978e-05
2009,University of Delaware,udelIndDMRM,14,1000,974,26,1.01317122593718,2,2.37704464921651e-07
2009,University of Delaware,udelIndDMRM,15,1000,930,70,1.03626943005181,2,0.00733101276499862
2009,University of Delaware,udelIndDMRM,16,1000,969,31,1.01626016260163,2.06666666666667,3.29260808091306e-14
2009,University of Delaware,udelIndDMRM,17,1000,978,22,1.01112234580384,2,8.52899846397082e-13
2009,University of Delaware,udelIndDMRM,18,1000,974,26,1.01317122593718,2,4.26285199992611e-17
2009,University of Delaware,udelIndDMRM,19,1000,947,53,1.02880658436214,2.12,1.13459799914761e-14
2009,University of Delaware,udelIndDMRM,20,1000,966,34,1.01729399796541,2,8.69887749112991e-05
2009,University of Delaware,udelIndDMRM,21,1000,963,37,1.02145045965271,2.3125,4.91731071390372e-09
2009,University of Delaware,udelIndDMRM,22,1000,946,54,1.03412616339193,2.57142857142857,3.40728225546759e-11
2009,University of Delaware,udelIndDMRM,23,1000,769,231,1.16279069767442,2.53846153846154,0.000104403621131908
2009,University of Delaware,udelIndDMRM,24,1000,952,48,1.02564102564103,2.08695652173913,0.000224013510337853
2009,University of Delaware,udelIndDMRM,25,1000,911,89,1.04712041884817,2.02272727272727,0.0167680824232135
2009,University of Delaware,udelIndDMRM,26,1000,981,19,1.01010101010101,2.11111111111111,1.4443864137977e-12
2009,University of Delaware,udelIndDMRM,27,1000,984,16,1.00806451612903,2,0.0168395824297858
2009,University of Delaware,udelIndDMRM,28,1000,916,84,1.04602510460251,2.1,0.00169119338491111
2009,University of Delaware,udelIndDMRM,29,1000,982,18,1.00908173562059,2,9.45896592407657e-20
2009,University of Delaware,udelIndDMRM,30,1000,966,34,1.01729399796541,2,0.00323945858945884
2009,University of Delaware,udelIndDMRM,31,1000,934,66,1.0351966873706,2.0625,0.053355055547951
2009,University of Delaware,udelIndDMRM,32,1000,959,41,1.02145045965271,2.05,2.98013994680359e-06
2009,University of Delaware,udelIndDMRM,33,1000,982,18,1.00908173562059,2,1.47486091492066e-18
2009,University of Delaware,udelIndDMRM,34,1000,884,116,1.06951871657754,2.27450980392157,1.17236940810535e-05
2009,University of Delaware,udelIndDMRM,35,1000,954,46,1.02459016393443,2.09090909090909,3.67943631384608e-06
2009,University of Delaware,udelIndDMRM,36,1000,960,40,1.02040816326531,2,2.30519534532432e-09
2009,University of Delaware,udelIndDMRM,37,1000,990,10,1.00502512562814,2,4.38659697487649e-22
2009,University of Delaware,udelIndDMRM,38,1000,966,34,1.01729399796541,2,0.00102113817080168
2009,University of Delaware,udelIndDMRM,39,1000,943,57,1.03092783505155,2.11111111111111,3.99682736521547e-08
2009,University of Delaware,udelIndDMRM,40,1000,406,594,1.66944908180301,3.07772020725389,3.20122230904399e-08
2009,University of Delaware,udelIndDMRM,41,1000,981,19,1.01010101010101,2.11111111111111,2.16794688671169e-13
2009,University of Delaware,udelIndDMRM,42,1000,864,136,1.10864745011086,3.57894736842105,3.45106876054296e-06
2009,University of Delaware,udelIndDMRM,43,1000,968,32,1.01626016260163,2,0.0483136129611922
2009,University of Delaware,udelIndDMRM,44,1000,931,69,1.03734439834025,2.09090909090909,0.0466712880619154
2009,University of Delaware,udelIndDMRM,45,1000,970,30,1.01626016260163,2.14285714285714,9.49619959030385e-06
2009,University of Delaware,udelIndDMRM,46,1000,959,41,1.02145045965271,2.05,0.000107154034855646
2009,University of Delaware,udelIndDMRM,47,1000,977,23,1.01214574898785,2.09090909090909,1.04104028201502e-16
2009,University of Delaware,udelIndDMRM,48,1000,969,31,1.01729399796541,2.21428571428571,0.00653349546119466
2009,University of Delaware,udelIndDMRM,49,1000,964,36,1.01936799184506,2.11764705882353,0.00141467369463132
2009,University of Delaware,udelIndDMRM,50,1000,972,28,1.01419878296146,2,7.57661338245294e-07
2009,University of Delaware,udelIndDRPR,1,1000,728,272,1.17647058823529,2.22950819672131,0.0826721641287786
2009,University of Delaware,udelIndDRPR,2,1000,745,255,1.16009280742459,2.17948717948718,0.0187110513035114
2009,University of Delaware,udelIndDRPR,3,1000,953,47,1.02459016393443,2.04347826086957,8.93584567418822e-08
2009,University of Delaware,udelIndDRPR,4,1000,908,92,1.0515247108307,2.13953488372093,0.000379392251982048
2009,University of Delaware,udelIndDRPR,5,1000,816,184,1.10864745011086,2.13953488372093,1.10775069125682e-05
2009,University of Delaware,udelIndDRPR,6,1000,812,188,1.10741971207087,2.06593406593407,0.00395785915763855
2009,University of Delaware,udelIndDRPR,7,1000,629,371,1.26262626262626,2.2760736196319,0.000167562710176698
2009,University of Delaware,udelIndDRPR,8,1000,939,61,1.03412616339193,2.17857142857143,3.56999853201573e-08
2009,University of Delaware,udelIndDRPR,9,1000,960,40,1.02040816326531,2,5.19935909807745e-11
2009,University of Delaware,udelIndDRPR,10,1000,903,97,1.05932203389831,2.36585365853659,0.00443553976719437
2009,University of Delaware,udelIndDRPR,11,1000,822,178,1.10132158590308,2.06976744186047,0.0352367341361278
2009,University of Delaware,udelIndDRPR,12,1000,949,51,1.02774922918808,2.125,3.19655173585936e-11
2009,University of Delaware,udelIndDRPR,13,1000,957,43,1.02459016393443,2.26315789473684,1.1612052721604e-06
2009,University of Delaware,udelIndDRPR,14,1000,864,136,1.07642626480086,2.09230769230769,3.72895702714858e-12
2009,University of Delaware,udelIndDRPR,15,1000,761,239,1.14942528735632,2.19266055045872,4.52533797656764e-06
2009,University of Delaware,udelIndDRPR,16,1000,829,171,1.1001100110011,2.1375,0.00475599545948716
2009,University of Delaware,udelIndDRPR,17,1000,976,24,1.01214574898785,2,1.10958307957869e-09
2009,University of Delaware,udelIndDRPR,18,1000,753,247,1.15207373271889,2.14782608695652,7.30378373256632e-06
2009,University of Delaware,udelIndDRPR,19,1000,961,39,1.02040816326531,2.05263157894737,3.1630239325529e-16
2009,University of Delaware,udelIndDRPR,20,1000,699,301,1.20918984280532,2.3515625,0.00666073317036148
2009,University of Delaware,udelIndDRPR,21,1000,978,22,1.01112234580384,2,0.000276559885157148
2009,University of Delaware,udelIndDRPR,22,1000,822,178,1.10253583241455,2.09411764705882,1.66047997130801e-07
2009,University of Delaware,udelIndDRPR,23,1000,846,154,1.10253583241455,2.52459016393443,6.04215961105382e-08
2009,University of Delaware,udelIndDRPR,24,1000,745,255,1.15473441108545,2.10743801652893,0.000564131648635084
2009,University of Delaware,udelIndDRPR,25,1000,748,252,1.15740740740741,2.17241379310345,0.00805616345286716
2009,University of Delaware,udelIndDRPR,26,1000,725,275,1.17508813160987,2.18253968253968,4.32456670208231e-05
2009,University of Delaware,udelIndDRPR,27,1000,808,192,1.11358574610245,2.13333333333333,0.00165831310436718
2009,University of Delaware,udelIndDRPR,28,1000,797,203,1.12233445566779,2.15957446808511,0.0195194874981509
2009,University of Delaware,udelIndDRPR,29,1000,597,403,1.29366106080207,2.28977272727273,9.84541923676845e-05
2009,University of Delaware,udelIndDRPR,30,1000,781,219,1.13378684807256,2.16831683168317,9.26788471338053e-12
2009,University of Delaware,udelIndDRPR,31,1000,708,292,1.18623962040332,2.16296296296296,0.00065480714502299
2009,University of Delaware,udelIndDRPR,32,1000,972,28,1.01419878296146,2,8.64893386406272e-10
2009,University of Delaware,udelIndDRPR,33,1000,921,79,1.04275286757039,2.07894736842105,6.63359913339727e-09
2009,University of Delaware,udelIndDRPR,34,1000,976,24,1.01214574898785,2,2.98000568154625e-06
2009,University of Delaware,udelIndDRPR,35,1000,842,158,1.09170305676856,2.13513513513514,2.34762126354762e-08
2009,University of Delaware,udelIndDRPR,36,1000,976,24,1.01214574898785,2,7.34644072520119e-09
2009,University of Delaware,udelIndDRPR,37,1000,827,173,1.10497237569061,2.21794871794872,0.00185724143971863
2009,University of Delaware,udelIndDRPR,38,1000,979,21,1.01112234580384,2.1,5.52206600164076e-07
2009,University of Delaware,udelIndDRPR,39,1000,834,166,1.09649122807018,2.12820512820513,8.41645847426511e-07
2009,University of Delaware,udelIndDRPR,40,1000,638,362,1.25156445556946,2.24844720496894,1.91147636782279e-09
2009,University of Delaware,udelIndDRPR,41,1000,584,416,1.30039011703511,2.24864864864865,0.00564793470735989
2009,University of Delaware,udelIndDRPR,42,1000,953,47,1.02459016393443,2.04347826086957,5.95011211514347e-09
2009,University of Delaware,udelIndDRPR,43,1000,686,314,1.20481927710843,2.18055555555556,9.44142119834568e-08
2009,University of Delaware,udelIndDRPR,44,1000,940,60,1.03092783505155,2,1.34055693496691e-10
2009,University of Delaware,udelIndDRPR,45,1000,948,52,1.02774922918808,2.08,2.88993165538598e-08
2009,University of Delaware,udelIndDRPR,46,1000,905,95,1.0515247108307,2.06521739130435,0.000132283132902274
2009,University of Delaware,udelIndDRPR,47,1000,864,136,1.07642626480086,2.09230769230769,1.12826880536092e-08
2009,University of Delaware,udelIndDRPR,48,1000,890,110,1.06044538706257,2.07547169811321,9.14054743991549e-07
2009,University of Delaware,udelIndDRPR,49,1000,767,233,1.1441647597254,2.17757009345794,0.0294861470290782
2009,University of Delaware,udelIndDRPR,50,1000,783,217,1.12866817155756,2.10679611650485,1.81219614484289e-12
2009,University of Delaware,udelIndDRSP,1,1000,906,94,1.05042016806723,2.04347826086957,0.257608828479044
2009,University of Delaware,udelIndDRSP,2,1000,966,34,1.0183299389002,2.125,0.00587181475442262
2009,University of Delaware,udelIndDRSP,3,1000,936,64,1.03412616339193,2.06451612903226,6.00838324639951e-05
2009,University of Delaware,udelIndDRSP,4,1000,973,27,1.01419878296146,2.07692307692308,0.0662637402916467
2009,University of Delaware,udelIndDRSP,5,1000,933,67,1.03626943005181,2.09375,5.45353826742193e-09
2009,University of Delaware,udelIndDRSP,6,1000,752,248,1.15874855156431,2.23423423423423,0.188207191897414
2009,University of Delaware,udelIndDRSP,7,1000,969,31,1.01729399796541,2.21428571428571,9.36586742729623e-07
2009,University of Delaware,udelIndDRSP,8,1000,953,47,1.02459016393443,2.04347826086957,2.84518999500533e-11
2009,University of Delaware,udelIndDRSP,9,1000,969,31,1.01626016260163,2.06666666666667,2.12758880923506e-15
2009,University of Delaware,udelIndDRSP,10,1000,932,68,1.04166666666667,2.42857142857143,6.86444732709607e-13
2009,University of Delaware,udelIndDRSP,11,1000,856,144,1.08108108108108,2.08695652173913,1.78812042464979e-05
2009,University of Delaware,udelIndDRSP,12,1000,933,67,1.04384133611691,2.68,0.0136400617662133
2009,University of Delaware,udelIndDRSP,13,1000,787,213,1.13895216400911,2.34065934065934,0.0200953330724695
2009,University of Delaware,udelIndDRSP,14,1000,964,36,1.0183299389002,2,1.42534763528454e-06
2009,University of Delaware,udelIndDRSP,15,1000,926,74,1.03842159916926,2,0.0179762058029986
2009,University of Delaware,udelIndDRSP,16,1000,959,41,1.02145045965271,2.05,4.61969935368056e-05
2009,University of Delaware,udelIndDRSP,17,1000,970,30,1.01522842639594,2,1.40956934040747e-19
2009,University of Delaware,udelIndDRSP,18,1000,898,102,1.05596620908131,2.08163265306122,1.70295824202543e-15
2009,University of Delaware,udelIndDRSP,19,1000,879,121,1.06609808102345,2.05084745762712,2.2788877373106e-07
2009,University of Delaware,udelIndDRSP,20,1000,952,48,1.02459016393443,2,0.0603164756799638
2009,University of Delaware,udelIndDRSP,21,1000,945,55,1.03092783505155,2.2,6.87167601032897e-11
2009,University of Delaware,udelIndDRSP,22,1000,950,50,1.03199174406605,2.63157894736842,1.46678926228414e-11
2009,University of Delaware,udelIndDRSP,23,1000,782,218,1.15207373271889,2.53488372093023,0.000742757856679645
2009,University of Delaware,udelIndDRSP,24,1000,962,38,1.01936799184506,2,0.00428041698113707
2009,University of Delaware,udelIndDRSP,25,1000,881,119,1.06382978723404,2.01694915254237,0.102643807689216
2009,University of Delaware,udelIndDRSP,26,1000,969,31,1.01626016260163,2.06666666666667,6.3009787928154e-19
2009,University of Delaware,udelIndDRSP,27,1000,980,20,1.01010101010101,2,3.45997557073127e-10
2009,University of Delaware,udelIndDRSP,28,1000,914,86,1.04602510460251,2.04761904761905,0.00579260905064525
2009,University of Delaware,udelIndDRSP,29,1000,976,24,1.01214574898785,2,3.89954631017984e-16
2009,University of Delaware,udelIndDRSP,30,1000,962,38,1.01936799184506,2,2.84599577251601e-09
2009,University of Delaware,udelIndDRSP,31,1000,920,80,1.04275286757039,2.05128205128205,0.0457653668781461
2009,University of Delaware,udelIndDRSP,32,1000,961,39,1.02040816326531,2.05263157894737,8.28824180752055e-08
2009,University of Delaware,udelIndDRSP,33,1000,978,22,1.01112234580384,2,8.54657315795967e-06
2009,University of Delaware,udelIndDRSP,34,1000,962,38,1.02669404517454,3.16666666666667,8.21216265551494e-31
2009,University of Delaware,udelIndDRSP,35,1000,904,96,1.05596620908131,2.23255813953488,0.0102320127704318
2009,University of Delaware,udelIndDRSP,36,1000,981,19,1.01010101010101,2.11111111111111,1.05513245930465e-05
2009,University of Delaware,udelIndDRSP,37,1000,741,259,1.16959064327485,2.2719298245614,4.15101551011161e-05
2009,University of Delaware,udelIndDRSP,38,1000,959,41,1.02145045965271,2.05,0.0015882813829399
2009,University of Delaware,udelIndDRSP,39,1000,933,67,1.0351966873706,2.03030303030303,0.00059668672127259
2009,University of Delaware,udelIndDRSP,40,1000,410,590,1.6260162601626,2.87804878048781,2.94839148972633e-09
2009,University of Delaware,udelIndDRSP,41,1000,972,28,1.01419878296146,2,4.19215332024328e-25
2009,University of Delaware,udelIndDRSP,42,1000,871,129,1.09051254089422,2.80434782608696,0.00072202066132401
2009,University of Delaware,udelIndDRSP,43,1000,956,44,1.02249488752556,2,0.190096489802597
2009,University of Delaware,udelIndDRSP,44,1000,919,81,1.04384133611691,2.07692307692308,0.0307161895385484
2009,University of Delaware,udelIndDRSP,45,1000,949,51,1.02669404517454,2.04,0.000278552710097484
2009,University of Delaware,udelIndDRSP,46,1000,905,95,1.0515247108307,2.06521739130435,0.000276559885466609
2009,University of Delaware,udelIndDRSP,47,1000,987,13,1.00704934541793,2.16666666666667,4.95956625938614e-14
2009,University of Delaware,udelIndDRSP,48,1000,876,124,1.06951871657754,2.10169491525424,2.80144304893603e-07
2009,University of Delaware,udelIndDRSP,49,1000,885,115,1.06723585912487,2.21153846153846,0.0421516434884877
2009,University of Delaware,udelIndDRSP,50,1000,933,67,1.0351966873706,2.03030303030303,8.54657282723107e-06
2009,University of Glasgow Terrier Team,uogTrdphA,1,1000,759,241,1.16414435389988,2.41,0.267900018654478
2009,University of Glasgow Terrier Team,uogTrdphA,2,1000,846,154,1.09409190371991,2.26470588235294,0.0216145141850324
2009,University of Glasgow Terrier Team,uogTrdphA,3,1000,854,146,1.08459869848156,2.14705882352941,0.111893376191189
2009,University of Glasgow Terrier Team,uogTrdphA,4,1000,818,182,1.12359550561798,2.52777777777778,0.29991711823491
2009,University of Glasgow Terrier Team,uogTrdphA,5,1000,834,166,1.09769484083425,2.15584415584416,0.00888966042069545
2009,University of Glasgow Terrier Team,uogTrdphA,6,1000,724,276,1.19904076738609,2.50909090909091,0.0869315379563219
2009,University of Glasgow Terrier Team,uogTrdphA,7,1000,926,74,1.04602510460251,2.46666666666667,0.00206914866352498
2009,University of Glasgow Terrier Team,uogTrdphA,8,1000,888,112,1.06496272630458,2.19607843137255,5.63844979974902e-07
2009,University of Glasgow Terrier Team,uogTrdphA,9,1000,919,81,1.05932203389831,3.24,1.8830424581936e-06
2009,University of Glasgow Terrier Team,uogTrdphA,10,1000,833,167,1.10864745011086,2.42028985507246,0.0119439051837379
2009,University of Glasgow Terrier Team,uogTrdphA,11,1000,860,140,1.08108108108108,2.15384615384615,0.0222875395353139
2009,University of Glasgow Terrier Team,uogTrdphA,12,1000,887,113,1.06157112526539,2.05454545454545,3.00992271020933e-06
2009,University of Glasgow Terrier Team,uogTrdphA,13,1000,887,113,1.06157112526539,2.05454545454545,0.0679165078268867
2009,University of Glasgow Terrier Team,uogTrdphA,14,1000,866,134,1.07758620689655,2.16129032258065,0.156228328704757
2009,University of Glasgow Terrier Team,uogTrdphA,15,1000,783,217,1.16009280742459,2.74683544303797,0.0924501072164288
2009,University of Glasgow Terrier Team,uogTrdphA,16,1000,735,265,1.15606936416185,2.03846153846154,0.148326505146142
2009,University of Glasgow Terrier Team,uogTrdphA,17,1000,943,57,1.03092783505155,2.11111111111111,0.000855373048441388
2009,University of Glasgow Terrier Team,uogTrdphA,18,1000,937,63,1.0351966873706,2.17241379310345,0.00270416346265687
2009,University of Glasgow Terrier Team,uogTrdphA,19,1000,848,152,1.08932461873638,2.17142857142857,0.191089677821464
2009,University of Glasgow Terrier Team,uogTrdphA,20,1000,875,125,1.0752688172043,2.27272727272727,0.176483839570945
2009,University of Glasgow Terrier Team,uogTrdphA,21,1000,904,96,1.06269925611052,2.59459459459459,3.57667017310708e-06
2009,University of Glasgow Terrier Team,uogTrdphA,22,1000,958,42,1.02249488752556,2.1,1.9551819104202e-06
2009,University of Glasgow Terrier Team,uogTrdphA,23,1000,554,446,1.68634064080944,11.4358974358974,2.60531197921367e-08
2009,University of Glasgow Terrier Team,uogTrdphA,24,1000,846,154,1.08813928182807,2.10958904109589,0.000882506780501447
2009,University of Glasgow Terrier Team,uogTrdphA,25,1000,738,262,1.18483412322275,2.47169811320755,0.246291346207679
2009,University of Glasgow Terrier Team,uogTrdphA,26,1000,921,79,1.04493207941484,2.19444444444444,0.17100560150261
2009,University of Glasgow Terrier Team,uogTrdphA,27,1000,905,95,1.05596620908131,2.26190476190476,0.471046885763765
2009,University of Glasgow Terrier Team,uogTrdphA,28,1000,736,264,1.21951219512195,3.14285714285714,0.291142871040158
2009,University of Glasgow Terrier Team,uogTrdphA,29,1000,917,83,1.05596620908131,2.76666666666667,0.000744916479434354
2009,University of Glasgow Terrier Team,uogTrdphA,30,1000,853,147,1.08225108225108,2.07042253521127,0.123838401033452
2009,University of Glasgow Terrier Team,uogTrdphA,31,1000,791,209,1.14155251141553,2.45882352941177,0.0206186387809407
2009,University of Glasgow Terrier Team,uogTrdphA,32,1000,799,201,1.12612612612613,2.25842696629214,0.427288425017962
2009,University of Glasgow Terrier Team,uogTrdphA,33,1000,930,70,1.03950103950104,2.1875,6.71351258114249e-08
2009,University of Glasgow Terrier Team,uogTrdphA,34,1000,962,38,1.01936799184506,2,0.00227481356571016
2009,University of Glasgow Terrier Team,uogTrdphA,35,1000,760,240,1.16009280742459,2.35294117647059,0.420137968502134
2009,University of Glasgow Terrier Team,uogTrdphA,36,1000,930,70,1.03842159916926,2.12121212121212,0.0274324095859744
2009,University of Glasgow Terrier Team,uogTrdphA,37,1000,923,77,1.04493207941484,2.26470588235294,0.00385235987991006
2009,University of Glasgow Terrier Team,uogTrdphA,38,1000,879,121,1.06951871657754,2.16071428571429,0.0175866840047532
2009,University of Glasgow Terrier Team,uogTrdphA,39,1000,896,104,1.06496272630458,2.41860465116279,0.0344633084220048
2009,University of Glasgow Terrier Team,uogTrdphA,40,171,157,14,1.04268292682927,2,0.226943576713755
2009,University of Glasgow Terrier Team,uogTrdphA,41,1000,839,161,1.10497237569061,2.43939393939394,0.0256705846916199
2009,University of Glasgow Terrier Team,uogTrdphA,42,1000,930,70,1.03842159916926,2.12121212121212,0.0434692306696922
2009,University of Glasgow Terrier Team,uogTrdphA,43,1000,912,88,1.05042016806723,2.2,0.1032421073782
2009,University of Glasgow Terrier Team,uogTrdphA,44,1000,863,137,1.08813928182807,2.44642857142857,0.325117297051697
2009,University of Glasgow Terrier Team,uogTrdphA,45,1000,892,108,1.06269925611052,2.20408163265306,5.08665025697464e-06
2009,University of Glasgow Terrier Team,uogTrdphA,46,1000,859,141,1.10741971207087,3.20454545454545,0.0220549981725846
2009,University of Glasgow Terrier Team,uogTrdphA,47,1000,924,76,1.04275286757039,2.17142857142857,0.379240504510068
2009,University of Glasgow Terrier Team,uogTrdphA,48,1000,863,137,1.09170305676856,2.58490566037736,0.000881613231943889
2009,University of Glasgow Terrier Team,uogTrdphA,49,1000,852,148,1.09051254089422,2.27692307692308,0.369492639032653
2009,University of Glasgow Terrier Team,uogTrdphA,50,1000,952,48,1.02459016393443,2,0.000642464929366002
2009,University of Glasgow Terrier Team,uogTrdphCEwP,1,1000,901,99,1.06044538706257,2.35714285714286,0.598876526803167
2009,University of Glasgow Terrier Team,uogTrdphCEwP,2,1000,850,150,1.08695652173913,2.14285714285714,0.0613936123152283
2009,University of Glasgow Terrier Team,uogTrdphCEwP,3,1000,794,206,1.13765642775882,2.42352941176471,0.338031849356427
2009,University of Glasgow Terrier Team,uogTrdphCEwP,4,1000,857,143,1.09409190371991,2.50877192982456,0.266581767343607
2009,University of Glasgow Terrier Team,uogTrdphCEwP,5,1000,799,201,1.13250283125708,2.39285714285714,0.0419710683526719
2009,University of Glasgow Terrier Team,uogTrdphCEwP,6,1000,670,330,1.24843945068664,2.51908396946565,0.239783529512595
2009,University of Glasgow Terrier Team,uogTrdphCEwP,7,1000,899,101,1.06496272630458,2.525,0.118066698735068
2009,University of Glasgow Terrier Team,uogTrdphCEwP,8,1000,771,229,1.15740740740741,2.46236559139785,0.0247075571093805
2009,University of Glasgow Terrier Team,uogTrdphCEwP,9,1000,843,157,1.12739571589628,3.56818181818182,0.470895869154976
2009,University of Glasgow Terrier Team,uogTrdphCEwP,10,1000,916,84,1.04602510460251,2.1,0.0637279160636546
2009,University of Glasgow Terrier Team,uogTrdphCEwP,11,1000,858,142,1.08342361863489,2.18461538461538,0.0568211450098991
2009,University of Glasgow Terrier Team,uogTrdphCEwP,12,1000,960,40,1.02040816326531,2,1.00900389190201e-07
2009,University of Glasgow Terrier Team,uogTrdphCEwP,13,1000,750,250,1.20772946859903,3.20512820512821,0.0180414497854842
2009,University of Glasgow Terrier Team,uogTrdphCEwP,14,1000,820,180,1.11482720178372,2.33766233766234,0.305428039133844
2009,University of Glasgow Terrier Team,uogTrdphCEwP,15,1000,817,183,1.11731843575419,2.34615384615385,0.364316301942512
2009,University of Glasgow Terrier Team,uogTrdphCEwP,16,1000,752,248,1.14678899082569,2.06666666666667,0.241711459126262
2009,University of Glasgow Terrier Team,uogTrdphCEwP,17,1000,962,38,1.02040816326531,2.11111111111111,0.0907380973493934
2009,University of Glasgow Terrier Team,uogTrdphCEwP,18,1000,892,108,1.06269925611052,2.20408163265306,0.127600435937289
2009,University of Glasgow Terrier Team,uogTrdphCEwP,19,1000,801,199,1.12866817155756,2.34117647058824,0.122084210702287
2009,University of Glasgow Terrier Team,uogTrdphCEwP,20,1000,878,122,1.07066381156317,2.17857142857143,0.205960750245017
2009,University of Glasgow Terrier Team,uogTrdphCEwP,21,1000,912,88,1.06044538706257,2.83870967741936,0.00187356886668479
2009,University of Glasgow Terrier Team,uogTrdphCEwP,22,1000,951,49,1.02774922918808,2.22727272727273,0.00590246786349265
2009,University of Glasgow Terrier Team,uogTrdphCEwP,23,1000,807,193,1.16009280742459,3.50909090909091,0.792771019702934
2009,University of Glasgow Terrier Team,uogTrdphCEwP,24,1000,869,131,1.07642626480086,2.18333333333333,0.00229530762602736
2009,University of Glasgow Terrier Team,uogTrdphCEwP,25,1000,718,282,1.19904076738609,2.43103448275862,0.105995943125442
2009,University of Glasgow Terrier Team,uogTrdphCEwP,26,1000,876,124,1.07181136120043,2.17543859649123,0.139515586017593
2009,University of Glasgow Terrier Team,uogTrdphCEwP,27,1000,883,117,1.07642626480086,2.54347826086957,0.331556171277485
2009,University of Glasgow Terrier Team,uogTrdphCEwP,28,1000,700,300,1.25470514429109,3.09278350515464,0.43245041551326
2009,University of Glasgow Terrier Team,uogTrdphCEwP,29,1000,842,158,1.11482720178372,2.87272727272727,0.220226716094824
2009,University of Glasgow Terrier Team,uogTrdphCEwP,30,1000,832,168,1.09649122807018,2.1,0.384163343719734
2009,University of Glasgow Terrier Team,uogTrdphCEwP,31,1000,798,202,1.13765642775882,2.49382716049383,0.00241470566094254
2009,University of Glasgow Terrier Team,uogTrdphCEwP,32,1000,781,219,1.1454753722795,2.3804347826087,0.113651905639262
2009,University of Glasgow Terrier Team,uogTrdphCEwP,33,1000,955,45,1.02459016393443,2.14285714285714,0.000487202904957221
2009,University of Glasgow Terrier Team,uogTrdphCEwP,34,1000,960,40,1.02459016393443,2.5,0.00475599545949072
2009,University of Glasgow Terrier Team,uogTrdphCEwP,35,1000,746,254,1.17096018735363,2.35185185185185,0.452315386113982
2009,University of Glasgow Terrier Team,uogTrdphCEwP,36,1000,913,87,1.05042016806723,2.23076923076923,0.286252030426067
2009,University of Glasgow Terrier Team,uogTrdphCEwP,37,1000,858,142,1.09649122807018,2.62962962962963,0.0982851766886529
2009,University of Glasgow Terrier Team,uogTrdphCEwP,38,1000,871,129,1.0752688172043,2.1864406779661,0.017831192647276
2009,University of Glasgow Terrier Team,uogTrdphCEwP,39,1000,867,133,1.08342361863489,2.375,0.231545576088873
2009,University of Glasgow Terrier Team,uogTrdphCEwP,40,171,150,21,1.06875,2.1,0.303199920692035
2009,University of Glasgow Terrier Team,uogTrdphCEwP,41,1000,792,208,1.15473441108545,2.81081081081081,0.0483029882927158
2009,University of Glasgow Terrier Team,uogTrdphCEwP,42,1000,913,87,1.0482180293501,2.1219512195122,0.00385735897572713
2009,University of Glasgow Terrier Team,uogTrdphCEwP,43,1000,879,121,1.07066381156317,2.2,0.485219533643619
2009,University of Glasgow Terrier Team,uogTrdphCEwP,44,1000,857,143,1.09529025191676,2.55357142857143,0.585992971117991
2009,University of Glasgow Terrier Team,uogTrdphCEwP,45,1000,861,139,1.08813928182807,2.39655172413793,0.000811038921301655
2009,University of Glasgow Terrier Team,uogTrdphCEwP,46,1000,864,136,1.09289617486339,2.66666666666667,0.350645693733706
2009,University of Glasgow Terrier Team,uogTrdphCEwP,47,1000,933,67,1.03734439834025,2.16129032258065,0.269670566110567
2009,University of Glasgow Terrier Team,uogTrdphCEwP,48,1000,773,227,1.16414435389988,2.63953488372093,0.235716852970244
2009,University of Glasgow Terrier Team,uogTrdphCEwP,49,1000,772,228,1.15473441108545,2.42553191489362,0.43011210321701
2009,University of Glasgow Terrier Team,uogTrdphCEwP,50,1000,926,74,1.04712041884817,2.55172413793103,0.00149248181810084
2009,University of Glasgow Terrier Team,uogTrdphP,1,1000,737,263,1.18623962040332,2.4811320754717,0.445054337829688
2009,University of Glasgow Terrier Team,uogTrdphP,2,1000,846,154,1.0989010989011,2.40625,0.00149548542759854
2009,University of Glasgow Terrier Team,uogTrdphP,3,1000,897,103,1.05932203389831,2.19148936170213,0.0149492099401064
2009,University of Glasgow Terrier Team,uogTrdphP,4,1000,897,103,1.06044538706257,2.23913043478261,0.0457491782335329
2009,University of Glasgow Terrier Team,uogTrdphP,5,1000,827,173,1.11358574610245,2.43661971830986,0.12703266772808
2009,University of Glasgow Terrier Team,uogTrdphP,6,1000,674,326,1.21802679658953,2.21768707482993,0.229793325523017
2009,University of Glasgow Terrier Team,uogTrdphP,7,1000,479,521,1.65016501650165,4.10236220472441,0.407316897251398
2009,University of Glasgow Terrier Team,uogTrdphP,8,1000,919,81,1.04602510460251,2.18918918918919,0.000116701307608806
2009,University of Glasgow Terrier Team,uogTrdphP,9,1000,930,70,1.04493207941484,2.59259259259259,0.000522944472571785
2009,University of Glasgow Terrier Team,uogTrdphP,10,1000,916,84,1.04602510460251,2.1,0.107919467163963
2009,University of Glasgow Terrier Team,uogTrdphP,11,1000,832,168,1.10987791342952,2.43478260869565,0.174187103115935
2009,University of Glasgow Terrier Team,uogTrdphP,12,1000,679,321,1.21654501216545,2.24475524475524,1.97907103068823e-05
2009,University of Glasgow Terrier Team,uogTrdphP,13,1000,895,105,1.06157112526539,2.23404255319149,0.000642304296904594
2009,University of Glasgow Terrier Team,uogTrdphP,14,1000,795,205,1.1454753722795,2.62820512820513,0.0296388448450758
2009,University of Glasgow Terrier Team,uogTrdphP,15,1000,864,136,1.08932461873638,2.51851851851852,0.0998711007901317
2009,University of Glasgow Terrier Team,uogTrdphP,16,1000,743,257,1.18063754427391,2.47115384615385,0.0357817359099408
2009,University of Glasgow Terrier Team,uogTrdphP,17,1000,960,40,1.02564102564103,2.66666666666667,9.46032233151209e-21
2009,University of Glasgow Terrier Team,uogTrdphP,18,1000,839,161,1.1001100110011,2.3,0.005557921462237
2009,University of Glasgow Terrier Team,uogTrdphP,19,1000,734,266,1.20918984280532,2.86021505376344,0.0142365383807898
2009,University of Glasgow Terrier Team,uogTrdphP,20,1000,866,134,1.08225108225108,2.31034482758621,0.227742744587481
2009,University of Glasgow Terrier Team,uogTrdphP,21,1000,929,71,1.04058272632674,2.21875,0.0125273039092858
2009,University of Glasgow Terrier Team,uogTrdphP,22,1000,932,68,1.03626943005181,2.06060606060606,0.000524513344400692
2009,University of Glasgow Terrier Team,uogTrdphP,23,1000,938,62,1.03305785123967,2.06666666666667,3.79019271643404e-07
2009,University of Glasgow Terrier Team,uogTrdphP,24,1000,773,227,1.14810562571757,2.31632653061225,0.0291713018031803
2009,University of Glasgow Terrier Team,uogTrdphP,25,1000,748,252,1.19047619047619,2.73913043478261,0.105795147734496
2009,University of Glasgow Terrier Team,uogTrdphP,26,1000,834,166,1.10253583241455,2.27397260273973,0.0260175314530371
2009,University of Glasgow Terrier Team,uogTrdphP,27,1000,881,119,1.06951871657754,2.2037037037037,0.387445664060611
2009,University of Glasgow Terrier Team,uogTrdphP,28,1000,614,386,1.50375939849624,7.56862745098039,0.0177327257626999
2009,University of Glasgow Terrier Team,uogTrdphP,29,1000,886,114,1.07181136120043,2.42553191489362,1.13618519857024e-14
2009,University of Glasgow Terrier Team,uogTrdphP,30,1000,769,231,1.14942528735632,2.28712871287129,0.0767098898475797
2009,University of Glasgow Terrier Team,uogTrdphP,31,1000,792,208,1.13895216400911,2.41860465116279,0.00848860432402585
2009,University of Glasgow Terrier Team,uogTrdphP,32,1000,822,178,1.12994350282486,2.82539682539683,0.510252691826157
2009,University of Glasgow Terrier Team,uogTrdphP,33,1000,955,45,1.02669404517454,2.36842105263158,1.07578537372109e-11
2009,University of Glasgow Terrier Team,uogTrdphP,34,1000,944,56,1.04058272632674,3.29411764705882,3.31129010125847e-09
2009,University of Glasgow Terrier Team,uogTrdphP,35,1000,675,325,1.25156445556946,2.62096774193548,0.357351908393367
2009,University of Glasgow Terrier Team,uogTrdphP,36,1000,875,125,1.09170305676856,3.04878048780488,8.32482663800054e-05
2009,University of Glasgow Terrier Team,uogTrdphP,37,1000,863,137,1.08695652173913,2.40350877192982,0.00238106573253626
2009,University of Glasgow Terrier Team,uogTrdphP,38,1000,890,110,1.06951871657754,2.44444444444444,0.000421609103326232
2009,University of Glasgow Terrier Team,uogTrdphP,39,1000,940,60,1.03305785123967,2.14285714285714,3.2110355549401e-08
2009,University of Glasgow Terrier Team,uogTrdphP,40,1000,309,691,2.63157894736842,9.73239436619718,0.157866893419035
2009,University of Glasgow Terrier Team,uogTrdphP,41,1000,761,239,1.16550116550117,2.4639175257732,0.00503268580642186
2009,University of Glasgow Terrier Team,uogTrdphP,42,1000,901,99,1.06723585912487,2.75,9.84905253300343e-05
2009,University of Glasgow Terrier Team,uogTrdphP,43,1000,889,111,1.06723585912487,2.3125,0.00134922172033755
2009,University of Glasgow Terrier Team,uogTrdphP,44,1000,784,216,1.19331742243437,4,0.0207896079350336
2009,University of Glasgow Terrier Team,uogTrdphP,45,1000,896,104,1.06157112526539,2.26086956521739,0.0699110202585217
2009,University of Glasgow Terrier Team,uogTrdphP,46,1000,680,320,1.21506682867558,2.23776223776224,0.0353369795706041
2009,University of Glasgow Terrier Team,uogTrdphP,47,1000,874,126,1.08342361863489,2.57142857142857,0.0744486333550137
2009,University of Glasgow Terrier Team,uogTrdphP,48,1000,878,122,1.07411385606874,2.30188679245283,0.000578309324792022
2009,University of Glasgow Terrier Team,uogTrdphP,49,1000,817,183,1.11731843575419,2.34615384615385,0.0187449197878865
2009,University of Glasgow Terrier Team,uogTrdphP,50,1000,854,146,1.10132158590308,2.7037037037037,0.147652209235468
2009,University of Amsterdam (De Rijke),uvaee,1,1000,852,148,1.10619469026549,2.84615384615385,0.602585189344378
2009,University of Amsterdam (De Rijke),uvaee,2,1000,942,58,1.03626943005181,2.52173913043478,4.08942037640164e-06
2009,University of Amsterdam (De Rijke),uvaee,3,1000,906,94,1.05596620908131,2.29268292682927,0.0028130359424094
2009,University of Amsterdam (De Rijke),uvaee,4,1000,851,149,1.12612612612613,4.02702702702703,0.025013126947575
2009,University of Amsterdam (De Rijke),uvaee,5,1000,897,103,1.05932203389831,2.19148936170213,0.00349876377605606
2009,University of Amsterdam (De Rijke),uvaee,6,1000,827,173,1.10619469026549,2.24675324675325,0.109777974651518
2009,University of Amsterdam (De Rijke),uvaee,7,1000,867,133,1.09170305676856,2.71428571428571,4.36335637886377e-08
2009,University of Amsterdam (De Rijke),uvaee,8,1000,906,94,1.05932203389831,2.47368421052632,0.190002781569781
2009,University of Amsterdam (De Rijke),uvaee,9,1000,939,61,1.03842159916926,2.54166666666667,0.618958855704446
2009,University of Amsterdam (De Rijke),uvaee,10,1000,888,112,1.06269925611052,2.11320754716981,0.0138956047590152
2009,University of Amsterdam (De Rijke),uvaee,11,1000,856,144,1.10253583241455,2.82352941176471,0.137680764745057
2009,University of Amsterdam (De Rijke),uvaee,12,1000,914,86,1.05042016806723,2.26315789473684,0.246238897960376
2009,University of Amsterdam (De Rijke),uvaee,13,1000,747,253,1.26262626262626,5.62222222222222,7.72868002660172e-06
2009,University of Amsterdam (De Rijke),uvaee,14,1000,817,183,1.15340253748558,3.66,0.0778539589592899
2009,University of Amsterdam (De Rijke),uvaee,15,1000,901,99,1.05708245243129,2.2,0.0460923624033318
2009,University of Amsterdam (De Rijke),uvaee,16,1000,921,79,1.04275286757039,2.07894736842105,2.94737207955135e-05
2009,University of Amsterdam (De Rijke),uvaee,17,1000,966,34,1.01936799184506,2.26666666666667,2.45113315180278e-05
2009,University of Amsterdam (De Rijke),uvaee,18,1000,934,66,1.0351966873706,2.0625,0.0136406759976505
2009,University of Amsterdam (De Rijke),uvaee,19,1000,908,92,1.06044538706257,2.62857142857143,3.03803448036001e-05
2009,University of Amsterdam (De Rijke),uvaee,20,1000,909,91,1.06382978723404,2.93548387096774,0.030549155853564
2009,University of Amsterdam (De Rijke),uvaee,21,1000,938,62,1.04166666666667,2.81818181818182,5.52294993944479e-07
2009,University of Amsterdam (De Rijke),uvaee,22,1000,936,64,1.0351966873706,2.13333333333333,0.0536621650528155
2009,University of Amsterdam (De Rijke),uvaee,23,1000,929,71,1.04166666666667,2.29032258064516,0.000475889016179334
2009,University of Amsterdam (De Rijke),uvaee,24,1000,863,137,1.08108108108108,2.20967741935484,9.62613428604793e-06
2009,University of Amsterdam (De Rijke),uvaee,25,1000,881,119,1.085776330076,2.975,0.155780193078471
2009,University of Amsterdam (De Rijke),uvaee,26,1000,894,106,1.06269925611052,2.25531914893617,0.020575673638592
2009,University of Amsterdam (De Rijke),uvaee,27,1000,953,47,1.02669404517454,2.23809523809524,0.000373007951519358
2009,University of Amsterdam (De Rijke),uvaee,28,1000,611,389,1.46842878120411,5.55714285714286,0.000857509154685987
2009,University of Amsterdam (De Rijke),uvaee,29,1000,911,89,1.05932203389831,2.6969696969697,5.74193978376548e-09
2009,University of Amsterdam (De Rijke),uvaee,30,1000,935,65,1.03734439834025,2.24137931034483,4.03391627981425e-05
2009,University of Amsterdam (De Rijke),uvaee,31,1000,891,109,1.07066381156317,2.53488372093023,0.0367978874732945
2009,University of Amsterdam (De Rijke),uvaee,32,1000,853,147,1.08695652173913,2.19402985074627,0.145657103460985
2009,University of Amsterdam (De Rijke),uvaee,33,1000,971,29,1.01626016260163,2.23076923076923,4.0895319731974e-06
2009,University of Amsterdam (De Rijke),uvaee,34,1000,924,76,1.04384133611691,2.23529411764706,0.0721461882869981
2009,University of Amsterdam (De Rijke),uvaee,35,1000,869,131,1.07991360691145,2.29824561403509,0.051519434613196
2009,University of Amsterdam (De Rijke),uvaee,36,1000,932,68,1.03950103950104,2.26666666666667,3.42789871934807e-05
2009,University of Amsterdam (De Rijke),uvaee,37,1000,890,110,1.06723585912487,2.34042553191489,0.0736829089492373
2009,University of Amsterdam (De Rijke),uvaee,38,1000,922,78,1.04275286757039,2.10810810810811,0.0170052673580575
2009,University of Amsterdam (De Rijke),uvaee,39,1000,924,76,1.03950103950104,2,0.0154916510717076
2009,University of Amsterdam (De Rijke),uvaee,40,1000,529,471,1.46627565982405,3.07843137254902,0.00231170246570054
2009,University of Amsterdam (De Rijke),uvaee,41,1000,898,102,1.06723585912487,2.61538461538462,3.32906331892434e-07
2009,University of Amsterdam (De Rijke),uvaee,42,1000,905,95,1.06382978723404,2.71428571428571,0.00348699746485483
2009,University of Amsterdam (De Rijke),uvaee,43,1000,934,66,1.04166666666667,2.53846153846154,0.0585957910244015
2009,University of Amsterdam (De Rijke),uvaee,44,1000,841,159,1.13250283125708,3.78571428571429,1.48762530512313e-05
2009,University of Amsterdam (De Rijke),uvaee,45,1000,959,41,1.02564102564103,2.5625,8.0520814678443e-05
2009,University of Amsterdam (De Rijke),uvaee,46,1000,803,197,1.11982082866741,2.18888888888889,0.0385599083133036
2009,University of Amsterdam (De Rijke),uvaee,47,1000,935,65,1.04275286757039,2.70833333333333,0.00142448749438102
2009,University of Amsterdam (De Rijke),uvaee,48,1000,874,126,1.08225108225108,2.52,0.0207896258160098
2009,University of Amsterdam (De Rijke),uvaee,49,1000,891,109,1.06837606837607,2.42222222222222,0.0140235985930412
2009,University of Amsterdam (De Rijke),uvaee,50,1000,932,68,1.04166666666667,2.42857142857143,1.19862381594155e-08
2009,University of Amsterdam (De Rijke),uvamrf,1,1000,669,331,1.27713920817369,2.90350877192982,0.272691063155048
2009,University of Amsterdam (De Rijke),uvamrf,2,1000,927,73,1.04493207941484,2.43333333333333,0.000290544896350456
2009,University of Amsterdam (De Rijke),uvamrf,3,1000,778,222,1.16550116550117,2.775,2.78391539722737e-07
2009,University of Amsterdam (De Rijke),uvamrf,4,1000,866,134,1.11607142857143,4.46666666666667,0.098403595000514
2009,University of Amsterdam (De Rijke),uvamrf,5,1000,811,189,1.12612612612613,2.45454545454545,0.271224827913383
2009,University of Amsterdam (De Rijke),uvamrf,6,1000,813,187,1.11731843575419,2.28048780487805,2.54222996769551e-05
2009,University of Amsterdam (De Rijke),uvamrf,7,1000,620,380,1.36612021857924,3.39285714285714,0.00063218962761568
2009,University of Amsterdam (De Rijke),uvamrf,8,1000,831,169,1.12739571589628,3.01785714285714,0.191278719494141
2009,University of Amsterdam (De Rijke),uvamrf,9,1000,929,71,1.0482180293501,2.84,0.217081979540768
2009,University of Amsterdam (De Rijke),uvamrf,10,1000,917,83,1.04493207941484,2.075,5.90867821019736e-05
2009,University of Amsterdam (De Rijke),uvamrf,11,1000,811,189,1.15074798619102,3.25862068965517,0.206261335129187
2009,University of Amsterdam (De Rijke),uvamrf,12,1000,748,252,1.16550116550117,2.29090909090909,0.124018888763645
2009,University of Amsterdam (De Rijke),uvamrf,13,1000,735,265,1.27226463104326,5.19607843137255,2.39699077406069e-05
2009,University of Amsterdam (De Rijke),uvamrf,14,1000,825,175,1.12612612612613,2.77777777777778,0.0751526516514983
2009,University of Amsterdam (De Rijke),uvamrf,15,1000,936,64,1.03950103950104,2.46153846153846,1.5709235605854e-08
2009,University of Amsterdam (De Rijke),uvamrf,16,1000,872,128,1.08225108225108,2.46153846153846,0.00579976389681583
2009,University of Amsterdam (De Rijke),uvamrf,17,1000,968,32,1.0183299389002,2.28571428571429,1.45404377191979e-10
2009,University of Amsterdam (De Rijke),uvamrf,18,1000,920,80,1.04712041884817,2.28571428571429,4.47282887568891e-07
2009,University of Amsterdam (De Rijke),uvamrf,19,1000,907,93,1.05932203389831,2.51351351351351,0.000119502136064483
2009,University of Amsterdam (De Rijke),uvamrf,20,1000,904,96,1.06723585912487,2.90909090909091,6.1099173711946e-06
2009,University of Amsterdam (De Rijke),uvamrf,21,1000,882,118,1.07411385606874,2.40816326530612,7.14701565643253e-06
2009,University of Amsterdam (De Rijke),uvamrf,22,1000,957,43,1.02354145342886,2.15,0.0230996943410704
2009,University of Amsterdam (De Rijke),uvamrf,23,1000,840,160,1.09769484083425,2.25352112676056,0.000269014289819724
2009,University of Amsterdam (De Rijke),uvamrf,24,1000,859,141,1.08813928182807,2.35,0.000129356687983728
2009,University of Amsterdam (De Rijke),uvamrf,25,1000,841,159,1.11111111111111,2.69491525423729,0.24595969322773
2009,University of Amsterdam (De Rijke),uvamrf,26,1000,912,88,1.05042016806723,2.2,0.00385235632340019
2009,University of Amsterdam (De Rijke),uvamrf,27,1000,936,64,1.03626943005181,2.20689655172414,7.03438560275803e-05
2009,University of Amsterdam (De Rijke),uvamrf,28,1000,897,103,1.06496272630458,2.45238095238095,0.0113889939285094
2009,University of Amsterdam (De Rijke),uvamrf,29,1000,930,70,1.03734439834025,2.05882352941176,3.81657326818724e-07
2009,University of Amsterdam (De Rijke),uvamrf,30,1000,890,110,1.06609808102345,2.29166666666667,0.124659145402867
2009,University of Amsterdam (De Rijke),uvamrf,31,1000,851,149,1.09529025191676,2.40322580645161,0.00318374907911915
2009,University of Amsterdam (De Rijke),uvamrf,32,1000,765,235,1.16686114352392,2.55434782608696,0.00861947458526948
2009,University of Amsterdam (De Rijke),uvamrf,33,1000,955,45,1.02669404517454,2.36842105263158,1.22221315746819e-11
2009,University of Amsterdam (De Rijke),uvamrf,34,1000,972,28,1.01522842639594,2.15384615384615,0.458655309576638
2009,University of Amsterdam (De Rijke),uvamrf,35,1000,864,136,1.08932461873638,2.51851851851852,0.0305412118864157
2009,University of Amsterdam (De Rijke),uvamrf,36,1000,940,60,1.03412616339193,2.22222222222222,0.00243125281563144
2009,University of Amsterdam (De Rijke),uvamrf,37,1000,875,125,1.07642626480086,2.31481481481482,0.000127676327736095
2009,University of Amsterdam (De Rijke),uvamrf,38,1000,930,70,1.04275286757039,2.41379310344828,2.58030535709962e-06
2009,University of Amsterdam (De Rijke),uvamrf,39,1000,954,46,1.02354145342886,2,0.0708063974710748
2009,University of Amsterdam (De Rijke),uvamrf,40,1000,529,471,1.46627565982405,3.07843137254902,0.00231170246570054
2009,University of Amsterdam (De Rijke),uvamrf,41,1000,587,413,1.38888888888889,3.10526315789474,0.000119376314848769
2009,University of Amsterdam (De Rijke),uvamrf,42,1000,907,93,1.06157112526539,2.65714285714286,0.0051888681114427
2009,University of Amsterdam (De Rijke),uvamrf,43,1000,931,69,1.04712041884817,2.875,0.104990966507422
2009,University of Amsterdam (De Rijke),uvamrf,44,1000,778,222,1.19760479041916,3.89473684210526,5.60741064453478e-06
2009,University of Amsterdam (De Rijke),uvamrf,45,1000,943,57,1.03305785123967,2.28,0.000822881194196813
2009,University of Amsterdam (De Rijke),uvamrf,46,1000,721,279,1.17508813160987,2.14615384615385,0.0171278460643719
2009,University of Amsterdam (De Rijke),uvamrf,47,1000,930,70,1.04602510460251,2.69230769230769,0.00173378936667617
2009,University of Amsterdam (De Rijke),uvamrf,48,1000,907,93,1.06609808102345,3,0.0001114825118415
2009,University of Amsterdam (De Rijke),uvamrf,49,1000,911,89,1.06044538706257,2.78125,0.0541027651010454
2009,University of Amsterdam (De Rijke),uvamrf,50,1000,937,63,1.04384133611691,3,0.00931108240151703
2009,University of Amsterdam (De Rijke),uvamrftop,1,1000,1000,0,1,,0
2009,University of Amsterdam (De Rijke),uvamrftop,2,1000,1000,0,1,,0
2009,University of Amsterdam (De Rijke),uvamrftop,3,1000,1000,0,1,,0
2009,University of Amsterdam (De Rijke),uvamrftop,4,1000,1000,0,1,,0
2009,University of Amsterdam (De Rijke),uvamrftop,5,1000,1000,0,1,,0
2009,University of Amsterdam (De Rijke),uvamrftop,6,1000,1000,0,1,,0
2009,University of Amsterdam (De Rijke),uvamrftop,7,1000,1000,0,1,,0
2009,University of Amsterdam (De Rijke),uvamrftop,8,1000,1000,0,1,,0
2009,University of Amsterdam (De Rijke),uvamrftop,9,1000,1000,0,1,,0
2009,University of Amsterdam (De Rijke),uvamrftop,10,1000,1000,0,1,,0
2009,University of Amsterdam (De Rijke),uvamrftop,11,1000,1000,0,1,,0
2009,University of Amsterdam (De Rijke),uvamrftop,12,1000,1000,0,1,,0
2009,University of Amsterdam (De Rijke),uvamrftop,13,1000,1000,0,1,,0
2009,University of Amsterdam (De Rijke),uvamrftop,14,1000,1000,0,1,,0
2009,University of Amsterdam (De Rijke),uvamrftop,15,1000,1000,0,1,,0
2009,University of Amsterdam (De Rijke),uvamrftop,16,1000,1000,0,1,,0
2009,University of Amsterdam (De Rijke),uvamrftop,17,1000,1000,0,1,,0
2009,University of Amsterdam (De Rijke),uvamrftop,18,1000,1000,0,1,,0
2009,University of Amsterdam (De Rijke),uvamrftop,19,1000,1000,0,1,,0
2009,University of Amsterdam (De Rijke),uvamrftop,20,1000,1000,0,1,,0
2009,University of Amsterdam (De Rijke),uvamrftop,21,1000,1000,0,1,,0
2009,University of Amsterdam (De Rijke),uvamrftop,22,1000,1000,0,1,,0
2009,University of Amsterdam (De Rijke),uvamrftop,23,1000,1000,0,1,,0
2009,University of Amsterdam (De Rijke),uvamrftop,24,1000,1000,0,1,,0
2009,University of Amsterdam (De Rijke),uvamrftop,25,1000,1000,0,1,,0
2009,University of Amsterdam (De Rijke),uvamrftop,26,1000,1000,0,1,,0
2009,University of Amsterdam (De Rijke),uvamrftop,27,1000,1000,0,1,,0
2009,University of Amsterdam (De Rijke),uvamrftop,28,1000,1000,0,1,,0
2009,University of Amsterdam (De Rijke),uvamrftop,29,1000,1000,0,1,,0
2009,University of Amsterdam (De Rijke),uvamrftop,30,1000,1000,0,1,,0
2009,University of Amsterdam (De Rijke),uvamrftop,31,1000,1000,0,1,,0
2009,University of Amsterdam (De Rijke),uvamrftop,32,1000,1000,0,1,,0
2009,University of Amsterdam (De Rijke),uvamrftop,33,1000,1000,0,1,,0
2009,University of Amsterdam (De Rijke),uvamrftop,34,1000,1000,0,1,,0
2009,University of Amsterdam (De Rijke),uvamrftop,35,1000,1000,0,1,,0
2009,University of Amsterdam (De Rijke),uvamrftop,36,1000,1000,0,1,,0
2009,University of Amsterdam (De Rijke),uvamrftop,37,1000,1000,0,1,,0
2009,University of Amsterdam (De Rijke),uvamrftop,38,1000,1000,0,1,,0
2009,University of Amsterdam (De Rijke),uvamrftop,39,1000,1000,0,1,,0
2009,University of Amsterdam (De Rijke),uvamrftop,40,1000,1000,0,1,,0
2009,University of Amsterdam (De Rijke),uvamrftop,41,1000,1000,0,1,,0
2009,University of Amsterdam (De Rijke),uvamrftop,42,1000,1000,0,1,,0
2009,University of Amsterdam (De Rijke),uvamrftop,43,1000,1000,0,1,,0
2009,University of Amsterdam (De Rijke),uvamrftop,44,1000,1000,0,1,,0
2009,University of Amsterdam (De Rijke),uvamrftop,45,1000,1000,0,1,,0
2009,University of Amsterdam (De Rijke),uvamrftop,46,1000,1000,0,1,,0
2009,University of Amsterdam (De Rijke),uvamrftop,47,1000,1000,0,1,,0
2009,University of Amsterdam (De Rijke),uvamrftop,48,1000,1000,0,1,,0
2009,University of Amsterdam (De Rijke),uvamrftop,49,1000,1000,0,1,,0
2009,University of Amsterdam (De Rijke),uvamrftop,50,1000,1000,0,1,,0
2009,University of Waterloo,watprf,1,1000,646,354,1.36798905608755,4.16470588235294,0.00354604477985992
2009,University of Waterloo,watprf,2,1000,729,271,1.23456790123457,3.34567901234568,0.0909493142911861
2009,University of Waterloo,watprf,3,1000,550,450,1.47058823529412,3.46153846153846,0.00678299207954415
2009,University of Waterloo,watprf,4,1000,718,282,1.23152709359606,3,0.205145925371314
2009,University of Waterloo,watprf,5,1000,644,356,1.34048257372654,3.49019607843137,0.0093212498307167
2009,University of Waterloo,watprf,6,1000,503,497,1.54083204930663,3.4041095890411,0.258216073646858
2009,University of Waterloo,watprf,7,1000,665,335,1.34408602150538,4.24050632911392,0.224749762674516
2009,University of Waterloo,watprf,8,1000,569,431,1.3986013986014,2.95205479452055,0.0975892814070668
2009,University of Waterloo,watprf,9,1000,493,507,1.67785234899329,4.92233009708738,0.345077025216787
2009,University of Waterloo,watprf,10,1000,580,420,1.44717800289436,3.78378378378378,0.140500349256828
2009,University of Waterloo,watprf,11,1000,653,347,1.27064803049555,2.58955223880597,0.286355329927688
2009,University of Waterloo,watprf,12,1000,773,227,1.15207373271889,2.38947368421053,0.513165191113044
2009,University of Waterloo,watprf,13,1000,902,98,1.05263157894737,2.04166666666667,0.00293725148879689
2009,University of Waterloo,watprf,14,1000,807,193,1.11856823266219,2.2183908045977,0.0079166525766335
2009,University of Waterloo,watprf,15,1000,889,111,1.06609808102345,2.26530612244898,0.0028422151964382
2009,University of Waterloo,watprf,16,1000,522,478,1.47275405007364,3.04458598726115,0.291865131222835
2009,University of Waterloo,watprf,17,1000,521,479,1.48809523809524,3.17218543046358,0.000447322792902774
2009,University of Waterloo,watprf,18,1000,603,397,1.33155792276964,2.68243243243243,0.556746039431192
2009,University of Waterloo,watprf,19,1000,559,441,1.48809523809524,3.90265486725664,0.0241901013486799
2009,University of Waterloo,watprf,20,1000,851,149,1.085776330076,2.12857142857143,0.0407663304716018
2009,University of Waterloo,watprf,21,1000,704,296,1.22100122100122,2.57391304347826,0.299056755575598
2009,University of Waterloo,watprf,22,1000,828,172,1.11358574610245,2.45714285714286,0.149517002122616
2009,University of Waterloo,watprf,23,1000,715,285,1.21212121212121,2.59090909090909,0.000173890298460368
2009,University of Waterloo,watprf,24,1000,710,290,1.24223602484472,3.05263157894737,0.30369553180875
2009,University of Waterloo,watprf,25,1000,566,434,1.42045454545455,3.14492753623188,0.473238112400994
2009,University of Waterloo,watprf,26,1000,382,618,2.01207243460765,5.37391304347826,0.425019244481333
2009,University of Waterloo,watprf,27,1000,599,401,1.43266475644699,4.05050505050505,0.00202415002711635
2009,University of Waterloo,watprf,28,1000,829,171,1.11607142857143,2.55223880597015,1.42614609293381e-08
2009,University of Waterloo,watprf,29,1000,717,283,1.23304562268804,3.01063829787234,0.497987676066106
2009,University of Waterloo,watprf,30,1000,625,375,1.31233595800525,2.73722627737226,0.01048413890376
2009,University of Waterloo,watprf,31,1000,827,173,1.11482720178372,2.47142857142857,0.00720225652733827
2009,University of Waterloo,watprf,32,1000,615,385,1.3531799729364,3.10483870967742,0.19031548329807
2009,University of Waterloo,watprf,33,1000,732,268,1.23609394313968,3.48051948051948,0.0011272791286579
2009,University of Waterloo,watprf,34,1000,616,384,1.40646976090014,4.0421052631579,0.111120392814338
2009,University of Waterloo,watprf,35,1000,617,383,1.40252454417952,3.98958333333333,0.0539998795303592
2009,University of Waterloo,watprf,36,1000,617,383,1.3351134846462,2.90151515151515,0.188553225584256
2009,University of Waterloo,watprf,37,1000,743,257,1.18764845605701,2.5959595959596,0.486803020386119
2009,University of Waterloo,watprf,38,1000,793,207,1.13378684807256,2.32584269662921,0.232039963009434
2009,University of Waterloo,watprf,39,1000,614,386,1.32978723404255,2.79710144927536,0.0802670720340831
2009,University of Waterloo,watprf,40,1000,741,259,1.19331742243437,2.67010309278351,0.0158852933697983
2009,University of Waterloo,watprf,41,1000,658,342,1.28369704749679,2.82644628099174,0.342848522348506
2009,University of Waterloo,watprf,42,1000,713,287,1.22850122850123,2.84158415841584,0.0975901559234923
2009,University of Waterloo,watprf,43,1000,839,161,1.10741971207087,2.515625,0.0109813582258393
2009,University of Waterloo,watprf,44,1000,337,663,2.10526315789474,4.80434782608696,0.00591014973803367
2009,University of Waterloo,watprf,45,1000,736,264,1.194743130227,2.61386138613861,0.170933105643936
2009,University of Waterloo,watprf,46,1000,809,191,1.1454753722795,2.984375,0.537229851180525
2009,University of Waterloo,watprf,47,1000,700,300,1.27713920817369,3.6144578313253,0.302309114973459
2009,University of Waterloo,watprf,48,1000,734,266,1.19760479041916,2.63366336633663,0.158081175966347
2009,University of Waterloo,watprf,49,1000,589,411,1.40252454417952,3.31451612903226,0.215149377750617
2009,University of Waterloo,watprf,50,1000,419,581,1.78571428571429,4.12056737588653,0.1092452683855
2009,University of Waterloo,watrrfw,1,1000,998,2,1.001001001001,2,3.44572641565647e-24
2009,University of Waterloo,watrrfw,2,1000,1000,0,1,,0
2009,University of Waterloo,watrrfw,3,1000,1000,0,1,,0
2009,University of Waterloo,watrrfw,4,1000,1000,0,1,,0
2009,University of Waterloo,watrrfw,5,1000,998,2,1.001001001001,2,3.60063512258297e-28
2009,University of Waterloo,watrrfw,6,1000,1000,0,1,,0
2009,University of Waterloo,watrrfw,7,1000,1000,0,1,,0
2009,University of Waterloo,watrrfw,8,1000,1000,0,1,,0
2009,University of Waterloo,watrrfw,9,1000,996,4,1.00200400801603,2,3.51348170280073e-09
2009,University of Waterloo,watrrfw,10,1000,996,4,1.00200400801603,2,9.67275477293827e-16
2009,University of Waterloo,watrrfw,11,1000,998,2,1.001001001001,2,3.75475305183848e-39
2009,University of Waterloo,watrrfw,12,1000,1000,0,1,,0
2009,University of Waterloo,watrrfw,13,1000,1000,0,1,,0
2009,University of Waterloo,watrrfw,14,1000,996,4,1.00200400801603,2,1.27487909637426e-27
2009,University of Waterloo,watrrfw,15,1000,998,2,1.001001001001,2,4.10841283370628e-40
2009,University of Waterloo,watrrfw,16,1000,998,2,1.001001001001,2,3.69757155033565e-40
2009,University of Waterloo,watrrfw,17,1000,996,4,1.00200400801603,2,7.64497577919609e-27
2009,University of Waterloo,watrrfw,18,1000,1000,0,1,,0
2009,University of Waterloo,watrrfw,19,1000,998,2,1.001001001001,2,9.64304693507191e-05
2009,University of Waterloo,watrrfw,20,1000,998,2,1.001001001001,2,2.33120472525847e-22
2009,University of Waterloo,watrrfw,21,1000,994,6,1.00300902708124,2,3.06655402991876e-11
2009,University of Waterloo,watrrfw,22,1000,1000,0,1,,0
2009,University of Waterloo,watrrfw,23,1000,1000,0,1,,0
2009,University of Waterloo,watrrfw,24,1000,998,2,1.001001001001,2,7.67606160135037e-13
2009,University of Waterloo,watrrfw,25,1000,998,2,1.001001001001,2,3.00741746214471e-26
2009,University of Waterloo,watrrfw,26,1000,998,2,1.001001001001,2,2.05338301092607e-44
2009,University of Waterloo,watrrfw,27,1000,1000,0,1,,0
2009,University of Waterloo,watrrfw,28,1000,996,4,1.00200400801603,2,5.1063594890566e-12
2009,University of Waterloo,watrrfw,29,1000,1000,0,1,,0
2009,University of Waterloo,watrrfw,30,1000,1000,0,1,,0
2009,University of Waterloo,watrrfw,31,1000,998,2,1.001001001001,2,1.22255029507316e-16
2009,University of Waterloo,watrrfw,32,1000,1000,0,1,,0
2009,University of Waterloo,watrrfw,33,1000,998,2,1.001001001001,2,4.36850911808902e-36
2009,University of Waterloo,watrrfw,34,1000,996,4,1.00200400801603,2,1.41654007597509e-27
2009,University of Waterloo,watrrfw,35,1000,998,2,1.001001001001,2,1.69244993873101e-36
2009,University of Waterloo,watrrfw,36,1000,998,2,1.001001001001,2,6.38500061347152e-25
2009,University of Waterloo,watrrfw,37,1000,996,4,1.00200400801603,2,4.25398322928899e-24
2009,University of Waterloo,watrrfw,38,1000,1000,0,1,,0
2009,University of Waterloo,watrrfw,39,1000,1000,0,1,,0
2009,University of Waterloo,watrrfw,40,1000,1000,0,1,,0
2009,University of Waterloo,watrrfw,41,1000,1000,0,1,,0
2009,University of Waterloo,watrrfw,42,1000,998,2,1.001001001001,2,6.67204957483528e-29
2009,University of Waterloo,watrrfw,43,1000,1000,0,1,,0
2009,University of Waterloo,watrrfw,44,1000,1000,0,1,,0
2009,University of Waterloo,watrrfw,45,1000,1000,0,1,,0
2009,University of Waterloo,watrrfw,46,1000,1000,0,1,,0
2009,University of Waterloo,watrrfw,47,1000,998,2,1.001001001001,2,1.57068076611194e-34
2009,University of Waterloo,watrrfw,48,1000,1000,0,1,,0
2009,University of Waterloo,watrrfw,49,1000,1000,0,1,,0
2009,University of Waterloo,watrrfw,50,1000,998,2,1.001001001001,2,2.8602713005618e-43
2009,University of Waterloo,watwp,1,1000,621,379,1.31061598951507,2.66901408450704,0.207231417135315
2009,University of Waterloo,watwp,2,1000,849,151,1.08813928182807,2.15714285714286,0.047504390620795
2009,University of Waterloo,watwp,3,1000,779,221,1.13378684807256,2.14563106796117,0.299250852415005
2009,University of Waterloo,watwp,4,1000,641,359,1.2853470437018,2.62043795620438,0.816141038524869
2009,University of Waterloo,watwp,5,1000,811,189,1.11111111111111,2.12359550561798,0.172554402646677
2009,University of Waterloo,watwp,6,1000,760,240,1.14678899082569,2.14285714285714,0.330185088942894
2009,University of Waterloo,watwp,7,1000,789,211,1.13122171945701,2.22105263157895,0.000295475681471887
2009,University of Waterloo,watwp,8,1000,767,233,1.15074798619102,2.2843137254902,0.020924524690505
2009,University of Waterloo,watwp,9,1000,685,315,1.23915737298637,2.58196721311475,0.219693082781426
2009,University of Waterloo,watwp,10,1000,734,266,1.17233294255569,2.23529411764706,0.197285886331911
2009,University of Waterloo,watwp,11,1000,657,343,1.27713920817369,2.72222222222222,0.00105989224516183
2009,University of Waterloo,watwp,12,1000,743,257,1.15473441108545,2.08943089430894,0.102036073320578
2009,University of Waterloo,watwp,13,1000,288,712,1.89035916824197,2.95435684647303,0.698253595587882
2009,University of Waterloo,watwp,14,1000,573,427,1.31926121372032,2.30810810810811,0.27860878641132
2009,University of Waterloo,watwp,15,1000,824,176,1.10132158590308,2.0952380952381,0.0627002711047934
2009,University of Waterloo,watwp,16,1000,810,190,1.11358574610245,2.15909090909091,0.305035430460215
2009,University of Waterloo,watwp,17,1000,783,217,1.15606936416185,2.64634146341463,0.171619039490532
2009,University of Waterloo,watwp,18,1000,657,343,1.24843945068664,2.38194444444444,0.0200764877504224
2009,University of Waterloo,watwp,19,1000,701,299,1.20481927710843,2.31782945736434,0.345173476326159
2009,University of Waterloo,watwp,20,1000,517,483,1.41442715700141,2.5421052631579,0.745513963322612
2009,University of Waterloo,watwp,21,1000,718,282,1.19760479041916,2.41025641025641,0.250752082916299
2009,University of Waterloo,watwp,22,1000,860,140,1.07758620689655,2.05882352941176,0.221471712216545
2009,University of Waterloo,watwp,23,1000,633,367,1.28865979381443,2.56643356643357,0.142451888176713
2009,University of Waterloo,watwp,24,1000,681,319,1.21654501216545,2.26241134751773,0.526056177243806
2009,University of Waterloo,watwp,25,1000,710,290,1.18764845605701,2.1969696969697,0.34052576467551
2009,University of Waterloo,watwp,26,1000,726,274,1.18203309692671,2.28333333333333,0.325535039455935
2009,University of Waterloo,watwp,27,1000,736,264,1.16959064327485,2.21848739495798,0.343031073611255
2009,University of Waterloo,watwp,28,1000,540,460,1.48809523809524,3.48484848484849,0.726307105599655
2009,University of Waterloo,watwp,29,1000,778,222,1.13636363636364,2.17647058823529,0.0113567305650304
2009,University of Waterloo,watwp,30,1000,812,188,1.11111111111111,2.13636363636364,0.00936124534740584
2009,University of Waterloo,watwp,31,1000,433,567,1.51975683890578,2.52,0.645629547062615
2009,University of Waterloo,watwp,32,1000,668,332,1.23915737298637,2.38848920863309,0.0700523394685127
2009,University of Waterloo,watwp,33,1000,678,322,1.21802679658953,2.25174825174825,0.0633122309563165
2009,University of Waterloo,watwp,34,1000,783,217,1.13636363636364,2.23711340206186,0.0917228970295761
2009,University of Waterloo,watwp,35,1000,721,279,1.22249388753056,2.87628865979381,0.576046587199089
2009,University of Waterloo,watwp,36,1000,713,287,1.18343195266272,2.17424242424242,0.679565723415696
2009,University of Waterloo,watwp,37,1000,709,291,1.18906064209275,2.20454545454545,0.303276175787589
2009,University of Waterloo,watwp,38,1000,714,286,1.18906064209275,2.25196850393701,0.0688252656555781
2009,University of Waterloo,watwp,39,1000,782,218,1.12739571589628,2.07619047619048,0.154164092282959
2009,University of Waterloo,watwp,40,1000,5,995,25.6410256410256,29.2647058823529,0.6029559
2009,University of Waterloo,watwp,41,1000,811,189,1.10987791342952,2.1,0.0519709676850906
2009,University of Waterloo,watwp,42,1000,834,166,1.09529025191676,2.10126582278481,0.217421928295636
2009,University of Waterloo,watwp,43,1000,826,174,1.10497237569061,2.20253164556962,0.516363603549038
2009,University of Waterloo,watwp,44,1000,633,367,1.28700128700129,2.54861111111111,0.0336877613058717
2009,University of Waterloo,watwp,45,1000,815,185,1.10864745011086,2.1264367816092,0.136443609589906
2009,University of Waterloo,watwp,46,1000,617,383,1.34228187919463,2.9921875,0.185675779582496
2009,University of Waterloo,watwp,47,1000,738,262,1.16959064327485,2.23931623931624,0.197283208161301
2009,University of Waterloo,watwp,48,1000,782,218,1.14025085518814,2.29473684210526,0.100250186180669
2009,University of Waterloo,watwp,49,1000,637,363,1.2853470437018,2.57446808510638,0.290119591084466
2009,University of Waterloo,watwp,50,1000,731,269,1.17508813160987,2.24166666666667,0.118341261482381
2009,Yahoo! Research,yhooumd09BFM,1,1000,967,33,1.01729399796541,2.0625,0.0111731157316522
2009,Yahoo! Research,yhooumd09BFM,2,1000,977,23,1.01317122593718,2.3,1.11978244048771e-08
2009,Yahoo! Research,yhooumd09BFM,3,1000,896,104,1.07066381156317,2.73684210526316,0.00165832552182755
2009,Yahoo! Research,yhooumd09BFM,4,1000,898,102,1.08813928182807,4.85714285714286,0.0127188907882056
2009,Yahoo! Research,yhooumd09BFM,5,1000,966,34,1.01729399796541,2,0.00120891023390916
2009,Yahoo! Research,yhooumd09BFM,6,1000,957,43,1.02249488752556,2.04761904761905,2.60256789493152e-08
2009,Yahoo! Research,yhooumd09BFM,7,1000,903,97,1.06837606837607,2.93939393939394,0.020789670966804
2009,Yahoo! Research,yhooumd09BFM,8,1000,970,30,1.01626016260163,2.14285714285714,0.00814804750622122
2009,Yahoo! Research,yhooumd09BFM,9,1000,967,33,1.02145045965271,2.75,0.104595780308763
2009,Yahoo! Research,yhooumd09BFM,10,1000,986,14,1.00806451612903,2.33333333333333,8.28824180742362e-08
2009,Yahoo! Research,yhooumd09BFM,11,1000,966,34,1.01936799184506,2.26666666666667,0.0103619632541023
2009,Yahoo! Research,yhooumd09BFM,12,1000,867,133,1.12107623318386,5.32,0.0216284341059475
2009,Yahoo! Research,yhooumd09BFM,13,1000,821,179,1.16279069767442,4.58974358974359,3.81351729114985e-05
2009,Yahoo! Research,yhooumd09BFM,14,1000,955,45,1.02354145342886,2.04545454545455,2.72505401411014e-05
2009,Yahoo! Research,yhooumd09BFM,15,1000,957,43,1.02774922918808,2.6875,8.04189683957084e-10
2009,Yahoo! Research,yhooumd09BFM,16,1000,982,18,1.00908173562059,2,0.0482954507382529
2009,Yahoo! Research,yhooumd09BFM,17,1000,981,19,1.01010101010101,2.11111111111111,3.78925260193417e-11
2009,Yahoo! Research,yhooumd09BFM,18,1000,982,18,1.00908173562059,2,1.24402063232978e-08
2009,Yahoo! Research,yhooumd09BFM,19,1000,967,33,1.02145045965271,2.75,0.00528444029275671
2009,Yahoo! Research,yhooumd09BFM,20,1000,986,14,1.00704934541793,2,5.03024453747115e-08
2009,Yahoo! Research,yhooumd09BFM,21,1000,962,38,1.01936799184506,2,0.00762130488615342
2009,Yahoo! Research,yhooumd09BFM,22,1000,982,18,1.01010101010101,2.25,2.13509104246595e-10
2009,Yahoo! Research,yhooumd09BFM,23,1000,931,69,1.04384133611691,2.55555555555556,2.11226229472137e-06
2009,Yahoo! Research,yhooumd09BFM,24,1000,871,129,1.09409190371991,3,0.00120891143224059
2009,Yahoo! Research,yhooumd09BFM,25,1000,954,46,1.02669404517454,2.3,0.235703569677175
2009,Yahoo! Research,yhooumd09BFM,26,1000,979,21,1.01112234580384,2.1,1.82310597741562e-05
2009,Yahoo! Research,yhooumd09BFM,27,1000,971,29,1.01626016260163,2.23076923076923,0.00353391946334175
2009,Yahoo! Research,yhooumd09BFM,28,1000,916,84,1.05820105820106,2.89655172413793,0.396539392130843
2009,Yahoo! Research,yhooumd09BFM,29,1000,983,17,1.00908173562059,2.125,5.03628208701878e-13
2009,Yahoo! Research,yhooumd09BFM,30,1000,984,16,1.00806451612903,2,7.69191789297726e-06
2009,Yahoo! Research,yhooumd09BFM,31,1000,920,80,1.04602510460251,2.22222222222222,0.084030121042685
2009,Yahoo! Research,yhooumd09BFM,32,1000,926,74,1.04493207941484,2.38709677419355,0.307972276717863
2009,Yahoo! Research,yhooumd09BFM,33,1000,973,27,1.01522842639594,2.25,0.104200229071532
2009,Yahoo! Research,yhooumd09BFM,34,1000,933,67,1.04058272632674,2.39285714285714,0.0013432335931287
2009,Yahoo! Research,yhooumd09BFM,35,1000,970,30,1.01626016260163,2.14285714285714,2.63571685265004e-14
2009,Yahoo! Research,yhooumd09BFM,36,1000,950,50,1.03412616339193,2.94117647058824,0.00318585262099798
2009,Yahoo! Research,yhooumd09BFM,37,1000,976,24,1.01317122593718,2.18181818181818,5.46390034391835e-08
2009,Yahoo! Research,yhooumd09BFM,38,1000,966,34,1.01936799184506,2.26666666666667,0.00162872850112317
2009,Yahoo! Research,yhooumd09BFM,39,1000,969,31,1.01729399796541,2.21428571428571,0.00108801921043716
2009,Yahoo! Research,yhooumd09BFM,40,1000,806,194,1.13895216400911,2.69444444444444,0.000685471383938889
2009,Yahoo! Research,yhooumd09BFM,41,1000,963,37,1.02354145342886,2.64285714285714,0.124659000347094
2009,Yahoo! Research,yhooumd09BFM,42,1000,959,41,1.02669404517454,2.73333333333333,0.000334415053685806
2009,Yahoo! Research,yhooumd09BFM,43,1000,971,29,1.01936799184506,2.9,0.0313263607131235
2009,Yahoo! Research,yhooumd09BFM,44,1000,844,156,1.11856823266219,3.12,0.00182577236775951
2009,Yahoo! Research,yhooumd09BFM,45,1000,978,22,1.01112234580384,2,0.000988441112432635
2009,Yahoo! Research,yhooumd09BFM,46,1000,967,33,1.02249488752556,3,2.62029027410437e-06
2009,Yahoo! Research,yhooumd09BFM,47,1000,982,18,1.01010101010101,2.25,1.30665047125177e-12
2009,Yahoo! Research,yhooumd09BFM,48,1000,962,38,1.02354145342886,2.53333333333333,0.00185121434588292
2009,Yahoo! Research,yhooumd09BFM,49,1000,926,74,1.0482180293501,2.64285714285714,0.00360789013196497
2009,Yahoo! Research,yhooumd09BFM,50,1000,954,46,1.02669404517454,2.3,0.351509164119988
2009,Yahoo! Research,yhooumd09BGC,1,1000,966,34,1.0183299389002,2.125,0.127393382761871
2009,Yahoo! Research,yhooumd09BGC,2,1000,927,73,1.04384133611691,2.35483870967742,0.000730045585127874
2009,Yahoo! Research,yhooumd09BGC,3,1000,811,189,1.15874855156431,3.63461538461538,0.000982994832635769
2009,Yahoo! Research,yhooumd09BGC,4,1000,847,153,1.12485939257593,3.64285714285714,0.0772563773743712
2009,Yahoo! Research,yhooumd09BGC,5,1000,879,121,1.07296137339056,2.28301886792453,0.0080543289156658
2009,Yahoo! Research,yhooumd09BGC,6,1000,790,210,1.13507377979569,2.30769230769231,0.064410178539355
2009,Yahoo! Research,yhooumd09BGC,7,1000,750,250,1.21212121212121,3.33333333333333,0.160332112626998
2009,Yahoo! Research,yhooumd09BGC,8,1000,944,56,1.03092783505155,2.15384615384615,0.247034911222883
2009,Yahoo! Research,yhooumd09BGC,9,1000,962,38,1.02249488752556,2.375,0.513222453747471
2009,Yahoo! Research,yhooumd09BGC,10,1000,572,428,1.53374233128834,5.35,0.0651352160863205
2009,Yahoo! Research,yhooumd09BGC,11,1000,912,88,1.0515247108307,2.25641025641026,0.31046338028713
2009,Yahoo! Research,yhooumd09BGC,12,1000,902,98,1.07066381156317,3.0625,0.029019529479964
2009,Yahoo! Research,yhooumd09BGC,13,1000,744,256,1.24843945068664,4.49122807017544,2.43788302535725e-06
2009,Yahoo! Research,yhooumd09BGC,14,1000,850,150,1.10619469026549,2.77777777777778,0.00475893950178822
2009,Yahoo! Research,yhooumd09BGC,15,1000,918,82,1.0482180293501,2.27777777777778,0.0609463558975245
2009,Yahoo! Research,yhooumd09BGC,16,1000,881,119,1.06837606837607,2.16363636363636,0.0119380540559943
2009,Yahoo! Research,yhooumd09BGC,17,1000,938,62,1.03842159916926,2.48,1.27281838813439e-06
2009,Yahoo! Research,yhooumd09BGC,18,1000,926,74,1.04275286757039,2.24242424242424,0.00280852110576715
2009,Yahoo! Research,yhooumd09BGC,19,1000,922,78,1.05042016806723,2.6,1.44123340349572e-06
2009,Yahoo! Research,yhooumd09BGC,20,1000,962,38,1.02040816326531,2.11111111111111,0.0334031530044277
2009,Yahoo! Research,yhooumd09BGC,21,1000,901,99,1.06044538706257,2.35714285714286,7.57582029073849e-06
2009,Yahoo! Research,yhooumd09BGC,22,1000,968,32,1.01729399796541,2.13333333333333,4.31564045220678e-08
2009,Yahoo! Research,yhooumd09BGC,23,1000,882,118,1.085776330076,3.02564102564103,0.000132667600809765
2009,Yahoo! Research,yhooumd09BGC,24,1000,769,231,1.17647058823529,2.85185185185185,0.0652114290984694
2009,Yahoo! Research,yhooumd09BGC,25,1000,765,235,1.15874855156431,2.39795918367347,0.199123325740828
2009,Yahoo! Research,yhooumd09BGC,26,1000,897,103,1.06269925611052,2.34090909090909,0.00150977379988563
2009,Yahoo! Research,yhooumd09BGC,27,1000,933,67,1.03842159916926,2.23333333333333,0.020634989744034
2009,Yahoo! Research,yhooumd09BGC,28,1000,811,189,1.16414435389988,3.9375,0.0147744456496201
2009,Yahoo! Research,yhooumd09BGC,29,1000,945,55,1.03199174406605,2.29166666666667,4.81993439280068e-09
2009,Yahoo! Research,yhooumd09BGC,30,1000,789,211,1.12233445566779,2.06862745098039,0.083974652218667
2009,Yahoo! Research,yhooumd09BGC,31,1000,781,219,1.14810562571757,2.43333333333333,0.153468320022347
2009,Yahoo! Research,yhooumd09BGC,32,1000,877,123,1.07991360691145,2.51020408163265,0.379985725364465
2009,Yahoo! Research,yhooumd09BGC,33,1000,956,44,1.02669404517454,2.44444444444444,0.00337321336560175
2009,Yahoo! Research,yhooumd09BGC,34,1000,945,55,1.03626943005181,2.75,0.100973870390726
2009,Yahoo! Research,yhooumd09BGC,35,1000,874,126,1.07758620689655,2.33333333333333,0.327080885998288
2009,Yahoo! Research,yhooumd09BGC,36,1000,908,92,1.07066381156317,3.53846153846154,0.00491378988005141
2009,Yahoo! Research,yhooumd09BGC,37,1000,896,104,1.07066381156317,2.73684210526316,0.0370188800746941
2009,Yahoo! Research,yhooumd09BGC,38,1000,919,81,1.0482180293501,2.31428571428571,0.218497473906205
2009,Yahoo! Research,yhooumd09BGC,39,1000,929,71,1.04384133611691,2.44827586206897,2.36432801717132e-05
2009,Yahoo! Research,yhooumd09BGC,40,1000,556,444,1.4367816091954,3.17142857142857,0.00314139780434968
2009,Yahoo! Research,yhooumd09BGC,41,1000,887,113,1.06837606837607,2.30612244897959,0.0237509246282465
2009,Yahoo! Research,yhooumd09BGC,42,1000,931,69,1.0482180293501,3,0.104902626279052
2009,Yahoo! Research,yhooumd09BGC,43,1000,903,97,1.06269925611052,2.55263157894737,0.204668676436226
2009,Yahoo! Research,yhooumd09BGC,44,1000,676,324,1.31233595800525,3.76744186046512,0.130841193737496
2009,Yahoo! Research,yhooumd09BGC,45,1000,936,64,1.03734439834025,2.28571428571429,0.0550780392096315
2009,Yahoo! Research,yhooumd09BGC,46,1000,832,168,1.11111111111111,2.47058823529412,0.00718183399870736
2009,Yahoo! Research,yhooumd09BGC,47,1000,926,74,1.04384133611691,2.3125,0.00354840763829972
2009,Yahoo! Research,yhooumd09BGC,48,1000,922,78,1.04493207941484,2.22857142857143,0.00693070830479398
2009,Yahoo! Research,yhooumd09BGC,49,1000,863,137,1.10741971207087,3.425,0.0960426339777133
2009,Yahoo! Research,yhooumd09BGC,50,1000,859,141,1.09769484083425,2.71153846153846,0.0684827772537149
2009,Yahoo! Research,yhooumd09BGM,1,1000,970,30,1.01626016260163,2.14285714285714,0.00652445443558909
2009,Yahoo! Research,yhooumd09BGM,2,1000,926,74,1.04712041884817,2.55172413793103,0.000388426972054529
2009,Yahoo! Research,yhooumd09BGM,3,1000,811,189,1.15874855156431,3.63461538461538,0.000885073103696687
2009,Yahoo! Research,yhooumd09BGM,4,1000,847,153,1.12485939257593,3.64285714285714,0.0760075590728714
2009,Yahoo! Research,yhooumd09BGM,5,1000,877,123,1.07411385606874,2.27777777777778,0.00732699892136548
2009,Yahoo! Research,yhooumd09BGM,6,1000,790,210,1.13507377979569,2.30769230769231,0.0473234654262263
2009,Yahoo! Research,yhooumd09BGM,7,1000,750,250,1.21212121212121,3.33333333333333,0.160332112626998
2009,Yahoo! Research,yhooumd09BGM,8,1000,944,56,1.03092783505155,2.15384615384615,0.246434461274448
2009,Yahoo! Research,yhooumd09BGM,9,1000,962,38,1.02249488752556,2.375,0.461964502647471
2009,Yahoo! Research,yhooumd09BGM,10,1000,567,433,1.54320987654321,5.34567901234568,0.052759580109386
2009,Yahoo! Research,yhooumd09BGM,11,1000,914,86,1.05042016806723,2.26315789473684,0.173000443842239
2009,Yahoo! Research,yhooumd09BGM,12,1000,900,100,1.07181136120043,3.03030303030303,0.0290197312789111
2009,Yahoo! Research,yhooumd09BGM,13,1000,744,256,1.24843945068664,4.49122807017544,2.43788302535725e-06
2009,Yahoo! Research,yhooumd09BGM,14,1000,850,150,1.10619469026549,2.77777777777778,0.0042849513169248
2009,Yahoo! Research,yhooumd09BGM,15,1000,918,82,1.0482180293501,2.27777777777778,0.0305930415581653
2009,Yahoo! Research,yhooumd09BGM,16,1000,871,129,1.07642626480086,2.22413793103448,0.00419555349888979
2009,Yahoo! Research,yhooumd09BGM,17,1000,938,62,1.03842159916926,2.48,1.03098290375127e-06
2009,Yahoo! Research,yhooumd09BGM,18,1000,924,76,1.04384133611691,2.23529411764706,0.0011108489188528
2009,Yahoo! Research,yhooumd09BGM,19,1000,922,78,1.05042016806723,2.6,1.44123340349572e-06
2009,Yahoo! Research,yhooumd09BGM,20,1000,962,38,1.02040816326531,2.11111111111111,0.0299187449867428
2009,Yahoo! Research,yhooumd09BGM,21,1000,901,99,1.06044538706257,2.35714285714286,7.57582028980925e-06
2009,Yahoo! Research,yhooumd09BGM,22,1000,962,38,1.02145045965271,2.23529411764706,2.64192521818288e-07
2009,Yahoo! Research,yhooumd09BGM,23,1000,882,118,1.085776330076,3.02564102564103,0.000132667600809765
2009,Yahoo! Research,yhooumd09BGM,24,1000,769,231,1.17647058823529,2.85185185185185,0.0572486464069601
2009,Yahoo! Research,yhooumd09BGM,25,1000,767,233,1.15740740740741,2.4020618556701,0.259480409261938
2009,Yahoo! Research,yhooumd09BGM,26,1000,893,107,1.06496272630458,2.32608695652174,0.000127105871776588
2009,Yahoo! Research,yhooumd09BGM,27,1000,933,67,1.03842159916926,2.23333333333333,0.0115248134220388
2009,Yahoo! Research,yhooumd09BGM,28,1000,811,189,1.16414435389988,3.9375,0.00573740122385289
2009,Yahoo! Research,yhooumd09BGM,29,1000,945,55,1.03199174406605,2.29166666666667,1.5125865664914e-09
2009,Yahoo! Research,yhooumd09BGM,30,1000,785,215,1.12485939257593,2.06730769230769,0.0846147478646785
2009,Yahoo! Research,yhooumd09BGM,31,1000,781,219,1.14810562571757,2.43333333333333,0.136929725254641
2009,Yahoo! Research,yhooumd09BGM,32,1000,877,123,1.07991360691145,2.51020408163265,0.422248517625957
2009,Yahoo! Research,yhooumd09BGM,33,1000,956,44,1.02669404517454,2.44444444444444,0.00304759233259835
2009,Yahoo! Research,yhooumd09BGM,34,1000,945,55,1.03626943005181,2.75,0.100973870390726
2009,Yahoo! Research,yhooumd09BGM,35,1000,874,126,1.07758620689655,2.33333333333333,0.332402283804423
2009,Yahoo! Research,yhooumd09BGM,36,1000,908,92,1.07066381156317,3.53846153846154,0.00442241128243345
2009,Yahoo! Research,yhooumd09BGM,37,1000,892,108,1.07296137339056,2.7,0.0244512489434752
2009,Yahoo! Research,yhooumd09BGM,38,1000,917,83,1.04931794333683,2.30555555555556,0.200744148408474
2009,Yahoo! Research,yhooumd09BGM,39,1000,929,71,1.04384133611691,2.44827586206897,1.13158743071135e-05
2009,Yahoo! Research,yhooumd09BGM,40,1000,463,537,1.5748031496063,3.12209302325581,0.00472248581812478
2009,Yahoo! Research,yhooumd09BGM,41,1000,885,115,1.06837606837607,2.25490196078431,0.00169913374395479
2009,Yahoo! Research,yhooumd09BGM,42,1000,931,69,1.0482180293501,3,0.116287483408761
2009,Yahoo! Research,yhooumd09BGM,43,1000,903,97,1.06269925611052,2.55263157894737,0.178763426231782
2009,Yahoo! Research,yhooumd09BGM,44,1000,676,324,1.31233595800525,3.76744186046512,0.155132051981828
2009,Yahoo! Research,yhooumd09BGM,45,1000,936,64,1.03734439834025,2.28571428571429,0.0673962097143766
2009,Yahoo! Research,yhooumd09BGM,46,1000,860,140,1.09289617486339,2.54545454545455,0.0056323882229906
2009,Yahoo! Research,yhooumd09BGM,47,1000,926,74,1.04384133611691,2.3125,0.00487484543368176
2009,Yahoo! Research,yhooumd09BGM,48,1000,920,80,1.04602510460251,2.22222222222222,0.00509240846889108
2009,Yahoo! Research,yhooumd09BGM,49,1000,863,137,1.10741971207087,3.425,0.175117609045299
2009,Yahoo! Research,yhooumd09BGM,50,1000,859,141,1.09769484083425,2.71153846153846,0.0894207876137284
